,ID,CODE_GENDER,FLAG_OWN_CAR,FLAG_OWN_REALTY,CNT_CHILDREN,AMT_INCOME_TOTAL,NAME_INCOME_TYPE,NAME_EDUCATION_TYPE,NAME_FAMILY_STATUS,NAME_HOUSING_TYPE,DAYS_BIRTH,DAYS_EMPLOYED,FLAG_MOBIL,FLAG_WORK_PHONE,FLAG_PHONE,FLAG_EMAIL,OCCUPATION_TYPE,CNT_FAM_MEMBERS,MONTHS_BALANCE,STATUS
0,5008804,M,Y,Y,0,427500.0,Working,Higher education,Civil marriage,Rented apartment,-12005,-4542,1,1,0,0,,2.0,0,C
1,5008804,M,Y,Y,0,427500.0,Working,Higher education,Civil marriage,Rented apartment,-12005,-4542,1,1,0,0,,2.0,-1,C
2,5008804,M,Y,Y,0,427500.0,Working,Higher education,Civil marriage,Rented apartment,-12005,-4542,1,1,0,0,,2.0,-2,C
3,5008804,M,Y,Y,0,427500.0,Working,Higher education,Civil marriage,Rented apartment,-12005,-4542,1,1,0,0,,2.0,-3,C
4,5008804,M,Y,Y,0,427500.0,Working,Higher education,Civil marriage,Rented apartment,-12005,-4542,1,1,0,0,,2.0,-4,C
5,5008804,M,Y,Y,0,427500.0,Working,Higher education,Civil marriage,Rented apartment,-12005,-4542,1,1,0,0,,2.0,-5,C
6,5008804,M,Y,Y,0,427500.0,Working,Higher education,Civil marriage,Rented apartment,-12005,-4542,1,1,0,0,,2.0,-6,C
7,5008804,M,Y,Y,0,427500.0,Working,Higher education,Civil marriage,Rented apartment,-12005,-4542,1,1,0,0,,2.0,-7,C
8,5008804,M,Y,Y,0,427500.0,Working,Higher education,Civil marriage,Rented apartment,-12005,-4542,1,1,0,0,,2.0,-8,C
9,5008804,M,Y,Y,0,427500.0,Working,Higher education,Civil marriage,Rented apartment,-12005,-4542,1,1,0,0,,2.0,-9,C
10,5008804,M,Y,Y,0,427500.0,Working,Higher education,Civil marriage,Rented apartment,-12005,-4542,1,1,0,0,,2.0,-10,C
11,5008804,M,Y,Y,0,427500.0,Working,Higher education,Civil marriage,Rented apartment,-12005,-4542,1,1,0,0,,2.0,-11,C
12,5008804,M,Y,Y,0,427500.0,Working,Higher education,Civil marriage,Rented apartment,-12005,-4542,1,1,0,0,,2.0,-12,C
13,5008804,M,Y,Y,0,427500.0,Working,Higher education,Civil marriage,Rented apartment,-12005,-4542,1,1,0,0,,2.0,-13,1
14,5008804,M,Y,Y,0,427500.0,Working,Higher education,Civil marriage,Rented apartment,-12005,-4542,1,1,0,0,,2.0,-14,0
15,5008804,M,Y,Y,0,427500.0,Working,Higher education,Civil marriage,Rented apartment,-12005,-4542,1,1,0,0,,2.0,-15,X
16,5008805,M,Y,Y,0,427500.0,Working,Higher education,Civil marriage,Rented apartment,-12005,-4542,1,1,0,0,,2.0,0,C
17,5008805,M,Y,Y,0,427500.0,Working,Higher education,Civil marriage,Rented apartment,-12005,-4542,1,1,0,0,,2.0,-1,C
18,5008805,M,Y,Y,0,427500.0,Working,Higher education,Civil marriage,Rented apartment,-12005,-4542,1,1,0,0,,2.0,-2,C
19,5008805,M,Y,Y,0,427500.0,Working,Higher education,Civil marriage,Rented apartment,-12005,-4542,1,1,0,0,,2.0,-3,C
20,5008805,M,Y,Y,0,427500.0,Working,Higher education,Civil marriage,Rented apartment,-12005,-4542,1,1,0,0,,2.0,-4,C
21,5008805,M,Y,Y,0,427500.0,Working,Higher education,Civil marriage,Rented apartment,-12005,-4542,1,1,0,0,,2.0,-5,C
22,5008805,M,Y,Y,0,427500.0,Working,Higher education,Civil marriage,Rented apartment,-12005,-4542,1,1,0,0,,2.0,-6,C
23,5008805,M,Y,Y,0,427500.0,Working,Higher education,Civil marriage,Rented apartment,-12005,-4542,1,1,0,0,,2.0,-7,C
24,5008805,M,Y,Y,0,427500.0,Working,Higher education,Civil marriage,Rented apartment,-12005,-4542,1,1,0,0,,2.0,-8,C
25,5008805,M,Y,Y,0,427500.0,Working,Higher education,Civil marriage,Rented apartment,-12005,-4542,1,1,0,0,,2.0,-9,C
26,5008805,M,Y,Y,0,427500.0,Working,Higher education,Civil marriage,Rented apartment,-12005,-4542,1,1,0,0,,2.0,-10,C
27,5008805,M,Y,Y,0,427500.0,Working,Higher education,Civil marriage,Rented apartment,-12005,-4542,1,1,0,0,,2.0,-11,C
28,5008805,M,Y,Y,0,427500.0,Working,Higher education,Civil marriage,Rented apartment,-12005,-4542,1,1,0,0,,2.0,-12,1
29,5008805,M,Y,Y,0,427500.0,Working,Higher education,Civil marriage,Rented apartment,-12005,-4542,1,1,0,0,,2.0,-13,0
30,5008805,M,Y,Y,0,427500.0,Working,Higher education,Civil marriage,Rented apartment,-12005,-4542,1,1,0,0,,2.0,-14,X
31,5008806,M,Y,Y,0,112500.0,Working,Secondary / secondary special,Married,House / apartment,-21474,-1134,1,0,0,0,Security staff,2.0,0,C
32,5008806,M,Y,Y,0,112500.0,Working,Secondary / secondary special,Married,House / apartment,-21474,-1134,1,0,0,0,Security staff,2.0,-1,C
33,5008806,M,Y,Y,0,112500.0,Working,Secondary / secondary special,Married,House / apartment,-21474,-1134,1,0,0,0,Security staff,2.0,-2,C
34,5008806,M,Y,Y,0,112500.0,Working,Secondary / secondary special,Married,House / apartment,-21474,-1134,1,0,0,0,Security staff,2.0,-3,C
35,5008806,M,Y,Y,0,112500.0,Working,Secondary / secondary special,Married,House / apartment,-21474,-1134,1,0,0,0,Security staff,2.0,-4,C
36,5008806,M,Y,Y,0,112500.0,Working,Secondary / secondary special,Married,House / apartment,-21474,-1134,1,0,0,0,Security staff,2.0,-5,C
37,5008806,M,Y,Y,0,112500.0,Working,Secondary / secondary special,Married,House / apartment,-21474,-1134,1,0,0,0,Security staff,2.0,-6,C
38,5008806,M,Y,Y,0,112500.0,Working,Secondary / secondary special,Married,House / apartment,-21474,-1134,1,0,0,0,Security staff,2.0,-7,X
39,5008806,M,Y,Y,0,112500.0,Working,Secondary / secondary special,Married,House / apartment,-21474,-1134,1,0,0,0,Security staff,2.0,-8,0
40,5008806,M,Y,Y,0,112500.0,Working,Secondary / secondary special,Married,House / apartment,-21474,-1134,1,0,0,0,Security staff,2.0,-9,0
41,5008806,M,Y,Y,0,112500.0,Working,Secondary / secondary special,Married,House / apartment,-21474,-1134,1,0,0,0,Security staff,2.0,-10,X
42,5008806,M,Y,Y,0,112500.0,Working,Secondary / secondary special,Married,House / apartment,-21474,-1134,1,0,0,0,Security staff,2.0,-11,0
43,5008806,M,Y,Y,0,112500.0,Working,Secondary / secondary special,Married,House / apartment,-21474,-1134,1,0,0,0,Security staff,2.0,-12,X
44,5008806,M,Y,Y,0,112500.0,Working,Secondary / secondary special,Married,House / apartment,-21474,-1134,1,0,0,0,Security staff,2.0,-13,0
45,5008806,M,Y,Y,0,112500.0,Working,Secondary / secondary special,Married,House / apartment,-21474,-1134,1,0,0,0,Security staff,2.0,-14,X
46,5008806,M,Y,Y,0,112500.0,Working,Secondary / secondary special,Married,House / apartment,-21474,-1134,1,0,0,0,Security staff,2.0,-15,X
47,5008806,M,Y,Y,0,112500.0,Working,Secondary / secondary special,Married,House / apartment,-21474,-1134,1,0,0,0,Security staff,2.0,-16,X
48,5008806,M,Y,Y,0,112500.0,Working,Secondary / secondary special,Married,House / apartment,-21474,-1134,1,0,0,0,Security staff,2.0,-17,X
49,5008806,M,Y,Y,0,112500.0,Working,Secondary / secondary special,Married,House / apartment,-21474,-1134,1,0,0,0,Security staff,2.0,-18,X
50,5008806,M,Y,Y,0,112500.0,Working,Secondary / secondary special,Married,House / apartment,-21474,-1134,1,0,0,0,Security staff,2.0,-19,X
51,5008806,M,Y,Y,0,112500.0,Working,Secondary / secondary special,Married,House / apartment,-21474,-1134,1,0,0,0,Security staff,2.0,-20,0
52,5008806,M,Y,Y,0,112500.0,Working,Secondary / secondary special,Married,House / apartment,-21474,-1134,1,0,0,0,Security staff,2.0,-21,X
53,5008806,M,Y,Y,0,112500.0,Working,Secondary / secondary special,Married,House / apartment,-21474,-1134,1,0,0,0,Security staff,2.0,-22,X
54,5008806,M,Y,Y,0,112500.0,Working,Secondary / secondary special,Married,House / apartment,-21474,-1134,1,0,0,0,Security staff,2.0,-23,X
55,5008806,M,Y,Y,0,112500.0,Working,Secondary / secondary special,Married,House / apartment,-21474,-1134,1,0,0,0,Security staff,2.0,-24,0
56,5008806,M,Y,Y,0,112500.0,Working,Secondary / secondary special,Married,House / apartment,-21474,-1134,1,0,0,0,Security staff,2.0,-25,X
57,5008806,M,Y,Y,0,112500.0,Working,Secondary / secondary special,Married,House / apartment,-21474,-1134,1,0,0,0,Security staff,2.0,-26,X
58,5008806,M,Y,Y,0,112500.0,Working,Secondary / secondary special,Married,House / apartment,-21474,-1134,1,0,0,0,Security staff,2.0,-27,X
59,5008806,M,Y,Y,0,112500.0,Working,Secondary / secondary special,Married,House / apartment,-21474,-1134,1,0,0,0,Security staff,2.0,-28,0
60,5008806,M,Y,Y,0,112500.0,Working,Secondary / secondary special,Married,House / apartment,-21474,-1134,1,0,0,0,Security staff,2.0,-29,X
61,5008808,F,N,Y,0,270000.0,Commercial associate,Secondary / secondary special,Single / not married,House / apartment,-19110,-3051,1,0,1,1,Sales staff,1.0,0,0
62,5008808,F,N,Y,0,270000.0,Commercial associate,Secondary / secondary special,Single / not married,House / apartment,-19110,-3051,1,0,1,1,Sales staff,1.0,-1,X
63,5008808,F,N,Y,0,270000.0,Commercial associate,Secondary / secondary special,Single / not married,House / apartment,-19110,-3051,1,0,1,1,Sales staff,1.0,-2,0
64,5008808,F,N,Y,0,270000.0,Commercial associate,Secondary / secondary special,Single / not married,House / apartment,-19110,-3051,1,0,1,1,Sales staff,1.0,-3,X
65,5008808,F,N,Y,0,270000.0,Commercial associate,Secondary / secondary special,Single / not married,House / apartment,-19110,-3051,1,0,1,1,Sales staff,1.0,-4,X
66,5008809,F,N,Y,0,270000.0,Commercial associate,Secondary / secondary special,Single / not married,House / apartment,-19110,-3051,1,0,1,1,Sales staff,1.0,-22,X
67,5008809,F,N,Y,0,270000.0,Commercial associate,Secondary / secondary special,Single / not married,House / apartment,-19110,-3051,1,0,1,1,Sales staff,1.0,-23,X
68,5008809,F,N,Y,0,270000.0,Commercial associate,Secondary / secondary special,Single / not married,House / apartment,-19110,-3051,1,0,1,1,Sales staff,1.0,-24,X
69,5008809,F,N,Y,0,270000.0,Commercial associate,Secondary / secondary special,Single / not married,House / apartment,-19110,-3051,1,0,1,1,Sales staff,1.0,-25,X
70,5008809,F,N,Y,0,270000.0,Commercial associate,Secondary / secondary special,Single / not married,House / apartment,-19110,-3051,1,0,1,1,Sales staff,1.0,-26,X
71,5008810,F,N,Y,0,270000.0,Commercial associate,Secondary / secondary special,Single / not married,House / apartment,-19110,-3051,1,0,1,1,Sales staff,1.0,0,C
72,5008810,F,N,Y,0,270000.0,Commercial associate,Secondary / secondary special,Single / not married,House / apartment,-19110,-3051,1,0,1,1,Sales staff,1.0,-1,C
73,5008810,F,N,Y,0,270000.0,Commercial associate,Secondary / secondary special,Single / not married,House / apartment,-19110,-3051,1,0,1,1,Sales staff,1.0,-2,C
74,5008810,F,N,Y,0,270000.0,Commercial associate,Secondary / secondary special,Single / not married,House / apartment,-19110,-3051,1,0,1,1,Sales staff,1.0,-3,C
75,5008810,F,N,Y,0,270000.0,Commercial associate,Secondary / secondary special,Single / not married,House / apartment,-19110,-3051,1,0,1,1,Sales staff,1.0,-4,C
76,5008810,F,N,Y,0,270000.0,Commercial associate,Secondary / secondary special,Single / not married,House / apartment,-19110,-3051,1,0,1,1,Sales staff,1.0,-5,C
77,5008810,F,N,Y,0,270000.0,Commercial associate,Secondary / secondary special,Single / not married,House / apartment,-19110,-3051,1,0,1,1,Sales staff,1.0,-6,C
78,5008810,F,N,Y,0,270000.0,Commercial associate,Secondary / secondary special,Single / not married,House / apartment,-19110,-3051,1,0,1,1,Sales staff,1.0,-7,C
79,5008810,F,N,Y,0,270000.0,Commercial associate,Secondary / secondary special,Single / not married,House / apartment,-19110,-3051,1,0,1,1,Sales staff,1.0,-8,C
80,5008810,F,N,Y,0,270000.0,Commercial associate,Secondary / secondary special,Single / not married,House / apartment,-19110,-3051,1,0,1,1,Sales staff,1.0,-9,C
81,5008810,F,N,Y,0,270000.0,Commercial associate,Secondary / secondary special,Single / not married,House / apartment,-19110,-3051,1,0,1,1,Sales staff,1.0,-10,C
82,5008810,F,N,Y,0,270000.0,Commercial associate,Secondary / secondary special,Single / not married,House / apartment,-19110,-3051,1,0,1,1,Sales staff,1.0,-11,C
83,5008810,F,N,Y,0,270000.0,Commercial associate,Secondary / secondary special,Single / not married,House / apartment,-19110,-3051,1,0,1,1,Sales staff,1.0,-12,C
84,5008810,F,N,Y,0,270000.0,Commercial associate,Secondary / secondary special,Single / not married,House / apartment,-19110,-3051,1,0,1,1,Sales staff,1.0,-13,C
85,5008810,F,N,Y,0,270000.0,Commercial associate,Secondary / secondary special,Single / not married,House / apartment,-19110,-3051,1,0,1,1,Sales staff,1.0,-14,C
86,5008810,F,N,Y,0,270000.0,Commercial associate,Secondary / secondary special,Single / not married,House / apartment,-19110,-3051,1,0,1,1,Sales staff,1.0,-15,X
87,5008810,F,N,Y,0,270000.0,Commercial associate,Secondary / secondary special,Single / not married,House / apartment,-19110,-3051,1,0,1,1,Sales staff,1.0,-16,0
88,5008810,F,N,Y,0,270000.0,Commercial associate,Secondary / secondary special,Single / not married,House / apartment,-19110,-3051,1,0,1,1,Sales staff,1.0,-17,X
89,5008810,F,N,Y,0,270000.0,Commercial associate,Secondary / secondary special,Single / not married,House / apartment,-19110,-3051,1,0,1,1,Sales staff,1.0,-18,0
90,5008810,F,N,Y,0,270000.0,Commercial associate,Secondary / secondary special,Single / not married,House / apartment,-19110,-3051,1,0,1,1,Sales staff,1.0,-19,X
91,5008810,F,N,Y,0,270000.0,Commercial associate,Secondary / secondary special,Single / not married,House / apartment,-19110,-3051,1,0,1,1,Sales staff,1.0,-20,0
92,5008810,F,N,Y,0,270000.0,Commercial associate,Secondary / secondary special,Single / not married,House / apartment,-19110,-3051,1,0,1,1,Sales staff,1.0,-21,0
93,5008810,F,N,Y,0,270000.0,Commercial associate,Secondary / secondary special,Single / not married,House / apartment,-19110,-3051,1,0,1,1,Sales staff,1.0,-22,0
94,5008810,F,N,Y,0,270000.0,Commercial associate,Secondary / secondary special,Single / not married,House / apartment,-19110,-3051,1,0,1,1,Sales staff,1.0,-23,X
95,5008810,F,N,Y,0,270000.0,Commercial associate,Secondary / secondary special,Single / not married,House / apartment,-19110,-3051,1,0,1,1,Sales staff,1.0,-24,0
96,5008810,F,N,Y,0,270000.0,Commercial associate,Secondary / secondary special,Single / not married,House / apartment,-19110,-3051,1,0,1,1,Sales staff,1.0,-25,X
97,5008810,F,N,Y,0,270000.0,Commercial associate,Secondary / secondary special,Single / not married,House / apartment,-19110,-3051,1,0,1,1,Sales staff,1.0,-26,X
98,5008811,F,N,Y,0,270000.0,Commercial associate,Secondary / secondary special,Single / not married,House / apartment,-19110,-3051,1,0,1,1,Sales staff,1.0,0,C
99,5008811,F,N,Y,0,270000.0,Commercial associate,Secondary / secondary special,Single / not married,House / apartment,-19110,-3051,1,0,1,1,Sales staff,1.0,-1,C
100,5008811,F,N,Y,0,270000.0,Commercial associate,Secondary / secondary special,Single / not married,House / apartment,-19110,-3051,1,0,1,1,Sales staff,1.0,-2,C
101,5008811,F,N,Y,0,270000.0,Commercial associate,Secondary / secondary special,Single / not married,House / apartment,-19110,-3051,1,0,1,1,Sales staff,1.0,-3,C
102,5008811,F,N,Y,0,270000.0,Commercial associate,Secondary / secondary special,Single / not married,House / apartment,-19110,-3051,1,0,1,1,Sales staff,1.0,-4,C
103,5008811,F,N,Y,0,270000.0,Commercial associate,Secondary / secondary special,Single / not married,House / apartment,-19110,-3051,1,0,1,1,Sales staff,1.0,-5,C
104,5008811,F,N,Y,0,270000.0,Commercial associate,Secondary / secondary special,Single / not married,House / apartment,-19110,-3051,1,0,1,1,Sales staff,1.0,-6,C
105,5008811,F,N,Y,0,270000.0,Commercial associate,Secondary / secondary special,Single / not married,House / apartment,-19110,-3051,1,0,1,1,Sales staff,1.0,-7,C
106,5008811,F,N,Y,0,270000.0,Commercial associate,Secondary / secondary special,Single / not married,House / apartment,-19110,-3051,1,0,1,1,Sales staff,1.0,-8,C
107,5008811,F,N,Y,0,270000.0,Commercial associate,Secondary / secondary special,Single / not married,House / apartment,-19110,-3051,1,0,1,1,Sales staff,1.0,-9,C
108,5008811,F,N,Y,0,270000.0,Commercial associate,Secondary / secondary special,Single / not married,House / apartment,-19110,-3051,1,0,1,1,Sales staff,1.0,-10,C
109,5008811,F,N,Y,0,270000.0,Commercial associate,Secondary / secondary special,Single / not married,House / apartment,-19110,-3051,1,0,1,1,Sales staff,1.0,-11,C
110,5008811,F,N,Y,0,270000.0,Commercial associate,Secondary / secondary special,Single / not married,House / apartment,-19110,-3051,1,0,1,1,Sales staff,1.0,-12,C
111,5008811,F,N,Y,0,270000.0,Commercial associate,Secondary / secondary special,Single / not married,House / apartment,-19110,-3051,1,0,1,1,Sales staff,1.0,-13,C
112,5008811,F,N,Y,0,270000.0,Commercial associate,Secondary / secondary special,Single / not married,House / apartment,-19110,-3051,1,0,1,1,Sales staff,1.0,-14,C
113,5008811,F,N,Y,0,270000.0,Commercial associate,Secondary / secondary special,Single / not married,House / apartment,-19110,-3051,1,0,1,1,Sales staff,1.0,-15,C
114,5008811,F,N,Y,0,270000.0,Commercial associate,Secondary / secondary special,Single / not married,House / apartment,-19110,-3051,1,0,1,1,Sales staff,1.0,-16,C
115,5008811,F,N,Y,0,270000.0,Commercial associate,Secondary / secondary special,Single / not married,House / apartment,-19110,-3051,1,0,1,1,Sales staff,1.0,-17,C
116,5008811,F,N,Y,0,270000.0,Commercial associate,Secondary / secondary special,Single / not married,House / apartment,-19110,-3051,1,0,1,1,Sales staff,1.0,-18,C
117,5008811,F,N,Y,0,270000.0,Commercial associate,Secondary / secondary special,Single / not married,House / apartment,-19110,-3051,1,0,1,1,Sales staff,1.0,-19,C
118,5008811,F,N,Y,0,270000.0,Commercial associate,Secondary / secondary special,Single / not married,House / apartment,-19110,-3051,1,0,1,1,Sales staff,1.0,-20,C
119,5008811,F,N,Y,0,270000.0,Commercial associate,Secondary / secondary special,Single / not married,House / apartment,-19110,-3051,1,0,1,1,Sales staff,1.0,-21,C
120,5008811,F,N,Y,0,270000.0,Commercial associate,Secondary / secondary special,Single / not married,House / apartment,-19110,-3051,1,0,1,1,Sales staff,1.0,-22,C
121,5008811,F,N,Y,0,270000.0,Commercial associate,Secondary / secondary special,Single / not married,House / apartment,-19110,-3051,1,0,1,1,Sales staff,1.0,-23,C
122,5008811,F,N,Y,0,270000.0,Commercial associate,Secondary / secondary special,Single / not married,House / apartment,-19110,-3051,1,0,1,1,Sales staff,1.0,-24,C
123,5008811,F,N,Y,0,270000.0,Commercial associate,Secondary / secondary special,Single / not married,House / apartment,-19110,-3051,1,0,1,1,Sales staff,1.0,-25,C
124,5008811,F,N,Y,0,270000.0,Commercial associate,Secondary / secondary special,Single / not married,House / apartment,-19110,-3051,1,0,1,1,Sales staff,1.0,-26,C
125,5008811,F,N,Y,0,270000.0,Commercial associate,Secondary / secondary special,Single / not married,House / apartment,-19110,-3051,1,0,1,1,Sales staff,1.0,-27,X
126,5008811,F,N,Y,0,270000.0,Commercial associate,Secondary / secondary special,Single / not married,House / apartment,-19110,-3051,1,0,1,1,Sales staff,1.0,-28,0
127,5008811,F,N,Y,0,270000.0,Commercial associate,Secondary / secondary special,Single / not married,House / apartment,-19110,-3051,1,0,1,1,Sales staff,1.0,-29,X
128,5008811,F,N,Y,0,270000.0,Commercial associate,Secondary / secondary special,Single / not married,House / apartment,-19110,-3051,1,0,1,1,Sales staff,1.0,-30,0
129,5008811,F,N,Y,0,270000.0,Commercial associate,Secondary / secondary special,Single / not married,House / apartment,-19110,-3051,1,0,1,1,Sales staff,1.0,-31,X
130,5008811,F,N,Y,0,270000.0,Commercial associate,Secondary / secondary special,Single / not married,House / apartment,-19110,-3051,1,0,1,1,Sales staff,1.0,-32,0
131,5008811,F,N,Y,0,270000.0,Commercial associate,Secondary / secondary special,Single / not married,House / apartment,-19110,-3051,1,0,1,1,Sales staff,1.0,-33,0
132,5008811,F,N,Y,0,270000.0,Commercial associate,Secondary / secondary special,Single / not married,House / apartment,-19110,-3051,1,0,1,1,Sales staff,1.0,-34,0
133,5008811,F,N,Y,0,270000.0,Commercial associate,Secondary / secondary special,Single / not married,House / apartment,-19110,-3051,1,0,1,1,Sales staff,1.0,-35,X
134,5008811,F,N,Y,0,270000.0,Commercial associate,Secondary / secondary special,Single / not married,House / apartment,-19110,-3051,1,0,1,1,Sales staff,1.0,-36,0
135,5008811,F,N,Y,0,270000.0,Commercial associate,Secondary / secondary special,Single / not married,House / apartment,-19110,-3051,1,0,1,1,Sales staff,1.0,-37,X
136,5008811,F,N,Y,0,270000.0,Commercial associate,Secondary / secondary special,Single / not married,House / apartment,-19110,-3051,1,0,1,1,Sales staff,1.0,-38,X
137,5008812,F,N,Y,0,283500.0,Pensioner,Higher education,Separated,House / apartment,-22464,365243,1,0,0,0,,1.0,-4,0
138,5008812,F,N,Y,0,283500.0,Pensioner,Higher education,Separated,House / apartment,-22464,365243,1,0,0,0,,1.0,-5,X
139,5008812,F,N,Y,0,283500.0,Pensioner,Higher education,Separated,House / apartment,-22464,365243,1,0,0,0,,1.0,-6,X
140,5008812,F,N,Y,0,283500.0,Pensioner,Higher education,Separated,House / apartment,-22464,365243,1,0,0,0,,1.0,-7,0
141,5008812,F,N,Y,0,283500.0,Pensioner,Higher education,Separated,House / apartment,-22464,365243,1,0,0,0,,1.0,-8,0
142,5008812,F,N,Y,0,283500.0,Pensioner,Higher education,Separated,House / apartment,-22464,365243,1,0,0,0,,1.0,-9,0
143,5008812,F,N,Y,0,283500.0,Pensioner,Higher education,Separated,House / apartment,-22464,365243,1,0,0,0,,1.0,-10,0
144,5008812,F,N,Y,0,283500.0,Pensioner,Higher education,Separated,House / apartment,-22464,365243,1,0,0,0,,1.0,-11,0
145,5008812,F,N,Y,0,283500.0,Pensioner,Higher education,Separated,House / apartment,-22464,365243,1,0,0,0,,1.0,-12,0
146,5008812,F,N,Y,0,283500.0,Pensioner,Higher education,Separated,House / apartment,-22464,365243,1,0,0,0,,1.0,-13,0
147,5008812,F,N,Y,0,283500.0,Pensioner,Higher education,Separated,House / apartment,-22464,365243,1,0,0,0,,1.0,-14,0
148,5008812,F,N,Y,0,283500.0,Pensioner,Higher education,Separated,House / apartment,-22464,365243,1,0,0,0,,1.0,-15,0
149,5008812,F,N,Y,0,283500.0,Pensioner,Higher education,Separated,House / apartment,-22464,365243,1,0,0,0,,1.0,-16,0
150,5008812,F,N,Y,0,283500.0,Pensioner,Higher education,Separated,House / apartment,-22464,365243,1,0,0,0,,1.0,-17,0
151,5008812,F,N,Y,0,283500.0,Pensioner,Higher education,Separated,House / apartment,-22464,365243,1,0,0,0,,1.0,-18,0
152,5008812,F,N,Y,0,283500.0,Pensioner,Higher education,Separated,House / apartment,-22464,365243,1,0,0,0,,1.0,-19,0
153,5008812,F,N,Y,0,283500.0,Pensioner,Higher education,Separated,House / apartment,-22464,365243,1,0,0,0,,1.0,-20,X
154,5008813,F,N,Y,0,283500.0,Pensioner,Higher education,Separated,House / apartment,-22464,365243,1,0,0,0,,1.0,0,0
155,5008813,F,N,Y,0,283500.0,Pensioner,Higher education,Separated,House / apartment,-22464,365243,1,0,0,0,,1.0,-1,X
156,5008813,F,N,Y,0,283500.0,Pensioner,Higher education,Separated,House / apartment,-22464,365243,1,0,0,0,,1.0,-2,X
157,5008813,F,N,Y,0,283500.0,Pensioner,Higher education,Separated,House / apartment,-22464,365243,1,0,0,0,,1.0,-3,0
158,5008813,F,N,Y,0,283500.0,Pensioner,Higher education,Separated,House / apartment,-22464,365243,1,0,0,0,,1.0,-4,0
159,5008813,F,N,Y,0,283500.0,Pensioner,Higher education,Separated,House / apartment,-22464,365243,1,0,0,0,,1.0,-5,0
160,5008813,F,N,Y,0,283500.0,Pensioner,Higher education,Separated,House / apartment,-22464,365243,1,0,0,0,,1.0,-6,0
161,5008813,F,N,Y,0,283500.0,Pensioner,Higher education,Separated,House / apartment,-22464,365243,1,0,0,0,,1.0,-7,0
162,5008813,F,N,Y,0,283500.0,Pensioner,Higher education,Separated,House / apartment,-22464,365243,1,0,0,0,,1.0,-8,0
163,5008813,F,N,Y,0,283500.0,Pensioner,Higher education,Separated,House / apartment,-22464,365243,1,0,0,0,,1.0,-9,0
164,5008813,F,N,Y,0,283500.0,Pensioner,Higher education,Separated,House / apartment,-22464,365243,1,0,0,0,,1.0,-10,0
165,5008813,F,N,Y,0,283500.0,Pensioner,Higher education,Separated,House / apartment,-22464,365243,1,0,0,0,,1.0,-11,0
166,5008813,F,N,Y,0,283500.0,Pensioner,Higher education,Separated,House / apartment,-22464,365243,1,0,0,0,,1.0,-12,0
167,5008813,F,N,Y,0,283500.0,Pensioner,Higher education,Separated,House / apartment,-22464,365243,1,0,0,0,,1.0,-13,0
168,5008813,F,N,Y,0,283500.0,Pensioner,Higher education,Separated,House / apartment,-22464,365243,1,0,0,0,,1.0,-14,0
169,5008813,F,N,Y,0,283500.0,Pensioner,Higher education,Separated,House / apartment,-22464,365243,1,0,0,0,,1.0,-15,0
170,5008813,F,N,Y,0,283500.0,Pensioner,Higher education,Separated,House / apartment,-22464,365243,1,0,0,0,,1.0,-16,X
171,5008814,F,N,Y,0,283500.0,Pensioner,Higher education,Separated,House / apartment,-22464,365243,1,0,0,0,,1.0,-1,0
172,5008814,F,N,Y,0,283500.0,Pensioner,Higher education,Separated,House / apartment,-22464,365243,1,0,0,0,,1.0,-2,X
173,5008814,F,N,Y,0,283500.0,Pensioner,Higher education,Separated,House / apartment,-22464,365243,1,0,0,0,,1.0,-3,X
174,5008814,F,N,Y,0,283500.0,Pensioner,Higher education,Separated,House / apartment,-22464,365243,1,0,0,0,,1.0,-4,0
175,5008814,F,N,Y,0,283500.0,Pensioner,Higher education,Separated,House / apartment,-22464,365243,1,0,0,0,,1.0,-5,0
176,5008814,F,N,Y,0,283500.0,Pensioner,Higher education,Separated,House / apartment,-22464,365243,1,0,0,0,,1.0,-6,0
177,5008814,F,N,Y,0,283500.0,Pensioner,Higher education,Separated,House / apartment,-22464,365243,1,0,0,0,,1.0,-7,0
178,5008814,F,N,Y,0,283500.0,Pensioner,Higher education,Separated,House / apartment,-22464,365243,1,0,0,0,,1.0,-8,0
179,5008814,F,N,Y,0,283500.0,Pensioner,Higher education,Separated,House / apartment,-22464,365243,1,0,0,0,,1.0,-9,0
180,5008814,F,N,Y,0,283500.0,Pensioner,Higher education,Separated,House / apartment,-22464,365243,1,0,0,0,,1.0,-10,0
181,5008814,F,N,Y,0,283500.0,Pensioner,Higher education,Separated,House / apartment,-22464,365243,1,0,0,0,,1.0,-11,0
182,5008814,F,N,Y,0,283500.0,Pensioner,Higher education,Separated,House / apartment,-22464,365243,1,0,0,0,,1.0,-12,0
183,5008814,F,N,Y,0,283500.0,Pensioner,Higher education,Separated,House / apartment,-22464,365243,1,0,0,0,,1.0,-13,0
184,5008814,F,N,Y,0,283500.0,Pensioner,Higher education,Separated,House / apartment,-22464,365243,1,0,0,0,,1.0,-14,0
185,5008814,F,N,Y,0,283500.0,Pensioner,Higher education,Separated,House / apartment,-22464,365243,1,0,0,0,,1.0,-15,0
186,5008814,F,N,Y,0,283500.0,Pensioner,Higher education,Separated,House / apartment,-22464,365243,1,0,0,0,,1.0,-16,0
187,5008814,F,N,Y,0,283500.0,Pensioner,Higher education,Separated,House / apartment,-22464,365243,1,0,0,0,,1.0,-17,X
188,5008815,M,Y,Y,0,270000.0,Working,Higher education,Married,House / apartment,-16872,-769,1,1,1,1,Accountants,2.0,0,0
189,5008815,M,Y,Y,0,270000.0,Working,Higher education,Married,House / apartment,-16872,-769,1,1,1,1,Accountants,2.0,-1,0
190,5008815,M,Y,Y,0,270000.0,Working,Higher education,Married,House / apartment,-16872,-769,1,1,1,1,Accountants,2.0,-2,0
191,5008815,M,Y,Y,0,270000.0,Working,Higher education,Married,House / apartment,-16872,-769,1,1,1,1,Accountants,2.0,-3,0
192,5008815,M,Y,Y,0,270000.0,Working,Higher education,Married,House / apartment,-16872,-769,1,1,1,1,Accountants,2.0,-4,0
193,5008815,M,Y,Y,0,270000.0,Working,Higher education,Married,House / apartment,-16872,-769,1,1,1,1,Accountants,2.0,-5,0
194,5112956,M,Y,Y,0,270000.0,Working,Higher education,Married,House / apartment,-16872,-769,1,1,1,1,Accountants,2.0,0,X
195,5112956,M,Y,Y,0,270000.0,Working,Higher education,Married,House / apartment,-16872,-769,1,1,1,1,Accountants,2.0,-1,X
196,5112956,M,Y,Y,0,270000.0,Working,Higher education,Married,House / apartment,-16872,-769,1,1,1,1,Accountants,2.0,-2,X
197,5112956,M,Y,Y,0,270000.0,Working,Higher education,Married,House / apartment,-16872,-769,1,1,1,1,Accountants,2.0,-3,0
198,5112956,M,Y,Y,0,270000.0,Working,Higher education,Married,House / apartment,-16872,-769,1,1,1,1,Accountants,2.0,-4,0
199,5112956,M,Y,Y,0,270000.0,Working,Higher education,Married,House / apartment,-16872,-769,1,1,1,1,Accountants,2.0,-5,0
200,5112956,M,Y,Y,0,270000.0,Working,Higher education,Married,House / apartment,-16872,-769,1,1,1,1,Accountants,2.0,-6,0
201,5112956,M,Y,Y,0,270000.0,Working,Higher education,Married,House / apartment,-16872,-769,1,1,1,1,Accountants,2.0,-7,0
202,5112956,M,Y,Y,0,270000.0,Working,Higher education,Married,House / apartment,-16872,-769,1,1,1,1,Accountants,2.0,-8,0
203,5112956,M,Y,Y,0,270000.0,Working,Higher education,Married,House / apartment,-16872,-769,1,1,1,1,Accountants,2.0,-9,0
204,5112956,M,Y,Y,0,270000.0,Working,Higher education,Married,House / apartment,-16872,-769,1,1,1,1,Accountants,2.0,-10,X
205,5112956,M,Y,Y,0,270000.0,Working,Higher education,Married,House / apartment,-16872,-769,1,1,1,1,Accountants,2.0,-11,0
206,5112956,M,Y,Y,0,270000.0,Working,Higher education,Married,House / apartment,-16872,-769,1,1,1,1,Accountants,2.0,-12,0
207,5112956,M,Y,Y,0,270000.0,Working,Higher education,Married,House / apartment,-16872,-769,1,1,1,1,Accountants,2.0,-13,0
208,5112956,M,Y,Y,0,270000.0,Working,Higher education,Married,House / apartment,-16872,-769,1,1,1,1,Accountants,2.0,-14,0
209,5112956,M,Y,Y,0,270000.0,Working,Higher education,Married,House / apartment,-16872,-769,1,1,1,1,Accountants,2.0,-15,0
210,5112956,M,Y,Y,0,270000.0,Working,Higher education,Married,House / apartment,-16872,-769,1,1,1,1,Accountants,2.0,-16,0
211,5112956,M,Y,Y,0,270000.0,Working,Higher education,Married,House / apartment,-16872,-769,1,1,1,1,Accountants,2.0,-17,0
212,5112956,M,Y,Y,0,270000.0,Working,Higher education,Married,House / apartment,-16872,-769,1,1,1,1,Accountants,2.0,-18,0
213,5112956,M,Y,Y,0,270000.0,Working,Higher education,Married,House / apartment,-16872,-769,1,1,1,1,Accountants,2.0,-19,0
214,5112956,M,Y,Y,0,270000.0,Working,Higher education,Married,House / apartment,-16872,-769,1,1,1,1,Accountants,2.0,-20,0
215,5112956,M,Y,Y,0,270000.0,Working,Higher education,Married,House / apartment,-16872,-769,1,1,1,1,Accountants,2.0,-21,X
216,5112956,M,Y,Y,0,270000.0,Working,Higher education,Married,House / apartment,-16872,-769,1,1,1,1,Accountants,2.0,-22,0
217,5112956,M,Y,Y,0,270000.0,Working,Higher education,Married,House / apartment,-16872,-769,1,1,1,1,Accountants,2.0,-23,0
218,5112956,M,Y,Y,0,270000.0,Working,Higher education,Married,House / apartment,-16872,-769,1,1,1,1,Accountants,2.0,-24,0
219,5112956,M,Y,Y,0,270000.0,Working,Higher education,Married,House / apartment,-16872,-769,1,1,1,1,Accountants,2.0,-25,X
220,5112956,M,Y,Y,0,270000.0,Working,Higher education,Married,House / apartment,-16872,-769,1,1,1,1,Accountants,2.0,-26,0
221,5112956,M,Y,Y,0,270000.0,Working,Higher education,Married,House / apartment,-16872,-769,1,1,1,1,Accountants,2.0,-27,0
222,5112956,M,Y,Y,0,270000.0,Working,Higher education,Married,House / apartment,-16872,-769,1,1,1,1,Accountants,2.0,-28,0
223,5112956,M,Y,Y,0,270000.0,Working,Higher education,Married,House / apartment,-16872,-769,1,1,1,1,Accountants,2.0,-29,0
224,5112956,M,Y,Y,0,270000.0,Working,Higher education,Married,House / apartment,-16872,-769,1,1,1,1,Accountants,2.0,-30,X
225,5112956,M,Y,Y,0,270000.0,Working,Higher education,Married,House / apartment,-16872,-769,1,1,1,1,Accountants,2.0,-31,0
226,5112956,M,Y,Y,0,270000.0,Working,Higher education,Married,House / apartment,-16872,-769,1,1,1,1,Accountants,2.0,-32,0
227,5112956,M,Y,Y,0,270000.0,Working,Higher education,Married,House / apartment,-16872,-769,1,1,1,1,Accountants,2.0,-33,X
228,5112956,M,Y,Y,0,270000.0,Working,Higher education,Married,House / apartment,-16872,-769,1,1,1,1,Accountants,2.0,-34,0
229,5112956,M,Y,Y,0,270000.0,Working,Higher education,Married,House / apartment,-16872,-769,1,1,1,1,Accountants,2.0,-35,0
230,5112956,M,Y,Y,0,270000.0,Working,Higher education,Married,House / apartment,-16872,-769,1,1,1,1,Accountants,2.0,-36,0
231,5112956,M,Y,Y,0,270000.0,Working,Higher education,Married,House / apartment,-16872,-769,1,1,1,1,Accountants,2.0,-37,0
232,5112956,M,Y,Y,0,270000.0,Working,Higher education,Married,House / apartment,-16872,-769,1,1,1,1,Accountants,2.0,-38,0
233,5112956,M,Y,Y,0,270000.0,Working,Higher education,Married,House / apartment,-16872,-769,1,1,1,1,Accountants,2.0,-39,0
234,5112956,M,Y,Y,0,270000.0,Working,Higher education,Married,House / apartment,-16872,-769,1,1,1,1,Accountants,2.0,-40,0
235,5112956,M,Y,Y,0,270000.0,Working,Higher education,Married,House / apartment,-16872,-769,1,1,1,1,Accountants,2.0,-41,0
236,5112956,M,Y,Y,0,270000.0,Working,Higher education,Married,House / apartment,-16872,-769,1,1,1,1,Accountants,2.0,-42,0
237,5008819,M,Y,Y,0,135000.0,Commercial associate,Secondary / secondary special,Married,House / apartment,-17778,-1194,1,0,0,0,Laborers,2.0,-10,X
238,5008819,M,Y,Y,0,135000.0,Commercial associate,Secondary / secondary special,Married,House / apartment,-17778,-1194,1,0,0,0,Laborers,2.0,-11,X
239,5008819,M,Y,Y,0,135000.0,Commercial associate,Secondary / secondary special,Married,House / apartment,-17778,-1194,1,0,0,0,Laborers,2.0,-12,X
240,5008819,M,Y,Y,0,135000.0,Commercial associate,Secondary / secondary special,Married,House / apartment,-17778,-1194,1,0,0,0,Laborers,2.0,-13,X
241,5008819,M,Y,Y,0,135000.0,Commercial associate,Secondary / secondary special,Married,House / apartment,-17778,-1194,1,0,0,0,Laborers,2.0,-14,X
242,5008819,M,Y,Y,0,135000.0,Commercial associate,Secondary / secondary special,Married,House / apartment,-17778,-1194,1,0,0,0,Laborers,2.0,-15,X
243,5008819,M,Y,Y,0,135000.0,Commercial associate,Secondary / secondary special,Married,House / apartment,-17778,-1194,1,0,0,0,Laborers,2.0,-16,X
244,5008819,M,Y,Y,0,135000.0,Commercial associate,Secondary / secondary special,Married,House / apartment,-17778,-1194,1,0,0,0,Laborers,2.0,-17,X
245,5008820,M,Y,Y,0,135000.0,Commercial associate,Secondary / secondary special,Married,House / apartment,-17778,-1194,1,0,0,0,Laborers,2.0,-8,X
246,5008820,M,Y,Y,0,135000.0,Commercial associate,Secondary / secondary special,Married,House / apartment,-17778,-1194,1,0,0,0,Laborers,2.0,-9,X
247,5008820,M,Y,Y,0,135000.0,Commercial associate,Secondary / secondary special,Married,House / apartment,-17778,-1194,1,0,0,0,Laborers,2.0,-10,0
248,5008820,M,Y,Y,0,135000.0,Commercial associate,Secondary / secondary special,Married,House / apartment,-17778,-1194,1,0,0,0,Laborers,2.0,-11,X
249,5008820,M,Y,Y,0,135000.0,Commercial associate,Secondary / secondary special,Married,House / apartment,-17778,-1194,1,0,0,0,Laborers,2.0,-12,X
250,5008820,M,Y,Y,0,135000.0,Commercial associate,Secondary / secondary special,Married,House / apartment,-17778,-1194,1,0,0,0,Laborers,2.0,-13,X
251,5008820,M,Y,Y,0,135000.0,Commercial associate,Secondary / secondary special,Married,House / apartment,-17778,-1194,1,0,0,0,Laborers,2.0,-14,X
252,5008820,M,Y,Y,0,135000.0,Commercial associate,Secondary / secondary special,Married,House / apartment,-17778,-1194,1,0,0,0,Laborers,2.0,-15,X
253,5008820,M,Y,Y,0,135000.0,Commercial associate,Secondary / secondary special,Married,House / apartment,-17778,-1194,1,0,0,0,Laborers,2.0,-16,X
254,5008821,M,Y,Y,0,135000.0,Commercial associate,Secondary / secondary special,Married,House / apartment,-17778,-1194,1,0,0,0,Laborers,2.0,0,X
255,5008821,M,Y,Y,0,135000.0,Commercial associate,Secondary / secondary special,Married,House / apartment,-17778,-1194,1,0,0,0,Laborers,2.0,-1,0
256,5008821,M,Y,Y,0,135000.0,Commercial associate,Secondary / secondary special,Married,House / apartment,-17778,-1194,1,0,0,0,Laborers,2.0,-2,0
257,5008821,M,Y,Y,0,135000.0,Commercial associate,Secondary / secondary special,Married,House / apartment,-17778,-1194,1,0,0,0,Laborers,2.0,-3,0
258,5008821,M,Y,Y,0,135000.0,Commercial associate,Secondary / secondary special,Married,House / apartment,-17778,-1194,1,0,0,0,Laborers,2.0,-4,X
259,5008821,M,Y,Y,0,135000.0,Commercial associate,Secondary / secondary special,Married,House / apartment,-17778,-1194,1,0,0,0,Laborers,2.0,-5,0
260,5008821,M,Y,Y,0,135000.0,Commercial associate,Secondary / secondary special,Married,House / apartment,-17778,-1194,1,0,0,0,Laborers,2.0,-6,0
261,5008821,M,Y,Y,0,135000.0,Commercial associate,Secondary / secondary special,Married,House / apartment,-17778,-1194,1,0,0,0,Laborers,2.0,-7,0
262,5008821,M,Y,Y,0,135000.0,Commercial associate,Secondary / secondary special,Married,House / apartment,-17778,-1194,1,0,0,0,Laborers,2.0,-8,X
263,5008822,M,Y,Y,0,135000.0,Commercial associate,Secondary / secondary special,Married,House / apartment,-17778,-1194,1,0,0,0,Laborers,2.0,-14,X
264,5008822,M,Y,Y,0,135000.0,Commercial associate,Secondary / secondary special,Married,House / apartment,-17778,-1194,1,0,0,0,Laborers,2.0,-15,X
265,5008822,M,Y,Y,0,135000.0,Commercial associate,Secondary / secondary special,Married,House / apartment,-17778,-1194,1,0,0,0,Laborers,2.0,-16,0
266,5008822,M,Y,Y,0,135000.0,Commercial associate,Secondary / secondary special,Married,House / apartment,-17778,-1194,1,0,0,0,Laborers,2.0,-17,X
267,5008822,M,Y,Y,0,135000.0,Commercial associate,Secondary / secondary special,Married,House / apartment,-17778,-1194,1,0,0,0,Laborers,2.0,-18,X
268,5008822,M,Y,Y,0,135000.0,Commercial associate,Secondary / secondary special,Married,House / apartment,-17778,-1194,1,0,0,0,Laborers,2.0,-19,X
269,5008822,M,Y,Y,0,135000.0,Commercial associate,Secondary / secondary special,Married,House / apartment,-17778,-1194,1,0,0,0,Laborers,2.0,-20,X
270,5008822,M,Y,Y,0,135000.0,Commercial associate,Secondary / secondary special,Married,House / apartment,-17778,-1194,1,0,0,0,Laborers,2.0,-21,X
271,5008822,M,Y,Y,0,135000.0,Commercial associate,Secondary / secondary special,Married,House / apartment,-17778,-1194,1,0,0,0,Laborers,2.0,-22,X
272,5008823,M,Y,Y,0,135000.0,Commercial associate,Secondary / secondary special,Married,House / apartment,-17778,-1194,1,0,0,0,Laborers,2.0,-3,X
273,5008823,M,Y,Y,0,135000.0,Commercial associate,Secondary / secondary special,Married,House / apartment,-17778,-1194,1,0,0,0,Laborers,2.0,-4,0
274,5008823,M,Y,Y,0,135000.0,Commercial associate,Secondary / secondary special,Married,House / apartment,-17778,-1194,1,0,0,0,Laborers,2.0,-5,0
275,5008823,M,Y,Y,0,135000.0,Commercial associate,Secondary / secondary special,Married,House / apartment,-17778,-1194,1,0,0,0,Laborers,2.0,-6,0
276,5008823,M,Y,Y,0,135000.0,Commercial associate,Secondary / secondary special,Married,House / apartment,-17778,-1194,1,0,0,0,Laborers,2.0,-7,0
277,5008824,M,Y,Y,0,135000.0,Commercial associate,Secondary / secondary special,Married,House / apartment,-17778,-1194,1,0,0,0,Laborers,2.0,0,0
278,5008824,M,Y,Y,0,135000.0,Commercial associate,Secondary / secondary special,Married,House / apartment,-17778,-1194,1,0,0,0,Laborers,2.0,-1,0
279,5008824,M,Y,Y,0,135000.0,Commercial associate,Secondary / secondary special,Married,House / apartment,-17778,-1194,1,0,0,0,Laborers,2.0,-2,0
280,5008824,M,Y,Y,0,135000.0,Commercial associate,Secondary / secondary special,Married,House / apartment,-17778,-1194,1,0,0,0,Laborers,2.0,-3,0
281,5008825,F,Y,N,0,130500.0,Working,Incomplete higher,Married,House / apartment,-10669,-1103,1,0,0,0,Accountants,2.0,0,0
282,5008825,F,Y,N,0,130500.0,Working,Incomplete higher,Married,House / apartment,-10669,-1103,1,0,0,0,Accountants,2.0,-1,0
283,5008825,F,Y,N,0,130500.0,Working,Incomplete higher,Married,House / apartment,-10669,-1103,1,0,0,0,Accountants,2.0,-2,0
284,5008825,F,Y,N,0,130500.0,Working,Incomplete higher,Married,House / apartment,-10669,-1103,1,0,0,0,Accountants,2.0,-3,0
285,5008825,F,Y,N,0,130500.0,Working,Incomplete higher,Married,House / apartment,-10669,-1103,1,0,0,0,Accountants,2.0,-4,0
286,5008825,F,Y,N,0,130500.0,Working,Incomplete higher,Married,House / apartment,-10669,-1103,1,0,0,0,Accountants,2.0,-5,0
287,5008825,F,Y,N,0,130500.0,Working,Incomplete higher,Married,House / apartment,-10669,-1103,1,0,0,0,Accountants,2.0,-6,0
288,5008825,F,Y,N,0,130500.0,Working,Incomplete higher,Married,House / apartment,-10669,-1103,1,0,0,0,Accountants,2.0,-7,0
289,5008825,F,Y,N,0,130500.0,Working,Incomplete higher,Married,House / apartment,-10669,-1103,1,0,0,0,Accountants,2.0,-8,0
290,5008825,F,Y,N,0,130500.0,Working,Incomplete higher,Married,House / apartment,-10669,-1103,1,0,0,0,Accountants,2.0,-9,0
291,5008825,F,Y,N,0,130500.0,Working,Incomplete higher,Married,House / apartment,-10669,-1103,1,0,0,0,Accountants,2.0,-10,0
292,5008825,F,Y,N,0,130500.0,Working,Incomplete higher,Married,House / apartment,-10669,-1103,1,0,0,0,Accountants,2.0,-11,0
293,5008825,F,Y,N,0,130500.0,Working,Incomplete higher,Married,House / apartment,-10669,-1103,1,0,0,0,Accountants,2.0,-12,0
294,5008825,F,Y,N,0,130500.0,Working,Incomplete higher,Married,House / apartment,-10669,-1103,1,0,0,0,Accountants,2.0,-13,0
295,5008825,F,Y,N,0,130500.0,Working,Incomplete higher,Married,House / apartment,-10669,-1103,1,0,0,0,Accountants,2.0,-14,0
296,5008825,F,Y,N,0,130500.0,Working,Incomplete higher,Married,House / apartment,-10669,-1103,1,0,0,0,Accountants,2.0,-15,0
297,5008825,F,Y,N,0,130500.0,Working,Incomplete higher,Married,House / apartment,-10669,-1103,1,0,0,0,Accountants,2.0,-16,0
298,5008825,F,Y,N,0,130500.0,Working,Incomplete higher,Married,House / apartment,-10669,-1103,1,0,0,0,Accountants,2.0,-17,0
299,5008825,F,Y,N,0,130500.0,Working,Incomplete higher,Married,House / apartment,-10669,-1103,1,0,0,0,Accountants,2.0,-18,0
300,5008825,F,Y,N,0,130500.0,Working,Incomplete higher,Married,House / apartment,-10669,-1103,1,0,0,0,Accountants,2.0,-19,0
301,5008825,F,Y,N,0,130500.0,Working,Incomplete higher,Married,House / apartment,-10669,-1103,1,0,0,0,Accountants,2.0,-20,1
302,5008825,F,Y,N,0,130500.0,Working,Incomplete higher,Married,House / apartment,-10669,-1103,1,0,0,0,Accountants,2.0,-21,0
303,5008825,F,Y,N,0,130500.0,Working,Incomplete higher,Married,House / apartment,-10669,-1103,1,0,0,0,Accountants,2.0,-22,0
304,5008825,F,Y,N,0,130500.0,Working,Incomplete higher,Married,House / apartment,-10669,-1103,1,0,0,0,Accountants,2.0,-23,0
305,5008825,F,Y,N,0,130500.0,Working,Incomplete higher,Married,House / apartment,-10669,-1103,1,0,0,0,Accountants,2.0,-24,0
306,5008825,F,Y,N,0,130500.0,Working,Incomplete higher,Married,House / apartment,-10669,-1103,1,0,0,0,Accountants,2.0,-25,0
307,5008826,F,Y,N,0,130500.0,Working,Incomplete higher,Married,House / apartment,-10669,-1103,1,0,0,0,Accountants,2.0,-1,C
308,5008826,F,Y,N,0,130500.0,Working,Incomplete higher,Married,House / apartment,-10669,-1103,1,0,0,0,Accountants,2.0,-2,C
309,5008826,F,Y,N,0,130500.0,Working,Incomplete higher,Married,House / apartment,-10669,-1103,1,0,0,0,Accountants,2.0,-3,C
310,5008826,F,Y,N,0,130500.0,Working,Incomplete higher,Married,House / apartment,-10669,-1103,1,0,0,0,Accountants,2.0,-4,C
311,5008826,F,Y,N,0,130500.0,Working,Incomplete higher,Married,House / apartment,-10669,-1103,1,0,0,0,Accountants,2.0,-5,C
312,5008826,F,Y,N,0,130500.0,Working,Incomplete higher,Married,House / apartment,-10669,-1103,1,0,0,0,Accountants,2.0,-6,C
313,5008826,F,Y,N,0,130500.0,Working,Incomplete higher,Married,House / apartment,-10669,-1103,1,0,0,0,Accountants,2.0,-7,C
314,5008826,F,Y,N,0,130500.0,Working,Incomplete higher,Married,House / apartment,-10669,-1103,1,0,0,0,Accountants,2.0,-8,C
315,5008826,F,Y,N,0,130500.0,Working,Incomplete higher,Married,House / apartment,-10669,-1103,1,0,0,0,Accountants,2.0,-9,C
316,5008826,F,Y,N,0,130500.0,Working,Incomplete higher,Married,House / apartment,-10669,-1103,1,0,0,0,Accountants,2.0,-10,C
317,5008826,F,Y,N,0,130500.0,Working,Incomplete higher,Married,House / apartment,-10669,-1103,1,0,0,0,Accountants,2.0,-11,C
318,5008826,F,Y,N,0,130500.0,Working,Incomplete higher,Married,House / apartment,-10669,-1103,1,0,0,0,Accountants,2.0,-12,C
319,5008826,F,Y,N,0,130500.0,Working,Incomplete higher,Married,House / apartment,-10669,-1103,1,0,0,0,Accountants,2.0,-13,C
320,5008826,F,Y,N,0,130500.0,Working,Incomplete higher,Married,House / apartment,-10669,-1103,1,0,0,0,Accountants,2.0,-14,C
321,5008826,F,Y,N,0,130500.0,Working,Incomplete higher,Married,House / apartment,-10669,-1103,1,0,0,0,Accountants,2.0,-15,C
322,5008826,F,Y,N,0,130500.0,Working,Incomplete higher,Married,House / apartment,-10669,-1103,1,0,0,0,Accountants,2.0,-16,C
323,5008826,F,Y,N,0,130500.0,Working,Incomplete higher,Married,House / apartment,-10669,-1103,1,0,0,0,Accountants,2.0,-17,C
324,5008826,F,Y,N,0,130500.0,Working,Incomplete higher,Married,House / apartment,-10669,-1103,1,0,0,0,Accountants,2.0,-18,C
325,5008826,F,Y,N,0,130500.0,Working,Incomplete higher,Married,House / apartment,-10669,-1103,1,0,0,0,Accountants,2.0,-19,1
326,5008826,F,Y,N,0,130500.0,Working,Incomplete higher,Married,House / apartment,-10669,-1103,1,0,0,0,Accountants,2.0,-20,1
327,5008826,F,Y,N,0,130500.0,Working,Incomplete higher,Married,House / apartment,-10669,-1103,1,0,0,0,Accountants,2.0,-21,0
328,5008826,F,Y,N,0,130500.0,Working,Incomplete higher,Married,House / apartment,-10669,-1103,1,0,0,0,Accountants,2.0,-22,0
329,5008826,F,Y,N,0,130500.0,Working,Incomplete higher,Married,House / apartment,-10669,-1103,1,0,0,0,Accountants,2.0,-23,1
330,5008826,F,Y,N,0,130500.0,Working,Incomplete higher,Married,House / apartment,-10669,-1103,1,0,0,0,Accountants,2.0,-24,1
331,5008826,F,Y,N,0,130500.0,Working,Incomplete higher,Married,House / apartment,-10669,-1103,1,0,0,0,Accountants,2.0,-25,1
332,5008826,F,Y,N,0,130500.0,Working,Incomplete higher,Married,House / apartment,-10669,-1103,1,0,0,0,Accountants,2.0,-26,0
333,5008826,F,Y,N,0,130500.0,Working,Incomplete higher,Married,House / apartment,-10669,-1103,1,0,0,0,Accountants,2.0,-27,1
334,5008826,F,Y,N,0,130500.0,Working,Incomplete higher,Married,House / apartment,-10669,-1103,1,0,0,0,Accountants,2.0,-28,1
335,5008826,F,Y,N,0,130500.0,Working,Incomplete higher,Married,House / apartment,-10669,-1103,1,0,0,0,Accountants,2.0,-29,0
336,5008826,F,Y,N,0,130500.0,Working,Incomplete higher,Married,House / apartment,-10669,-1103,1,0,0,0,Accountants,2.0,-30,0
337,5008830,F,N,Y,0,157500.0,Working,Secondary / secondary special,Married,House / apartment,-10031,-1469,1,0,1,0,Laborers,2.0,0,C
338,5008830,F,N,Y,0,157500.0,Working,Secondary / secondary special,Married,House / apartment,-10031,-1469,1,0,1,0,Laborers,2.0,-1,C
339,5008830,F,N,Y,0,157500.0,Working,Secondary / secondary special,Married,House / apartment,-10031,-1469,1,0,1,0,Laborers,2.0,-2,C
340,5008830,F,N,Y,0,157500.0,Working,Secondary / secondary special,Married,House / apartment,-10031,-1469,1,0,1,0,Laborers,2.0,-3,C
341,5008830,F,N,Y,0,157500.0,Working,Secondary / secondary special,Married,House / apartment,-10031,-1469,1,0,1,0,Laborers,2.0,-4,C
342,5008830,F,N,Y,0,157500.0,Working,Secondary / secondary special,Married,House / apartment,-10031,-1469,1,0,1,0,Laborers,2.0,-5,C
343,5008830,F,N,Y,0,157500.0,Working,Secondary / secondary special,Married,House / apartment,-10031,-1469,1,0,1,0,Laborers,2.0,-6,C
344,5008830,F,N,Y,0,157500.0,Working,Secondary / secondary special,Married,House / apartment,-10031,-1469,1,0,1,0,Laborers,2.0,-7,C
345,5008830,F,N,Y,0,157500.0,Working,Secondary / secondary special,Married,House / apartment,-10031,-1469,1,0,1,0,Laborers,2.0,-8,C
346,5008830,F,N,Y,0,157500.0,Working,Secondary / secondary special,Married,House / apartment,-10031,-1469,1,0,1,0,Laborers,2.0,-9,C
347,5008830,F,N,Y,0,157500.0,Working,Secondary / secondary special,Married,House / apartment,-10031,-1469,1,0,1,0,Laborers,2.0,-10,C
348,5008830,F,N,Y,0,157500.0,Working,Secondary / secondary special,Married,House / apartment,-10031,-1469,1,0,1,0,Laborers,2.0,-11,C
349,5008830,F,N,Y,0,157500.0,Working,Secondary / secondary special,Married,House / apartment,-10031,-1469,1,0,1,0,Laborers,2.0,-12,C
350,5008830,F,N,Y,0,157500.0,Working,Secondary / secondary special,Married,House / apartment,-10031,-1469,1,0,1,0,Laborers,2.0,-13,C
351,5008830,F,N,Y,0,157500.0,Working,Secondary / secondary special,Married,House / apartment,-10031,-1469,1,0,1,0,Laborers,2.0,-14,C
352,5008830,F,N,Y,0,157500.0,Working,Secondary / secondary special,Married,House / apartment,-10031,-1469,1,0,1,0,Laborers,2.0,-15,C
353,5008830,F,N,Y,0,157500.0,Working,Secondary / secondary special,Married,House / apartment,-10031,-1469,1,0,1,0,Laborers,2.0,-16,0
354,5008830,F,N,Y,0,157500.0,Working,Secondary / secondary special,Married,House / apartment,-10031,-1469,1,0,1,0,Laborers,2.0,-17,1
355,5008830,F,N,Y,0,157500.0,Working,Secondary / secondary special,Married,House / apartment,-10031,-1469,1,0,1,0,Laborers,2.0,-18,0
356,5008830,F,N,Y,0,157500.0,Working,Secondary / secondary special,Married,House / apartment,-10031,-1469,1,0,1,0,Laborers,2.0,-19,0
357,5008830,F,N,Y,0,157500.0,Working,Secondary / secondary special,Married,House / apartment,-10031,-1469,1,0,1,0,Laborers,2.0,-20,1
358,5008830,F,N,Y,0,157500.0,Working,Secondary / secondary special,Married,House / apartment,-10031,-1469,1,0,1,0,Laborers,2.0,-21,0
359,5008830,F,N,Y,0,157500.0,Working,Secondary / secondary special,Married,House / apartment,-10031,-1469,1,0,1,0,Laborers,2.0,-22,0
360,5008830,F,N,Y,0,157500.0,Working,Secondary / secondary special,Married,House / apartment,-10031,-1469,1,0,1,0,Laborers,2.0,-23,0
361,5008830,F,N,Y,0,157500.0,Working,Secondary / secondary special,Married,House / apartment,-10031,-1469,1,0,1,0,Laborers,2.0,-24,0
362,5008830,F,N,Y,0,157500.0,Working,Secondary / secondary special,Married,House / apartment,-10031,-1469,1,0,1,0,Laborers,2.0,-25,0
363,5008830,F,N,Y,0,157500.0,Working,Secondary / secondary special,Married,House / apartment,-10031,-1469,1,0,1,0,Laborers,2.0,-26,0
364,5008830,F,N,Y,0,157500.0,Working,Secondary / secondary special,Married,House / apartment,-10031,-1469,1,0,1,0,Laborers,2.0,-27,0
365,5008830,F,N,Y,0,157500.0,Working,Secondary / secondary special,Married,House / apartment,-10031,-1469,1,0,1,0,Laborers,2.0,-28,0
366,5008830,F,N,Y,0,157500.0,Working,Secondary / secondary special,Married,House / apartment,-10031,-1469,1,0,1,0,Laborers,2.0,-29,0
367,5008830,F,N,Y,0,157500.0,Working,Secondary / secondary special,Married,House / apartment,-10031,-1469,1,0,1,0,Laborers,2.0,-30,0
368,5008830,F,N,Y,0,157500.0,Working,Secondary / secondary special,Married,House / apartment,-10031,-1469,1,0,1,0,Laborers,2.0,-31,X
369,5008831,F,N,Y,0,157500.0,Working,Secondary / secondary special,Married,House / apartment,-10031,-1469,1,0,1,0,Laborers,2.0,0,C
370,5008831,F,N,Y,0,157500.0,Working,Secondary / secondary special,Married,House / apartment,-10031,-1469,1,0,1,0,Laborers,2.0,-1,C
371,5008831,F,N,Y,0,157500.0,Working,Secondary / secondary special,Married,House / apartment,-10031,-1469,1,0,1,0,Laborers,2.0,-2,C
372,5008831,F,N,Y,0,157500.0,Working,Secondary / secondary special,Married,House / apartment,-10031,-1469,1,0,1,0,Laborers,2.0,-3,C
373,5008831,F,N,Y,0,157500.0,Working,Secondary / secondary special,Married,House / apartment,-10031,-1469,1,0,1,0,Laborers,2.0,-4,0
374,5008831,F,N,Y,0,157500.0,Working,Secondary / secondary special,Married,House / apartment,-10031,-1469,1,0,1,0,Laborers,2.0,-5,1
375,5008831,F,N,Y,0,157500.0,Working,Secondary / secondary special,Married,House / apartment,-10031,-1469,1,0,1,0,Laborers,2.0,-6,0
376,5008831,F,N,Y,0,157500.0,Working,Secondary / secondary special,Married,House / apartment,-10031,-1469,1,0,1,0,Laborers,2.0,-7,0
377,5008831,F,N,Y,0,157500.0,Working,Secondary / secondary special,Married,House / apartment,-10031,-1469,1,0,1,0,Laborers,2.0,-8,1
378,5008831,F,N,Y,0,157500.0,Working,Secondary / secondary special,Married,House / apartment,-10031,-1469,1,0,1,0,Laborers,2.0,-9,0
379,5008831,F,N,Y,0,157500.0,Working,Secondary / secondary special,Married,House / apartment,-10031,-1469,1,0,1,0,Laborers,2.0,-10,0
380,5008831,F,N,Y,0,157500.0,Working,Secondary / secondary special,Married,House / apartment,-10031,-1469,1,0,1,0,Laborers,2.0,-11,0
381,5008831,F,N,Y,0,157500.0,Working,Secondary / secondary special,Married,House / apartment,-10031,-1469,1,0,1,0,Laborers,2.0,-12,0
382,5008831,F,N,Y,0,157500.0,Working,Secondary / secondary special,Married,House / apartment,-10031,-1469,1,0,1,0,Laborers,2.0,-13,0
383,5008831,F,N,Y,0,157500.0,Working,Secondary / secondary special,Married,House / apartment,-10031,-1469,1,0,1,0,Laborers,2.0,-14,0
384,5008831,F,N,Y,0,157500.0,Working,Secondary / secondary special,Married,House / apartment,-10031,-1469,1,0,1,0,Laborers,2.0,-15,0
385,5008831,F,N,Y,0,157500.0,Working,Secondary / secondary special,Married,House / apartment,-10031,-1469,1,0,1,0,Laborers,2.0,-16,0
386,5008831,F,N,Y,0,157500.0,Working,Secondary / secondary special,Married,House / apartment,-10031,-1469,1,0,1,0,Laborers,2.0,-17,0
387,5008831,F,N,Y,0,157500.0,Working,Secondary / secondary special,Married,House / apartment,-10031,-1469,1,0,1,0,Laborers,2.0,-18,0
388,5008831,F,N,Y,0,157500.0,Working,Secondary / secondary special,Married,House / apartment,-10031,-1469,1,0,1,0,Laborers,2.0,-19,X
389,5008832,F,N,Y,0,157500.0,Working,Secondary / secondary special,Married,House / apartment,-10031,-1469,1,0,1,0,Laborers,2.0,0,C
390,5008832,F,N,Y,0,157500.0,Working,Secondary / secondary special,Married,House / apartment,-10031,-1469,1,0,1,0,Laborers,2.0,-1,C
391,5008832,F,N,Y,0,157500.0,Working,Secondary / secondary special,Married,House / apartment,-10031,-1469,1,0,1,0,Laborers,2.0,-2,C
392,5008832,F,N,Y,0,157500.0,Working,Secondary / secondary special,Married,House / apartment,-10031,-1469,1,0,1,0,Laborers,2.0,-3,C
393,5008832,F,N,Y,0,157500.0,Working,Secondary / secondary special,Married,House / apartment,-10031,-1469,1,0,1,0,Laborers,2.0,-4,C
394,5008832,F,N,Y,0,157500.0,Working,Secondary / secondary special,Married,House / apartment,-10031,-1469,1,0,1,0,Laborers,2.0,-5,C
395,5008832,F,N,Y,0,157500.0,Working,Secondary / secondary special,Married,House / apartment,-10031,-1469,1,0,1,0,Laborers,2.0,-6,C
396,5008832,F,N,Y,0,157500.0,Working,Secondary / secondary special,Married,House / apartment,-10031,-1469,1,0,1,0,Laborers,2.0,-7,C
397,5008832,F,N,Y,0,157500.0,Working,Secondary / secondary special,Married,House / apartment,-10031,-1469,1,0,1,0,Laborers,2.0,-8,C
398,5008832,F,N,Y,0,157500.0,Working,Secondary / secondary special,Married,House / apartment,-10031,-1469,1,0,1,0,Laborers,2.0,-9,C
399,5008832,F,N,Y,0,157500.0,Working,Secondary / secondary special,Married,House / apartment,-10031,-1469,1,0,1,0,Laborers,2.0,-10,C
400,5008832,F,N,Y,0,157500.0,Working,Secondary / secondary special,Married,House / apartment,-10031,-1469,1,0,1,0,Laborers,2.0,-11,C
401,5008832,F,N,Y,0,157500.0,Working,Secondary / secondary special,Married,House / apartment,-10031,-1469,1,0,1,0,Laborers,2.0,-12,C
402,5008832,F,N,Y,0,157500.0,Working,Secondary / secondary special,Married,House / apartment,-10031,-1469,1,0,1,0,Laborers,2.0,-13,C
403,5008832,F,N,Y,0,157500.0,Working,Secondary / secondary special,Married,House / apartment,-10031,-1469,1,0,1,0,Laborers,2.0,-14,C
404,5008832,F,N,Y,0,157500.0,Working,Secondary / secondary special,Married,House / apartment,-10031,-1469,1,0,1,0,Laborers,2.0,-15,C
405,5008832,F,N,Y,0,157500.0,Working,Secondary / secondary special,Married,House / apartment,-10031,-1469,1,0,1,0,Laborers,2.0,-16,C
406,5008832,F,N,Y,0,157500.0,Working,Secondary / secondary special,Married,House / apartment,-10031,-1469,1,0,1,0,Laborers,2.0,-17,C
407,5008832,F,N,Y,0,157500.0,Working,Secondary / secondary special,Married,House / apartment,-10031,-1469,1,0,1,0,Laborers,2.0,-18,C
408,5008832,F,N,Y,0,157500.0,Working,Secondary / secondary special,Married,House / apartment,-10031,-1469,1,0,1,0,Laborers,2.0,-19,0
409,5008832,F,N,Y,0,157500.0,Working,Secondary / secondary special,Married,House / apartment,-10031,-1469,1,0,1,0,Laborers,2.0,-20,1
410,5008832,F,N,Y,0,157500.0,Working,Secondary / secondary special,Married,House / apartment,-10031,-1469,1,0,1,0,Laborers,2.0,-21,0
411,5008832,F,N,Y,0,157500.0,Working,Secondary / secondary special,Married,House / apartment,-10031,-1469,1,0,1,0,Laborers,2.0,-22,0
412,5008832,F,N,Y,0,157500.0,Working,Secondary / secondary special,Married,House / apartment,-10031,-1469,1,0,1,0,Laborers,2.0,-23,1
413,5008832,F,N,Y,0,157500.0,Working,Secondary / secondary special,Married,House / apartment,-10031,-1469,1,0,1,0,Laborers,2.0,-24,0
414,5008832,F,N,Y,0,157500.0,Working,Secondary / secondary special,Married,House / apartment,-10031,-1469,1,0,1,0,Laborers,2.0,-25,0
415,5008832,F,N,Y,0,157500.0,Working,Secondary / secondary special,Married,House / apartment,-10031,-1469,1,0,1,0,Laborers,2.0,-26,0
416,5008832,F,N,Y,0,157500.0,Working,Secondary / secondary special,Married,House / apartment,-10031,-1469,1,0,1,0,Laborers,2.0,-27,0
417,5008832,F,N,Y,0,157500.0,Working,Secondary / secondary special,Married,House / apartment,-10031,-1469,1,0,1,0,Laborers,2.0,-28,0
418,5008832,F,N,Y,0,157500.0,Working,Secondary / secondary special,Married,House / apartment,-10031,-1469,1,0,1,0,Laborers,2.0,-29,0
419,5008832,F,N,Y,0,157500.0,Working,Secondary / secondary special,Married,House / apartment,-10031,-1469,1,0,1,0,Laborers,2.0,-30,0
420,5008832,F,N,Y,0,157500.0,Working,Secondary / secondary special,Married,House / apartment,-10031,-1469,1,0,1,0,Laborers,2.0,-31,0
421,5008832,F,N,Y,0,157500.0,Working,Secondary / secondary special,Married,House / apartment,-10031,-1469,1,0,1,0,Laborers,2.0,-32,0
422,5008832,F,N,Y,0,157500.0,Working,Secondary / secondary special,Married,House / apartment,-10031,-1469,1,0,1,0,Laborers,2.0,-33,0
423,5008832,F,N,Y,0,157500.0,Working,Secondary / secondary special,Married,House / apartment,-10031,-1469,1,0,1,0,Laborers,2.0,-34,X
424,5008834,F,N,Y,1,112500.0,Working,Secondary / secondary special,Single / not married,House / apartment,-10968,-1620,1,0,0,0,,2.0,0,C
425,5008834,F,N,Y,1,112500.0,Working,Secondary / secondary special,Single / not married,House / apartment,-10968,-1620,1,0,0,0,,2.0,-1,C
426,5008834,F,N,Y,1,112500.0,Working,Secondary / secondary special,Single / not married,House / apartment,-10968,-1620,1,0,0,0,,2.0,-2,C
427,5008834,F,N,Y,1,112500.0,Working,Secondary / secondary special,Single / not married,House / apartment,-10968,-1620,1,0,0,0,,2.0,-3,C
428,5008834,F,N,Y,1,112500.0,Working,Secondary / secondary special,Single / not married,House / apartment,-10968,-1620,1,0,0,0,,2.0,-4,C
429,5008834,F,N,Y,1,112500.0,Working,Secondary / secondary special,Single / not married,House / apartment,-10968,-1620,1,0,0,0,,2.0,-5,C
430,5008834,F,N,Y,1,112500.0,Working,Secondary / secondary special,Single / not married,House / apartment,-10968,-1620,1,0,0,0,,2.0,-6,C
431,5008834,F,N,Y,1,112500.0,Working,Secondary / secondary special,Single / not married,House / apartment,-10968,-1620,1,0,0,0,,2.0,-7,C
432,5008834,F,N,Y,1,112500.0,Working,Secondary / secondary special,Single / not married,House / apartment,-10968,-1620,1,0,0,0,,2.0,-8,C
433,5008834,F,N,Y,1,112500.0,Working,Secondary / secondary special,Single / not married,House / apartment,-10968,-1620,1,0,0,0,,2.0,-9,C
434,5008834,F,N,Y,1,112500.0,Working,Secondary / secondary special,Single / not married,House / apartment,-10968,-1620,1,0,0,0,,2.0,-10,C
435,5008834,F,N,Y,1,112500.0,Working,Secondary / secondary special,Single / not married,House / apartment,-10968,-1620,1,0,0,0,,2.0,-11,C
436,5008834,F,N,Y,1,112500.0,Working,Secondary / secondary special,Single / not married,House / apartment,-10968,-1620,1,0,0,0,,2.0,-12,C
437,5008834,F,N,Y,1,112500.0,Working,Secondary / secondary special,Single / not married,House / apartment,-10968,-1620,1,0,0,0,,2.0,-13,C
438,5008834,F,N,Y,1,112500.0,Working,Secondary / secondary special,Single / not married,House / apartment,-10968,-1620,1,0,0,0,,2.0,-14,C
439,5008834,F,N,Y,1,112500.0,Working,Secondary / secondary special,Single / not married,House / apartment,-10968,-1620,1,0,0,0,,2.0,-15,C
440,5008834,F,N,Y,1,112500.0,Working,Secondary / secondary special,Single / not married,House / apartment,-10968,-1620,1,0,0,0,,2.0,-16,C
441,5008834,F,N,Y,1,112500.0,Working,Secondary / secondary special,Single / not married,House / apartment,-10968,-1620,1,0,0,0,,2.0,-17,C
442,5008834,F,N,Y,1,112500.0,Working,Secondary / secondary special,Single / not married,House / apartment,-10968,-1620,1,0,0,0,,2.0,-18,C
443,5008834,F,N,Y,1,112500.0,Working,Secondary / secondary special,Single / not married,House / apartment,-10968,-1620,1,0,0,0,,2.0,-19,C
444,5008834,F,N,Y,1,112500.0,Working,Secondary / secondary special,Single / not married,House / apartment,-10968,-1620,1,0,0,0,,2.0,-20,C
445,5008834,F,N,Y,1,112500.0,Working,Secondary / secondary special,Single / not married,House / apartment,-10968,-1620,1,0,0,0,,2.0,-21,C
446,5008834,F,N,Y,1,112500.0,Working,Secondary / secondary special,Single / not married,House / apartment,-10968,-1620,1,0,0,0,,2.0,-22,C
447,5008834,F,N,Y,1,112500.0,Working,Secondary / secondary special,Single / not married,House / apartment,-10968,-1620,1,0,0,0,,2.0,-23,C
448,5008834,F,N,Y,1,112500.0,Working,Secondary / secondary special,Single / not married,House / apartment,-10968,-1620,1,0,0,0,,2.0,-24,C
449,5008834,F,N,Y,1,112500.0,Working,Secondary / secondary special,Single / not married,House / apartment,-10968,-1620,1,0,0,0,,2.0,-25,C
450,5008834,F,N,Y,1,112500.0,Working,Secondary / secondary special,Single / not married,House / apartment,-10968,-1620,1,0,0,0,,2.0,-26,C
451,5008834,F,N,Y,1,112500.0,Working,Secondary / secondary special,Single / not married,House / apartment,-10968,-1620,1,0,0,0,,2.0,-27,C
452,5008834,F,N,Y,1,112500.0,Working,Secondary / secondary special,Single / not married,House / apartment,-10968,-1620,1,0,0,0,,2.0,-28,C
453,5008834,F,N,Y,1,112500.0,Working,Secondary / secondary special,Single / not married,House / apartment,-10968,-1620,1,0,0,0,,2.0,-29,C
454,5008834,F,N,Y,1,112500.0,Working,Secondary / secondary special,Single / not married,House / apartment,-10968,-1620,1,0,0,0,,2.0,-30,C
455,5008834,F,N,Y,1,112500.0,Working,Secondary / secondary special,Single / not married,House / apartment,-10968,-1620,1,0,0,0,,2.0,-31,C
456,5008834,F,N,Y,1,112500.0,Working,Secondary / secondary special,Single / not married,House / apartment,-10968,-1620,1,0,0,0,,2.0,-32,C
457,5008834,F,N,Y,1,112500.0,Working,Secondary / secondary special,Single / not married,House / apartment,-10968,-1620,1,0,0,0,,2.0,-33,C
458,5008834,F,N,Y,1,112500.0,Working,Secondary / secondary special,Single / not married,House / apartment,-10968,-1620,1,0,0,0,,2.0,-34,C
459,5008834,F,N,Y,1,112500.0,Working,Secondary / secondary special,Single / not married,House / apartment,-10968,-1620,1,0,0,0,,2.0,-35,C
460,5008834,F,N,Y,1,112500.0,Working,Secondary / secondary special,Single / not married,House / apartment,-10968,-1620,1,0,0,0,,2.0,-36,C
461,5008834,F,N,Y,1,112500.0,Working,Secondary / secondary special,Single / not married,House / apartment,-10968,-1620,1,0,0,0,,2.0,-37,C
462,5008834,F,N,Y,1,112500.0,Working,Secondary / secondary special,Single / not married,House / apartment,-10968,-1620,1,0,0,0,,2.0,-38,C
463,5008834,F,N,Y,1,112500.0,Working,Secondary / secondary special,Single / not married,House / apartment,-10968,-1620,1,0,0,0,,2.0,-39,C
464,5008834,F,N,Y,1,112500.0,Working,Secondary / secondary special,Single / not married,House / apartment,-10968,-1620,1,0,0,0,,2.0,-40,0
465,5008834,F,N,Y,1,112500.0,Working,Secondary / secondary special,Single / not married,House / apartment,-10968,-1620,1,0,0,0,,2.0,-41,0
466,5008834,F,N,Y,1,112500.0,Working,Secondary / secondary special,Single / not married,House / apartment,-10968,-1620,1,0,0,0,,2.0,-42,0
467,5008834,F,N,Y,1,112500.0,Working,Secondary / secondary special,Single / not married,House / apartment,-10968,-1620,1,0,0,0,,2.0,-43,0
468,5008834,F,N,Y,1,112500.0,Working,Secondary / secondary special,Single / not married,House / apartment,-10968,-1620,1,0,0,0,,2.0,-44,0
469,5008835,F,N,Y,1,112500.0,Working,Secondary / secondary special,Single / not married,House / apartment,-10968,-1620,1,0,0,0,,2.0,-28,X
470,5008835,F,N,Y,1,112500.0,Working,Secondary / secondary special,Single / not married,House / apartment,-10968,-1620,1,0,0,0,,2.0,-29,X
471,5008835,F,N,Y,1,112500.0,Working,Secondary / secondary special,Single / not married,House / apartment,-10968,-1620,1,0,0,0,,2.0,-30,X
472,5008835,F,N,Y,1,112500.0,Working,Secondary / secondary special,Single / not married,House / apartment,-10968,-1620,1,0,0,0,,2.0,-31,X
473,5008835,F,N,Y,1,112500.0,Working,Secondary / secondary special,Single / not married,House / apartment,-10968,-1620,1,0,0,0,,2.0,-32,X
474,5008835,F,N,Y,1,112500.0,Working,Secondary / secondary special,Single / not married,House / apartment,-10968,-1620,1,0,0,0,,2.0,-33,X
475,5008835,F,N,Y,1,112500.0,Working,Secondary / secondary special,Single / not married,House / apartment,-10968,-1620,1,0,0,0,,2.0,-34,X
476,5008835,F,N,Y,1,112500.0,Working,Secondary / secondary special,Single / not married,House / apartment,-10968,-1620,1,0,0,0,,2.0,-35,X
477,5008835,F,N,Y,1,112500.0,Working,Secondary / secondary special,Single / not married,House / apartment,-10968,-1620,1,0,0,0,,2.0,-36,X
478,5008835,F,N,Y,1,112500.0,Working,Secondary / secondary special,Single / not married,House / apartment,-10968,-1620,1,0,0,0,,2.0,-37,X
479,5008835,F,N,Y,1,112500.0,Working,Secondary / secondary special,Single / not married,House / apartment,-10968,-1620,1,0,0,0,,2.0,-38,X
480,5008835,F,N,Y,1,112500.0,Working,Secondary / secondary special,Single / not married,House / apartment,-10968,-1620,1,0,0,0,,2.0,-39,X
481,5008835,F,N,Y,1,112500.0,Working,Secondary / secondary special,Single / not married,House / apartment,-10968,-1620,1,0,0,0,,2.0,-40,X
482,5008835,F,N,Y,1,112500.0,Working,Secondary / secondary special,Single / not married,House / apartment,-10968,-1620,1,0,0,0,,2.0,-41,X
483,5008835,F,N,Y,1,112500.0,Working,Secondary / secondary special,Single / not married,House / apartment,-10968,-1620,1,0,0,0,,2.0,-42,0
484,5008835,F,N,Y,1,112500.0,Working,Secondary / secondary special,Single / not married,House / apartment,-10968,-1620,1,0,0,0,,2.0,-43,0
485,5008835,F,N,Y,1,112500.0,Working,Secondary / secondary special,Single / not married,House / apartment,-10968,-1620,1,0,0,0,,2.0,-44,0
486,5008836,M,Y,Y,3,270000.0,Working,Secondary / secondary special,Married,House / apartment,-12689,-1163,1,0,0,0,Laborers,5.0,-8,C
487,5008836,M,Y,Y,3,270000.0,Working,Secondary / secondary special,Married,House / apartment,-12689,-1163,1,0,0,0,Laborers,5.0,-9,C
488,5008836,M,Y,Y,3,270000.0,Working,Secondary / secondary special,Married,House / apartment,-12689,-1163,1,0,0,0,Laborers,5.0,-10,C
489,5008836,M,Y,Y,3,270000.0,Working,Secondary / secondary special,Married,House / apartment,-12689,-1163,1,0,0,0,Laborers,5.0,-11,C
490,5008836,M,Y,Y,3,270000.0,Working,Secondary / secondary special,Married,House / apartment,-12689,-1163,1,0,0,0,Laborers,5.0,-12,C
491,5008836,M,Y,Y,3,270000.0,Working,Secondary / secondary special,Married,House / apartment,-12689,-1163,1,0,0,0,Laborers,5.0,-13,C
492,5008836,M,Y,Y,3,270000.0,Working,Secondary / secondary special,Married,House / apartment,-12689,-1163,1,0,0,0,Laborers,5.0,-14,C
493,5008836,M,Y,Y,3,270000.0,Working,Secondary / secondary special,Married,House / apartment,-12689,-1163,1,0,0,0,Laborers,5.0,-15,C
494,5008836,M,Y,Y,3,270000.0,Working,Secondary / secondary special,Married,House / apartment,-12689,-1163,1,0,0,0,Laborers,5.0,-16,C
495,5008836,M,Y,Y,3,270000.0,Working,Secondary / secondary special,Married,House / apartment,-12689,-1163,1,0,0,0,Laborers,5.0,-17,C
496,5008836,M,Y,Y,3,270000.0,Working,Secondary / secondary special,Married,House / apartment,-12689,-1163,1,0,0,0,Laborers,5.0,-18,C
497,5008836,M,Y,Y,3,270000.0,Working,Secondary / secondary special,Married,House / apartment,-12689,-1163,1,0,0,0,Laborers,5.0,-19,C
498,5008836,M,Y,Y,3,270000.0,Working,Secondary / secondary special,Married,House / apartment,-12689,-1163,1,0,0,0,Laborers,5.0,-20,C
499,5008836,M,Y,Y,3,270000.0,Working,Secondary / secondary special,Married,House / apartment,-12689,-1163,1,0,0,0,Laborers,5.0,-21,C
500,5008836,M,Y,Y,3,270000.0,Working,Secondary / secondary special,Married,House / apartment,-12689,-1163,1,0,0,0,Laborers,5.0,-22,C
501,5008836,M,Y,Y,3,270000.0,Working,Secondary / secondary special,Married,House / apartment,-12689,-1163,1,0,0,0,Laborers,5.0,-23,C
502,5008836,M,Y,Y,3,270000.0,Working,Secondary / secondary special,Married,House / apartment,-12689,-1163,1,0,0,0,Laborers,5.0,-24,0
503,5008837,M,Y,Y,3,270000.0,Working,Secondary / secondary special,Married,House / apartment,-12689,-1163,1,0,0,0,Laborers,5.0,-2,C
504,5008837,M,Y,Y,3,270000.0,Working,Secondary / secondary special,Married,House / apartment,-12689,-1163,1,0,0,0,Laborers,5.0,-3,C
505,5008837,M,Y,Y,3,270000.0,Working,Secondary / secondary special,Married,House / apartment,-12689,-1163,1,0,0,0,Laborers,5.0,-4,C
506,5008837,M,Y,Y,3,270000.0,Working,Secondary / secondary special,Married,House / apartment,-12689,-1163,1,0,0,0,Laborers,5.0,-5,C
507,5008837,M,Y,Y,3,270000.0,Working,Secondary / secondary special,Married,House / apartment,-12689,-1163,1,0,0,0,Laborers,5.0,-6,C
508,5008837,M,Y,Y,3,270000.0,Working,Secondary / secondary special,Married,House / apartment,-12689,-1163,1,0,0,0,Laborers,5.0,-7,C
509,5008837,M,Y,Y,3,270000.0,Working,Secondary / secondary special,Married,House / apartment,-12689,-1163,1,0,0,0,Laborers,5.0,-8,C
510,5008837,M,Y,Y,3,270000.0,Working,Secondary / secondary special,Married,House / apartment,-12689,-1163,1,0,0,0,Laborers,5.0,-9,C
511,5008837,M,Y,Y,3,270000.0,Working,Secondary / secondary special,Married,House / apartment,-12689,-1163,1,0,0,0,Laborers,5.0,-10,C
512,5008837,M,Y,Y,3,270000.0,Working,Secondary / secondary special,Married,House / apartment,-12689,-1163,1,0,0,0,Laborers,5.0,-11,C
513,5008837,M,Y,Y,3,270000.0,Working,Secondary / secondary special,Married,House / apartment,-12689,-1163,1,0,0,0,Laborers,5.0,-12,C
514,5008837,M,Y,Y,3,270000.0,Working,Secondary / secondary special,Married,House / apartment,-12689,-1163,1,0,0,0,Laborers,5.0,-13,C
515,5008837,M,Y,Y,3,270000.0,Working,Secondary / secondary special,Married,House / apartment,-12689,-1163,1,0,0,0,Laborers,5.0,-14,C
516,5008837,M,Y,Y,3,270000.0,Working,Secondary / secondary special,Married,House / apartment,-12689,-1163,1,0,0,0,Laborers,5.0,-15,C
517,5008837,M,Y,Y,3,270000.0,Working,Secondary / secondary special,Married,House / apartment,-12689,-1163,1,0,0,0,Laborers,5.0,-16,C
518,5008837,M,Y,Y,3,270000.0,Working,Secondary / secondary special,Married,House / apartment,-12689,-1163,1,0,0,0,Laborers,5.0,-17,C
519,5008837,M,Y,Y,3,270000.0,Working,Secondary / secondary special,Married,House / apartment,-12689,-1163,1,0,0,0,Laborers,5.0,-18,0
520,5008838,M,N,Y,1,405000.0,Commercial associate,Higher education,Married,House / apartment,-11842,-2016,1,0,0,0,Managers,3.0,-9,X
521,5008838,M,N,Y,1,405000.0,Commercial associate,Higher education,Married,House / apartment,-11842,-2016,1,0,0,0,Managers,3.0,-10,0
522,5008838,M,N,Y,1,405000.0,Commercial associate,Higher education,Married,House / apartment,-11842,-2016,1,0,0,0,Managers,3.0,-11,0
523,5008838,M,N,Y,1,405000.0,Commercial associate,Higher education,Married,House / apartment,-11842,-2016,1,0,0,0,Managers,3.0,-12,0
524,5008838,M,N,Y,1,405000.0,Commercial associate,Higher education,Married,House / apartment,-11842,-2016,1,0,0,0,Managers,3.0,-13,0
525,5008838,M,N,Y,1,405000.0,Commercial associate,Higher education,Married,House / apartment,-11842,-2016,1,0,0,0,Managers,3.0,-14,0
526,5008838,M,N,Y,1,405000.0,Commercial associate,Higher education,Married,House / apartment,-11842,-2016,1,0,0,0,Managers,3.0,-15,0
527,5008838,M,N,Y,1,405000.0,Commercial associate,Higher education,Married,House / apartment,-11842,-2016,1,0,0,0,Managers,3.0,-16,0
528,5008838,M,N,Y,1,405000.0,Commercial associate,Higher education,Married,House / apartment,-11842,-2016,1,0,0,0,Managers,3.0,-17,0
529,5008838,M,N,Y,1,405000.0,Commercial associate,Higher education,Married,House / apartment,-11842,-2016,1,0,0,0,Managers,3.0,-18,0
530,5008838,M,N,Y,1,405000.0,Commercial associate,Higher education,Married,House / apartment,-11842,-2016,1,0,0,0,Managers,3.0,-19,0
531,5008838,M,N,Y,1,405000.0,Commercial associate,Higher education,Married,House / apartment,-11842,-2016,1,0,0,0,Managers,3.0,-20,0
532,5008838,M,N,Y,1,405000.0,Commercial associate,Higher education,Married,House / apartment,-11842,-2016,1,0,0,0,Managers,3.0,-21,0
533,5008838,M,N,Y,1,405000.0,Commercial associate,Higher education,Married,House / apartment,-11842,-2016,1,0,0,0,Managers,3.0,-22,0
534,5008838,M,N,Y,1,405000.0,Commercial associate,Higher education,Married,House / apartment,-11842,-2016,1,0,0,0,Managers,3.0,-23,0
535,5008838,M,N,Y,1,405000.0,Commercial associate,Higher education,Married,House / apartment,-11842,-2016,1,0,0,0,Managers,3.0,-24,0
536,5008838,M,N,Y,1,405000.0,Commercial associate,Higher education,Married,House / apartment,-11842,-2016,1,0,0,0,Managers,3.0,-25,0
537,5008838,M,N,Y,1,405000.0,Commercial associate,Higher education,Married,House / apartment,-11842,-2016,1,0,0,0,Managers,3.0,-26,0
538,5008838,M,N,Y,1,405000.0,Commercial associate,Higher education,Married,House / apartment,-11842,-2016,1,0,0,0,Managers,3.0,-27,0
539,5008838,M,N,Y,1,405000.0,Commercial associate,Higher education,Married,House / apartment,-11842,-2016,1,0,0,0,Managers,3.0,-28,0
540,5008838,M,N,Y,1,405000.0,Commercial associate,Higher education,Married,House / apartment,-11842,-2016,1,0,0,0,Managers,3.0,-29,0
541,5008838,M,N,Y,1,405000.0,Commercial associate,Higher education,Married,House / apartment,-11842,-2016,1,0,0,0,Managers,3.0,-30,0
542,5008838,M,N,Y,1,405000.0,Commercial associate,Higher education,Married,House / apartment,-11842,-2016,1,0,0,0,Managers,3.0,-31,0
543,5008838,M,N,Y,1,405000.0,Commercial associate,Higher education,Married,House / apartment,-11842,-2016,1,0,0,0,Managers,3.0,-32,0
544,5008838,M,N,Y,1,405000.0,Commercial associate,Higher education,Married,House / apartment,-11842,-2016,1,0,0,0,Managers,3.0,-33,0
545,5008838,M,N,Y,1,405000.0,Commercial associate,Higher education,Married,House / apartment,-11842,-2016,1,0,0,0,Managers,3.0,-34,0
546,5008838,M,N,Y,1,405000.0,Commercial associate,Higher education,Married,House / apartment,-11842,-2016,1,0,0,0,Managers,3.0,-35,0
547,5008838,M,N,Y,1,405000.0,Commercial associate,Higher education,Married,House / apartment,-11842,-2016,1,0,0,0,Managers,3.0,-36,0
548,5008838,M,N,Y,1,405000.0,Commercial associate,Higher education,Married,House / apartment,-11842,-2016,1,0,0,0,Managers,3.0,-37,0
549,5008838,M,N,Y,1,405000.0,Commercial associate,Higher education,Married,House / apartment,-11842,-2016,1,0,0,0,Managers,3.0,-38,0
550,5008838,M,N,Y,1,405000.0,Commercial associate,Higher education,Married,House / apartment,-11842,-2016,1,0,0,0,Managers,3.0,-39,X
551,5008839,M,N,Y,1,405000.0,Commercial associate,Higher education,Married,House / apartment,-11842,-2016,1,0,0,0,Managers,3.0,0,C
552,5008839,M,N,Y,1,405000.0,Commercial associate,Higher education,Married,House / apartment,-11842,-2016,1,0,0,0,Managers,3.0,-1,C
553,5008839,M,N,Y,1,405000.0,Commercial associate,Higher education,Married,House / apartment,-11842,-2016,1,0,0,0,Managers,3.0,-2,C
554,5008839,M,N,Y,1,405000.0,Commercial associate,Higher education,Married,House / apartment,-11842,-2016,1,0,0,0,Managers,3.0,-3,C
555,5008839,M,N,Y,1,405000.0,Commercial associate,Higher education,Married,House / apartment,-11842,-2016,1,0,0,0,Managers,3.0,-4,0
556,5008839,M,N,Y,1,405000.0,Commercial associate,Higher education,Married,House / apartment,-11842,-2016,1,0,0,0,Managers,3.0,-5,0
557,5008839,M,N,Y,1,405000.0,Commercial associate,Higher education,Married,House / apartment,-11842,-2016,1,0,0,0,Managers,3.0,-6,0
558,5008839,M,N,Y,1,405000.0,Commercial associate,Higher education,Married,House / apartment,-11842,-2016,1,0,0,0,Managers,3.0,-7,0
559,5008839,M,N,Y,1,405000.0,Commercial associate,Higher education,Married,House / apartment,-11842,-2016,1,0,0,0,Managers,3.0,-8,0
560,5008839,M,N,Y,1,405000.0,Commercial associate,Higher education,Married,House / apartment,-11842,-2016,1,0,0,0,Managers,3.0,-9,0
561,5008839,M,N,Y,1,405000.0,Commercial associate,Higher education,Married,House / apartment,-11842,-2016,1,0,0,0,Managers,3.0,-10,0
562,5008839,M,N,Y,1,405000.0,Commercial associate,Higher education,Married,House / apartment,-11842,-2016,1,0,0,0,Managers,3.0,-11,0
563,5008839,M,N,Y,1,405000.0,Commercial associate,Higher education,Married,House / apartment,-11842,-2016,1,0,0,0,Managers,3.0,-12,0
564,5008839,M,N,Y,1,405000.0,Commercial associate,Higher education,Married,House / apartment,-11842,-2016,1,0,0,0,Managers,3.0,-13,0
565,5008840,M,N,Y,1,405000.0,Commercial associate,Higher education,Married,House / apartment,-11842,-2016,1,0,0,0,Managers,3.0,0,C
566,5008840,M,N,Y,1,405000.0,Commercial associate,Higher education,Married,House / apartment,-11842,-2016,1,0,0,0,Managers,3.0,-1,C
567,5008840,M,N,Y,1,405000.0,Commercial associate,Higher education,Married,House / apartment,-11842,-2016,1,0,0,0,Managers,3.0,-2,C
568,5008840,M,N,Y,1,405000.0,Commercial associate,Higher education,Married,House / apartment,-11842,-2016,1,0,0,0,Managers,3.0,-3,C
569,5008840,M,N,Y,1,405000.0,Commercial associate,Higher education,Married,House / apartment,-11842,-2016,1,0,0,0,Managers,3.0,-4,C
570,5008840,M,N,Y,1,405000.0,Commercial associate,Higher education,Married,House / apartment,-11842,-2016,1,0,0,0,Managers,3.0,-5,C
571,5008840,M,N,Y,1,405000.0,Commercial associate,Higher education,Married,House / apartment,-11842,-2016,1,0,0,0,Managers,3.0,-6,C
572,5008840,M,N,Y,1,405000.0,Commercial associate,Higher education,Married,House / apartment,-11842,-2016,1,0,0,0,Managers,3.0,-7,C
573,5008840,M,N,Y,1,405000.0,Commercial associate,Higher education,Married,House / apartment,-11842,-2016,1,0,0,0,Managers,3.0,-8,C
574,5008840,M,N,Y,1,405000.0,Commercial associate,Higher education,Married,House / apartment,-11842,-2016,1,0,0,0,Managers,3.0,-9,C
575,5008840,M,N,Y,1,405000.0,Commercial associate,Higher education,Married,House / apartment,-11842,-2016,1,0,0,0,Managers,3.0,-10,C
576,5008840,M,N,Y,1,405000.0,Commercial associate,Higher education,Married,House / apartment,-11842,-2016,1,0,0,0,Managers,3.0,-11,C
577,5008840,M,N,Y,1,405000.0,Commercial associate,Higher education,Married,House / apartment,-11842,-2016,1,0,0,0,Managers,3.0,-12,C
578,5008840,M,N,Y,1,405000.0,Commercial associate,Higher education,Married,House / apartment,-11842,-2016,1,0,0,0,Managers,3.0,-13,C
579,5008840,M,N,Y,1,405000.0,Commercial associate,Higher education,Married,House / apartment,-11842,-2016,1,0,0,0,Managers,3.0,-14,C
580,5008840,M,N,Y,1,405000.0,Commercial associate,Higher education,Married,House / apartment,-11842,-2016,1,0,0,0,Managers,3.0,-15,C
581,5008840,M,N,Y,1,405000.0,Commercial associate,Higher education,Married,House / apartment,-11842,-2016,1,0,0,0,Managers,3.0,-16,C
582,5008840,M,N,Y,1,405000.0,Commercial associate,Higher education,Married,House / apartment,-11842,-2016,1,0,0,0,Managers,3.0,-17,C
583,5008840,M,N,Y,1,405000.0,Commercial associate,Higher education,Married,House / apartment,-11842,-2016,1,0,0,0,Managers,3.0,-18,C
584,5008840,M,N,Y,1,405000.0,Commercial associate,Higher education,Married,House / apartment,-11842,-2016,1,0,0,0,Managers,3.0,-19,C
585,5008840,M,N,Y,1,405000.0,Commercial associate,Higher education,Married,House / apartment,-11842,-2016,1,0,0,0,Managers,3.0,-20,C
586,5008840,M,N,Y,1,405000.0,Commercial associate,Higher education,Married,House / apartment,-11842,-2016,1,0,0,0,Managers,3.0,-21,C
587,5008840,M,N,Y,1,405000.0,Commercial associate,Higher education,Married,House / apartment,-11842,-2016,1,0,0,0,Managers,3.0,-22,C
588,5008840,M,N,Y,1,405000.0,Commercial associate,Higher education,Married,House / apartment,-11842,-2016,1,0,0,0,Managers,3.0,-23,C
589,5008840,M,N,Y,1,405000.0,Commercial associate,Higher education,Married,House / apartment,-11842,-2016,1,0,0,0,Managers,3.0,-24,C
590,5008840,M,N,Y,1,405000.0,Commercial associate,Higher education,Married,House / apartment,-11842,-2016,1,0,0,0,Managers,3.0,-25,C
591,5008840,M,N,Y,1,405000.0,Commercial associate,Higher education,Married,House / apartment,-11842,-2016,1,0,0,0,Managers,3.0,-26,C
592,5008840,M,N,Y,1,405000.0,Commercial associate,Higher education,Married,House / apartment,-11842,-2016,1,0,0,0,Managers,3.0,-27,C
593,5008840,M,N,Y,1,405000.0,Commercial associate,Higher education,Married,House / apartment,-11842,-2016,1,0,0,0,Managers,3.0,-28,C
594,5008840,M,N,Y,1,405000.0,Commercial associate,Higher education,Married,House / apartment,-11842,-2016,1,0,0,0,Managers,3.0,-29,C
595,5008840,M,N,Y,1,405000.0,Commercial associate,Higher education,Married,House / apartment,-11842,-2016,1,0,0,0,Managers,3.0,-30,C
596,5008840,M,N,Y,1,405000.0,Commercial associate,Higher education,Married,House / apartment,-11842,-2016,1,0,0,0,Managers,3.0,-31,C
597,5008840,M,N,Y,1,405000.0,Commercial associate,Higher education,Married,House / apartment,-11842,-2016,1,0,0,0,Managers,3.0,-32,C
598,5008840,M,N,Y,1,405000.0,Commercial associate,Higher education,Married,House / apartment,-11842,-2016,1,0,0,0,Managers,3.0,-33,C
599,5008840,M,N,Y,1,405000.0,Commercial associate,Higher education,Married,House / apartment,-11842,-2016,1,0,0,0,Managers,3.0,-34,C
600,5008840,M,N,Y,1,405000.0,Commercial associate,Higher education,Married,House / apartment,-11842,-2016,1,0,0,0,Managers,3.0,-35,C
601,5008840,M,N,Y,1,405000.0,Commercial associate,Higher education,Married,House / apartment,-11842,-2016,1,0,0,0,Managers,3.0,-36,C
602,5008840,M,N,Y,1,405000.0,Commercial associate,Higher education,Married,House / apartment,-11842,-2016,1,0,0,0,Managers,3.0,-37,C
603,5008840,M,N,Y,1,405000.0,Commercial associate,Higher education,Married,House / apartment,-11842,-2016,1,0,0,0,Managers,3.0,-38,C
604,5008840,M,N,Y,1,405000.0,Commercial associate,Higher education,Married,House / apartment,-11842,-2016,1,0,0,0,Managers,3.0,-39,C
605,5008840,M,N,Y,1,405000.0,Commercial associate,Higher education,Married,House / apartment,-11842,-2016,1,0,0,0,Managers,3.0,-40,C
606,5008840,M,N,Y,1,405000.0,Commercial associate,Higher education,Married,House / apartment,-11842,-2016,1,0,0,0,Managers,3.0,-41,C
607,5008840,M,N,Y,1,405000.0,Commercial associate,Higher education,Married,House / apartment,-11842,-2016,1,0,0,0,Managers,3.0,-42,C
608,5008840,M,N,Y,1,405000.0,Commercial associate,Higher education,Married,House / apartment,-11842,-2016,1,0,0,0,Managers,3.0,-43,C
609,5008840,M,N,Y,1,405000.0,Commercial associate,Higher education,Married,House / apartment,-11842,-2016,1,0,0,0,Managers,3.0,-44,C
610,5008840,M,N,Y,1,405000.0,Commercial associate,Higher education,Married,House / apartment,-11842,-2016,1,0,0,0,Managers,3.0,-45,C
611,5008840,M,N,Y,1,405000.0,Commercial associate,Higher education,Married,House / apartment,-11842,-2016,1,0,0,0,Managers,3.0,-46,0
612,5008840,M,N,Y,1,405000.0,Commercial associate,Higher education,Married,House / apartment,-11842,-2016,1,0,0,0,Managers,3.0,-47,0
613,5008840,M,N,Y,1,405000.0,Commercial associate,Higher education,Married,House / apartment,-11842,-2016,1,0,0,0,Managers,3.0,-48,0
614,5008840,M,N,Y,1,405000.0,Commercial associate,Higher education,Married,House / apartment,-11842,-2016,1,0,0,0,Managers,3.0,-49,0
615,5008840,M,N,Y,1,405000.0,Commercial associate,Higher education,Married,House / apartment,-11842,-2016,1,0,0,0,Managers,3.0,-50,0
616,5008840,M,N,Y,1,405000.0,Commercial associate,Higher education,Married,House / apartment,-11842,-2016,1,0,0,0,Managers,3.0,-51,0
617,5008840,M,N,Y,1,405000.0,Commercial associate,Higher education,Married,House / apartment,-11842,-2016,1,0,0,0,Managers,3.0,-52,0
618,5008840,M,N,Y,1,405000.0,Commercial associate,Higher education,Married,House / apartment,-11842,-2016,1,0,0,0,Managers,3.0,-53,0
619,5008840,M,N,Y,1,405000.0,Commercial associate,Higher education,Married,House / apartment,-11842,-2016,1,0,0,0,Managers,3.0,-54,0
620,5008840,M,N,Y,1,405000.0,Commercial associate,Higher education,Married,House / apartment,-11842,-2016,1,0,0,0,Managers,3.0,-55,0
621,5008841,M,N,Y,1,405000.0,Commercial associate,Higher education,Married,House / apartment,-11842,-2016,1,0,0,0,Managers,3.0,0,0
622,5008841,M,N,Y,1,405000.0,Commercial associate,Higher education,Married,House / apartment,-11842,-2016,1,0,0,0,Managers,3.0,-1,0
623,5008841,M,N,Y,1,405000.0,Commercial associate,Higher education,Married,House / apartment,-11842,-2016,1,0,0,0,Managers,3.0,-2,0
624,5008841,M,N,Y,1,405000.0,Commercial associate,Higher education,Married,House / apartment,-11842,-2016,1,0,0,0,Managers,3.0,-3,0
625,5008841,M,N,Y,1,405000.0,Commercial associate,Higher education,Married,House / apartment,-11842,-2016,1,0,0,0,Managers,3.0,-4,X
626,5008842,M,N,Y,1,405000.0,Commercial associate,Higher education,Married,House / apartment,-11842,-2016,1,0,0,0,Managers,3.0,0,0
627,5008842,M,N,Y,1,405000.0,Commercial associate,Higher education,Married,House / apartment,-11842,-2016,1,0,0,0,Managers,3.0,-1,0
628,5008842,M,N,Y,1,405000.0,Commercial associate,Higher education,Married,House / apartment,-11842,-2016,1,0,0,0,Managers,3.0,-2,0
629,5008842,M,N,Y,1,405000.0,Commercial associate,Higher education,Married,House / apartment,-11842,-2016,1,0,0,0,Managers,3.0,-3,0
630,5008842,M,N,Y,1,405000.0,Commercial associate,Higher education,Married,House / apartment,-11842,-2016,1,0,0,0,Managers,3.0,-4,0
631,5008842,M,N,Y,1,405000.0,Commercial associate,Higher education,Married,House / apartment,-11842,-2016,1,0,0,0,Managers,3.0,-5,0
632,5008842,M,N,Y,1,405000.0,Commercial associate,Higher education,Married,House / apartment,-11842,-2016,1,0,0,0,Managers,3.0,-6,0
633,5008842,M,N,Y,1,405000.0,Commercial associate,Higher education,Married,House / apartment,-11842,-2016,1,0,0,0,Managers,3.0,-7,0
634,5008842,M,N,Y,1,405000.0,Commercial associate,Higher education,Married,House / apartment,-11842,-2016,1,0,0,0,Managers,3.0,-8,0
635,5008843,M,N,Y,1,405000.0,Commercial associate,Higher education,Married,House / apartment,-11842,-2016,1,0,0,0,Managers,3.0,0,C
636,5008843,M,N,Y,1,405000.0,Commercial associate,Higher education,Married,House / apartment,-11842,-2016,1,0,0,0,Managers,3.0,-1,C
637,5008843,M,N,Y,1,405000.0,Commercial associate,Higher education,Married,House / apartment,-11842,-2016,1,0,0,0,Managers,3.0,-2,C
638,5008843,M,N,Y,1,405000.0,Commercial associate,Higher education,Married,House / apartment,-11842,-2016,1,0,0,0,Managers,3.0,-3,C
639,5008843,M,N,Y,1,405000.0,Commercial associate,Higher education,Married,House / apartment,-11842,-2016,1,0,0,0,Managers,3.0,-4,C
640,5008843,M,N,Y,1,405000.0,Commercial associate,Higher education,Married,House / apartment,-11842,-2016,1,0,0,0,Managers,3.0,-5,C
641,5008843,M,N,Y,1,405000.0,Commercial associate,Higher education,Married,House / apartment,-11842,-2016,1,0,0,0,Managers,3.0,-6,C
642,5008843,M,N,Y,1,405000.0,Commercial associate,Higher education,Married,House / apartment,-11842,-2016,1,0,0,0,Managers,3.0,-7,C
643,5008843,M,N,Y,1,405000.0,Commercial associate,Higher education,Married,House / apartment,-11842,-2016,1,0,0,0,Managers,3.0,-8,C
644,5008843,M,N,Y,1,405000.0,Commercial associate,Higher education,Married,House / apartment,-11842,-2016,1,0,0,0,Managers,3.0,-9,C
645,5008843,M,N,Y,1,405000.0,Commercial associate,Higher education,Married,House / apartment,-11842,-2016,1,0,0,0,Managers,3.0,-10,C
646,5008843,M,N,Y,1,405000.0,Commercial associate,Higher education,Married,House / apartment,-11842,-2016,1,0,0,0,Managers,3.0,-11,C
647,5008843,M,N,Y,1,405000.0,Commercial associate,Higher education,Married,House / apartment,-11842,-2016,1,0,0,0,Managers,3.0,-12,C
648,5008843,M,N,Y,1,405000.0,Commercial associate,Higher education,Married,House / apartment,-11842,-2016,1,0,0,0,Managers,3.0,-13,C
649,5008843,M,N,Y,1,405000.0,Commercial associate,Higher education,Married,House / apartment,-11842,-2016,1,0,0,0,Managers,3.0,-14,C
650,5008843,M,N,Y,1,405000.0,Commercial associate,Higher education,Married,House / apartment,-11842,-2016,1,0,0,0,Managers,3.0,-15,C
651,5008843,M,N,Y,1,405000.0,Commercial associate,Higher education,Married,House / apartment,-11842,-2016,1,0,0,0,Managers,3.0,-16,C
652,5008843,M,N,Y,1,405000.0,Commercial associate,Higher education,Married,House / apartment,-11842,-2016,1,0,0,0,Managers,3.0,-17,C
653,5008843,M,N,Y,1,405000.0,Commercial associate,Higher education,Married,House / apartment,-11842,-2016,1,0,0,0,Managers,3.0,-18,C
654,5008843,M,N,Y,1,405000.0,Commercial associate,Higher education,Married,House / apartment,-11842,-2016,1,0,0,0,Managers,3.0,-19,C
655,5008843,M,N,Y,1,405000.0,Commercial associate,Higher education,Married,House / apartment,-11842,-2016,1,0,0,0,Managers,3.0,-20,0
656,5008843,M,N,Y,1,405000.0,Commercial associate,Higher education,Married,House / apartment,-11842,-2016,1,0,0,0,Managers,3.0,-21,0
657,5008843,M,N,Y,1,405000.0,Commercial associate,Higher education,Married,House / apartment,-11842,-2016,1,0,0,0,Managers,3.0,-22,0
658,5008843,M,N,Y,1,405000.0,Commercial associate,Higher education,Married,House / apartment,-11842,-2016,1,0,0,0,Managers,3.0,-23,0
659,5008843,M,N,Y,1,405000.0,Commercial associate,Higher education,Married,House / apartment,-11842,-2016,1,0,0,0,Managers,3.0,-24,0
660,5008843,M,N,Y,1,405000.0,Commercial associate,Higher education,Married,House / apartment,-11842,-2016,1,0,0,0,Managers,3.0,-25,0
661,5008843,M,N,Y,1,405000.0,Commercial associate,Higher education,Married,House / apartment,-11842,-2016,1,0,0,0,Managers,3.0,-26,0
662,5008843,M,N,Y,1,405000.0,Commercial associate,Higher education,Married,House / apartment,-11842,-2016,1,0,0,0,Managers,3.0,-27,0
663,5008843,M,N,Y,1,405000.0,Commercial associate,Higher education,Married,House / apartment,-11842,-2016,1,0,0,0,Managers,3.0,-28,0
664,5008843,M,N,Y,1,405000.0,Commercial associate,Higher education,Married,House / apartment,-11842,-2016,1,0,0,0,Managers,3.0,-29,0
665,5008844,M,Y,Y,0,112500.0,Commercial associate,Secondary / secondary special,Married,House / apartment,-20502,-4450,1,0,1,0,Drivers,2.0,-11,C
666,5008844,M,Y,Y,0,112500.0,Commercial associate,Secondary / secondary special,Married,House / apartment,-20502,-4450,1,0,1,0,Drivers,2.0,-12,C
667,5008844,M,Y,Y,0,112500.0,Commercial associate,Secondary / secondary special,Married,House / apartment,-20502,-4450,1,0,1,0,Drivers,2.0,-13,C
668,5008844,M,Y,Y,0,112500.0,Commercial associate,Secondary / secondary special,Married,House / apartment,-20502,-4450,1,0,1,0,Drivers,2.0,-14,C
669,5008844,M,Y,Y,0,112500.0,Commercial associate,Secondary / secondary special,Married,House / apartment,-20502,-4450,1,0,1,0,Drivers,2.0,-15,C
670,5008844,M,Y,Y,0,112500.0,Commercial associate,Secondary / secondary special,Married,House / apartment,-20502,-4450,1,0,1,0,Drivers,2.0,-16,C
671,5008844,M,Y,Y,0,112500.0,Commercial associate,Secondary / secondary special,Married,House / apartment,-20502,-4450,1,0,1,0,Drivers,2.0,-17,C
672,5008844,M,Y,Y,0,112500.0,Commercial associate,Secondary / secondary special,Married,House / apartment,-20502,-4450,1,0,1,0,Drivers,2.0,-18,0
673,5008844,M,Y,Y,0,112500.0,Commercial associate,Secondary / secondary special,Married,House / apartment,-20502,-4450,1,0,1,0,Drivers,2.0,-19,0
674,5008844,M,Y,Y,0,112500.0,Commercial associate,Secondary / secondary special,Married,House / apartment,-20502,-4450,1,0,1,0,Drivers,2.0,-20,0
675,5008844,M,Y,Y,0,112500.0,Commercial associate,Secondary / secondary special,Married,House / apartment,-20502,-4450,1,0,1,0,Drivers,2.0,-21,0
676,5008844,M,Y,Y,0,112500.0,Commercial associate,Secondary / secondary special,Married,House / apartment,-20502,-4450,1,0,1,0,Drivers,2.0,-22,0
677,5008844,M,Y,Y,0,112500.0,Commercial associate,Secondary / secondary special,Married,House / apartment,-20502,-4450,1,0,1,0,Drivers,2.0,-23,0
678,5008844,M,Y,Y,0,112500.0,Commercial associate,Secondary / secondary special,Married,House / apartment,-20502,-4450,1,0,1,0,Drivers,2.0,-24,0
679,5008844,M,Y,Y,0,112500.0,Commercial associate,Secondary / secondary special,Married,House / apartment,-20502,-4450,1,0,1,0,Drivers,2.0,-25,0
680,5008844,M,Y,Y,0,112500.0,Commercial associate,Secondary / secondary special,Married,House / apartment,-20502,-4450,1,0,1,0,Drivers,2.0,-26,0
681,5008844,M,Y,Y,0,112500.0,Commercial associate,Secondary / secondary special,Married,House / apartment,-20502,-4450,1,0,1,0,Drivers,2.0,-27,0
682,5008844,M,Y,Y,0,112500.0,Commercial associate,Secondary / secondary special,Married,House / apartment,-20502,-4450,1,0,1,0,Drivers,2.0,-28,0
683,5008844,M,Y,Y,0,112500.0,Commercial associate,Secondary / secondary special,Married,House / apartment,-20502,-4450,1,0,1,0,Drivers,2.0,-29,0
684,5008844,M,Y,Y,0,112500.0,Commercial associate,Secondary / secondary special,Married,House / apartment,-20502,-4450,1,0,1,0,Drivers,2.0,-30,0
685,5008844,M,Y,Y,0,112500.0,Commercial associate,Secondary / secondary special,Married,House / apartment,-20502,-4450,1,0,1,0,Drivers,2.0,-31,0
686,5008844,M,Y,Y,0,112500.0,Commercial associate,Secondary / secondary special,Married,House / apartment,-20502,-4450,1,0,1,0,Drivers,2.0,-32,0
687,5008844,M,Y,Y,0,112500.0,Commercial associate,Secondary / secondary special,Married,House / apartment,-20502,-4450,1,0,1,0,Drivers,2.0,-33,0
688,5008844,M,Y,Y,0,112500.0,Commercial associate,Secondary / secondary special,Married,House / apartment,-20502,-4450,1,0,1,0,Drivers,2.0,-34,0
689,5008844,M,Y,Y,0,112500.0,Commercial associate,Secondary / secondary special,Married,House / apartment,-20502,-4450,1,0,1,0,Drivers,2.0,-35,0
690,5008844,M,Y,Y,0,112500.0,Commercial associate,Secondary / secondary special,Married,House / apartment,-20502,-4450,1,0,1,0,Drivers,2.0,-36,0
691,5008844,M,Y,Y,0,112500.0,Commercial associate,Secondary / secondary special,Married,House / apartment,-20502,-4450,1,0,1,0,Drivers,2.0,-37,0
692,5008844,M,Y,Y,0,112500.0,Commercial associate,Secondary / secondary special,Married,House / apartment,-20502,-4450,1,0,1,0,Drivers,2.0,-38,0
693,5008844,M,Y,Y,0,112500.0,Commercial associate,Secondary / secondary special,Married,House / apartment,-20502,-4450,1,0,1,0,Drivers,2.0,-39,0
694,5008844,M,Y,Y,0,112500.0,Commercial associate,Secondary / secondary special,Married,House / apartment,-20502,-4450,1,0,1,0,Drivers,2.0,-40,0
695,5008844,M,Y,Y,0,112500.0,Commercial associate,Secondary / secondary special,Married,House / apartment,-20502,-4450,1,0,1,0,Drivers,2.0,-41,0
696,5008844,M,Y,Y,0,112500.0,Commercial associate,Secondary / secondary special,Married,House / apartment,-20502,-4450,1,0,1,0,Drivers,2.0,-42,0
697,5008844,M,Y,Y,0,112500.0,Commercial associate,Secondary / secondary special,Married,House / apartment,-20502,-4450,1,0,1,0,Drivers,2.0,-43,0
698,5008846,M,Y,Y,0,112500.0,Commercial associate,Secondary / secondary special,Married,House / apartment,-20502,-4450,1,0,1,0,Drivers,2.0,0,0
699,5008846,M,Y,Y,0,112500.0,Commercial associate,Secondary / secondary special,Married,House / apartment,-20502,-4450,1,0,1,0,Drivers,2.0,-1,0
700,5008846,M,Y,Y,0,112500.0,Commercial associate,Secondary / secondary special,Married,House / apartment,-20502,-4450,1,0,1,0,Drivers,2.0,-2,0
701,5008846,M,Y,Y,0,112500.0,Commercial associate,Secondary / secondary special,Married,House / apartment,-20502,-4450,1,0,1,0,Drivers,2.0,-3,0
702,5008846,M,Y,Y,0,112500.0,Commercial associate,Secondary / secondary special,Married,House / apartment,-20502,-4450,1,0,1,0,Drivers,2.0,-4,0
703,5008846,M,Y,Y,0,112500.0,Commercial associate,Secondary / secondary special,Married,House / apartment,-20502,-4450,1,0,1,0,Drivers,2.0,-5,0
704,5008846,M,Y,Y,0,112500.0,Commercial associate,Secondary / secondary special,Married,House / apartment,-20502,-4450,1,0,1,0,Drivers,2.0,-6,0
705,5008846,M,Y,Y,0,112500.0,Commercial associate,Secondary / secondary special,Married,House / apartment,-20502,-4450,1,0,1,0,Drivers,2.0,-7,0
706,5008846,M,Y,Y,0,112500.0,Commercial associate,Secondary / secondary special,Married,House / apartment,-20502,-4450,1,0,1,0,Drivers,2.0,-8,0
707,5008846,M,Y,Y,0,112500.0,Commercial associate,Secondary / secondary special,Married,House / apartment,-20502,-4450,1,0,1,0,Drivers,2.0,-9,0
708,5008846,M,Y,Y,0,112500.0,Commercial associate,Secondary / secondary special,Married,House / apartment,-20502,-4450,1,0,1,0,Drivers,2.0,-10,0
709,5008846,M,Y,Y,0,112500.0,Commercial associate,Secondary / secondary special,Married,House / apartment,-20502,-4450,1,0,1,0,Drivers,2.0,-11,0
710,5008847,M,Y,Y,0,112500.0,Commercial associate,Secondary / secondary special,Married,House / apartment,-20502,-4450,1,0,1,0,Drivers,2.0,-14,C
711,5008847,M,Y,Y,0,112500.0,Commercial associate,Secondary / secondary special,Married,House / apartment,-20502,-4450,1,0,1,0,Drivers,2.0,-15,C
712,5008847,M,Y,Y,0,112500.0,Commercial associate,Secondary / secondary special,Married,House / apartment,-20502,-4450,1,0,1,0,Drivers,2.0,-16,C
713,5008847,M,Y,Y,0,112500.0,Commercial associate,Secondary / secondary special,Married,House / apartment,-20502,-4450,1,0,1,0,Drivers,2.0,-17,C
714,5008847,M,Y,Y,0,112500.0,Commercial associate,Secondary / secondary special,Married,House / apartment,-20502,-4450,1,0,1,0,Drivers,2.0,-18,C
715,5008847,M,Y,Y,0,112500.0,Commercial associate,Secondary / secondary special,Married,House / apartment,-20502,-4450,1,0,1,0,Drivers,2.0,-19,C
716,5008847,M,Y,Y,0,112500.0,Commercial associate,Secondary / secondary special,Married,House / apartment,-20502,-4450,1,0,1,0,Drivers,2.0,-20,C
717,5008847,M,Y,Y,0,112500.0,Commercial associate,Secondary / secondary special,Married,House / apartment,-20502,-4450,1,0,1,0,Drivers,2.0,-21,0
718,5008847,M,Y,Y,0,112500.0,Commercial associate,Secondary / secondary special,Married,House / apartment,-20502,-4450,1,0,1,0,Drivers,2.0,-22,0
719,5008847,M,Y,Y,0,112500.0,Commercial associate,Secondary / secondary special,Married,House / apartment,-20502,-4450,1,0,1,0,Drivers,2.0,-23,0
720,5008847,M,Y,Y,0,112500.0,Commercial associate,Secondary / secondary special,Married,House / apartment,-20502,-4450,1,0,1,0,Drivers,2.0,-24,0
721,5008847,M,Y,Y,0,112500.0,Commercial associate,Secondary / secondary special,Married,House / apartment,-20502,-4450,1,0,1,0,Drivers,2.0,-25,0
722,5008847,M,Y,Y,0,112500.0,Commercial associate,Secondary / secondary special,Married,House / apartment,-20502,-4450,1,0,1,0,Drivers,2.0,-26,0
723,5008847,M,Y,Y,0,112500.0,Commercial associate,Secondary / secondary special,Married,House / apartment,-20502,-4450,1,0,1,0,Drivers,2.0,-27,0
724,5008847,M,Y,Y,0,112500.0,Commercial associate,Secondary / secondary special,Married,House / apartment,-20502,-4450,1,0,1,0,Drivers,2.0,-28,0
725,5008847,M,Y,Y,0,112500.0,Commercial associate,Secondary / secondary special,Married,House / apartment,-20502,-4450,1,0,1,0,Drivers,2.0,-29,0
726,5008847,M,Y,Y,0,112500.0,Commercial associate,Secondary / secondary special,Married,House / apartment,-20502,-4450,1,0,1,0,Drivers,2.0,-30,0
727,5008847,M,Y,Y,0,112500.0,Commercial associate,Secondary / secondary special,Married,House / apartment,-20502,-4450,1,0,1,0,Drivers,2.0,-31,0
728,5008847,M,Y,Y,0,112500.0,Commercial associate,Secondary / secondary special,Married,House / apartment,-20502,-4450,1,0,1,0,Drivers,2.0,-32,0
729,5008847,M,Y,Y,0,112500.0,Commercial associate,Secondary / secondary special,Married,House / apartment,-20502,-4450,1,0,1,0,Drivers,2.0,-33,0
730,5008847,M,Y,Y,0,112500.0,Commercial associate,Secondary / secondary special,Married,House / apartment,-20502,-4450,1,0,1,0,Drivers,2.0,-34,0
731,5008847,M,Y,Y,0,112500.0,Commercial associate,Secondary / secondary special,Married,House / apartment,-20502,-4450,1,0,1,0,Drivers,2.0,-35,0
732,5008847,M,Y,Y,0,112500.0,Commercial associate,Secondary / secondary special,Married,House / apartment,-20502,-4450,1,0,1,0,Drivers,2.0,-36,0
733,5008847,M,Y,Y,0,112500.0,Commercial associate,Secondary / secondary special,Married,House / apartment,-20502,-4450,1,0,1,0,Drivers,2.0,-37,0
734,5008847,M,Y,Y,0,112500.0,Commercial associate,Secondary / secondary special,Married,House / apartment,-20502,-4450,1,0,1,0,Drivers,2.0,-38,0
735,5008847,M,Y,Y,0,112500.0,Commercial associate,Secondary / secondary special,Married,House / apartment,-20502,-4450,1,0,1,0,Drivers,2.0,-39,0
736,5008847,M,Y,Y,0,112500.0,Commercial associate,Secondary / secondary special,Married,House / apartment,-20502,-4450,1,0,1,0,Drivers,2.0,-40,0
737,5008847,M,Y,Y,0,112500.0,Commercial associate,Secondary / secondary special,Married,House / apartment,-20502,-4450,1,0,1,0,Drivers,2.0,-41,0
738,5008847,M,Y,Y,0,112500.0,Commercial associate,Secondary / secondary special,Married,House / apartment,-20502,-4450,1,0,1,0,Drivers,2.0,-42,0
739,5008847,M,Y,Y,0,112500.0,Commercial associate,Secondary / secondary special,Married,House / apartment,-20502,-4450,1,0,1,0,Drivers,2.0,-43,0
740,5008847,M,Y,Y,0,112500.0,Commercial associate,Secondary / secondary special,Married,House / apartment,-20502,-4450,1,0,1,0,Drivers,2.0,-44,0
741,5008847,M,Y,Y,0,112500.0,Commercial associate,Secondary / secondary special,Married,House / apartment,-20502,-4450,1,0,1,0,Drivers,2.0,-45,0
742,5008847,M,Y,Y,0,112500.0,Commercial associate,Secondary / secondary special,Married,House / apartment,-20502,-4450,1,0,1,0,Drivers,2.0,-46,0
743,5008849,M,Y,Y,0,112500.0,Commercial associate,Secondary / secondary special,Married,House / apartment,-20502,-4450,1,0,1,0,Drivers,2.0,-40,C
744,5008849,M,Y,Y,0,112500.0,Commercial associate,Secondary / secondary special,Married,House / apartment,-20502,-4450,1,0,1,0,Drivers,2.0,-41,C
745,5008849,M,Y,Y,0,112500.0,Commercial associate,Secondary / secondary special,Married,House / apartment,-20502,-4450,1,0,1,0,Drivers,2.0,-42,C
746,5008849,M,Y,Y,0,112500.0,Commercial associate,Secondary / secondary special,Married,House / apartment,-20502,-4450,1,0,1,0,Drivers,2.0,-43,C
747,5008849,M,Y,Y,0,112500.0,Commercial associate,Secondary / secondary special,Married,House / apartment,-20502,-4450,1,0,1,0,Drivers,2.0,-44,C
748,5008849,M,Y,Y,0,112500.0,Commercial associate,Secondary / secondary special,Married,House / apartment,-20502,-4450,1,0,1,0,Drivers,2.0,-45,C
749,5008849,M,Y,Y,0,112500.0,Commercial associate,Secondary / secondary special,Married,House / apartment,-20502,-4450,1,0,1,0,Drivers,2.0,-46,0
750,5008849,M,Y,Y,0,112500.0,Commercial associate,Secondary / secondary special,Married,House / apartment,-20502,-4450,1,0,1,0,Drivers,2.0,-47,X
751,5008849,M,Y,Y,0,112500.0,Commercial associate,Secondary / secondary special,Married,House / apartment,-20502,-4450,1,0,1,0,Drivers,2.0,-48,0
752,5008849,M,Y,Y,0,112500.0,Commercial associate,Secondary / secondary special,Married,House / apartment,-20502,-4450,1,0,1,0,Drivers,2.0,-49,0
753,5008849,M,Y,Y,0,112500.0,Commercial associate,Secondary / secondary special,Married,House / apartment,-20502,-4450,1,0,1,0,Drivers,2.0,-50,0
754,5008849,M,Y,Y,0,112500.0,Commercial associate,Secondary / secondary special,Married,House / apartment,-20502,-4450,1,0,1,0,Drivers,2.0,-51,0
755,5008850,M,Y,Y,0,112500.0,Commercial associate,Secondary / secondary special,Married,House / apartment,-20502,-4450,1,0,1,0,Drivers,2.0,0,0
756,5008850,M,Y,Y,0,112500.0,Commercial associate,Secondary / secondary special,Married,House / apartment,-20502,-4450,1,0,1,0,Drivers,2.0,-1,0
757,5008850,M,Y,Y,0,112500.0,Commercial associate,Secondary / secondary special,Married,House / apartment,-20502,-4450,1,0,1,0,Drivers,2.0,-2,0
758,5008850,M,Y,Y,0,112500.0,Commercial associate,Secondary / secondary special,Married,House / apartment,-20502,-4450,1,0,1,0,Drivers,2.0,-3,0
759,5008850,M,Y,Y,0,112500.0,Commercial associate,Secondary / secondary special,Married,House / apartment,-20502,-4450,1,0,1,0,Drivers,2.0,-4,0
760,5008850,M,Y,Y,0,112500.0,Commercial associate,Secondary / secondary special,Married,House / apartment,-20502,-4450,1,0,1,0,Drivers,2.0,-5,0
761,5008850,M,Y,Y,0,112500.0,Commercial associate,Secondary / secondary special,Married,House / apartment,-20502,-4450,1,0,1,0,Drivers,2.0,-6,0
762,5008850,M,Y,Y,0,112500.0,Commercial associate,Secondary / secondary special,Married,House / apartment,-20502,-4450,1,0,1,0,Drivers,2.0,-7,0
763,5008850,M,Y,Y,0,112500.0,Commercial associate,Secondary / secondary special,Married,House / apartment,-20502,-4450,1,0,1,0,Drivers,2.0,-8,0
764,5008850,M,Y,Y,0,112500.0,Commercial associate,Secondary / secondary special,Married,House / apartment,-20502,-4450,1,0,1,0,Drivers,2.0,-9,0
765,5008850,M,Y,Y,0,112500.0,Commercial associate,Secondary / secondary special,Married,House / apartment,-20502,-4450,1,0,1,0,Drivers,2.0,-10,0
766,5008850,M,Y,Y,0,112500.0,Commercial associate,Secondary / secondary special,Married,House / apartment,-20502,-4450,1,0,1,0,Drivers,2.0,-11,0
767,5008850,M,Y,Y,0,112500.0,Commercial associate,Secondary / secondary special,Married,House / apartment,-20502,-4450,1,0,1,0,Drivers,2.0,-12,0
768,5008850,M,Y,Y,0,112500.0,Commercial associate,Secondary / secondary special,Married,House / apartment,-20502,-4450,1,0,1,0,Drivers,2.0,-13,0
769,5008850,M,Y,Y,0,112500.0,Commercial associate,Secondary / secondary special,Married,House / apartment,-20502,-4450,1,0,1,0,Drivers,2.0,-14,0
770,5008850,M,Y,Y,0,112500.0,Commercial associate,Secondary / secondary special,Married,House / apartment,-20502,-4450,1,0,1,0,Drivers,2.0,-15,0
771,5008850,M,Y,Y,0,112500.0,Commercial associate,Secondary / secondary special,Married,House / apartment,-20502,-4450,1,0,1,0,Drivers,2.0,-16,0
772,5008850,M,Y,Y,0,112500.0,Commercial associate,Secondary / secondary special,Married,House / apartment,-20502,-4450,1,0,1,0,Drivers,2.0,-17,0
773,5008850,M,Y,Y,0,112500.0,Commercial associate,Secondary / secondary special,Married,House / apartment,-20502,-4450,1,0,1,0,Drivers,2.0,-18,0
774,5008850,M,Y,Y,0,112500.0,Commercial associate,Secondary / secondary special,Married,House / apartment,-20502,-4450,1,0,1,0,Drivers,2.0,-19,0
775,5008850,M,Y,Y,0,112500.0,Commercial associate,Secondary / secondary special,Married,House / apartment,-20502,-4450,1,0,1,0,Drivers,2.0,-20,0
776,5008850,M,Y,Y,0,112500.0,Commercial associate,Secondary / secondary special,Married,House / apartment,-20502,-4450,1,0,1,0,Drivers,2.0,-21,0
777,5008850,M,Y,Y,0,112500.0,Commercial associate,Secondary / secondary special,Married,House / apartment,-20502,-4450,1,0,1,0,Drivers,2.0,-22,0
778,5008850,M,Y,Y,0,112500.0,Commercial associate,Secondary / secondary special,Married,House / apartment,-20502,-4450,1,0,1,0,Drivers,2.0,-23,0
779,5008850,M,Y,Y,0,112500.0,Commercial associate,Secondary / secondary special,Married,House / apartment,-20502,-4450,1,0,1,0,Drivers,2.0,-24,0
780,5008850,M,Y,Y,0,112500.0,Commercial associate,Secondary / secondary special,Married,House / apartment,-20502,-4450,1,0,1,0,Drivers,2.0,-25,0
781,5008851,M,Y,Y,0,112500.0,Commercial associate,Secondary / secondary special,Married,House / apartment,-20502,-4450,1,0,1,0,Drivers,2.0,0,0
782,5008851,M,Y,Y,0,112500.0,Commercial associate,Secondary / secondary special,Married,House / apartment,-20502,-4450,1,0,1,0,Drivers,2.0,-1,0
783,5008851,M,Y,Y,0,112500.0,Commercial associate,Secondary / secondary special,Married,House / apartment,-20502,-4450,1,0,1,0,Drivers,2.0,-2,0
784,5008851,M,Y,Y,0,112500.0,Commercial associate,Secondary / secondary special,Married,House / apartment,-20502,-4450,1,0,1,0,Drivers,2.0,-3,0
785,5008851,M,Y,Y,0,112500.0,Commercial associate,Secondary / secondary special,Married,House / apartment,-20502,-4450,1,0,1,0,Drivers,2.0,-4,0
786,5008851,M,Y,Y,0,112500.0,Commercial associate,Secondary / secondary special,Married,House / apartment,-20502,-4450,1,0,1,0,Drivers,2.0,-5,0
787,5008851,M,Y,Y,0,112500.0,Commercial associate,Secondary / secondary special,Married,House / apartment,-20502,-4450,1,0,1,0,Drivers,2.0,-6,0
788,5008851,M,Y,Y,0,112500.0,Commercial associate,Secondary / secondary special,Married,House / apartment,-20502,-4450,1,0,1,0,Drivers,2.0,-7,0
789,5008851,M,Y,Y,0,112500.0,Commercial associate,Secondary / secondary special,Married,House / apartment,-20502,-4450,1,0,1,0,Drivers,2.0,-8,0
790,5008851,M,Y,Y,0,112500.0,Commercial associate,Secondary / secondary special,Married,House / apartment,-20502,-4450,1,0,1,0,Drivers,2.0,-9,0
791,5008851,M,Y,Y,0,112500.0,Commercial associate,Secondary / secondary special,Married,House / apartment,-20502,-4450,1,0,1,0,Drivers,2.0,-10,0
792,5008851,M,Y,Y,0,112500.0,Commercial associate,Secondary / secondary special,Married,House / apartment,-20502,-4450,1,0,1,0,Drivers,2.0,-11,0
793,5008852,M,Y,Y,0,112500.0,Commercial associate,Secondary / secondary special,Married,House / apartment,-20502,-4450,1,0,1,0,Drivers,2.0,0,0
794,5008853,M,Y,Y,0,112500.0,Commercial associate,Secondary / secondary special,Married,House / apartment,-20502,-4450,1,0,1,0,Drivers,2.0,-24,C
795,5008853,M,Y,Y,0,112500.0,Commercial associate,Secondary / secondary special,Married,House / apartment,-20502,-4450,1,0,1,0,Drivers,2.0,-25,C
796,5008853,M,Y,Y,0,112500.0,Commercial associate,Secondary / secondary special,Married,House / apartment,-20502,-4450,1,0,1,0,Drivers,2.0,-26,C
797,5008853,M,Y,Y,0,112500.0,Commercial associate,Secondary / secondary special,Married,House / apartment,-20502,-4450,1,0,1,0,Drivers,2.0,-27,C
798,5008853,M,Y,Y,0,112500.0,Commercial associate,Secondary / secondary special,Married,House / apartment,-20502,-4450,1,0,1,0,Drivers,2.0,-28,C
799,5008853,M,Y,Y,0,112500.0,Commercial associate,Secondary / secondary special,Married,House / apartment,-20502,-4450,1,0,1,0,Drivers,2.0,-29,0
800,5008853,M,Y,Y,0,112500.0,Commercial associate,Secondary / secondary special,Married,House / apartment,-20502,-4450,1,0,1,0,Drivers,2.0,-30,0
801,5008853,M,Y,Y,0,112500.0,Commercial associate,Secondary / secondary special,Married,House / apartment,-20502,-4450,1,0,1,0,Drivers,2.0,-31,0
802,5008853,M,Y,Y,0,112500.0,Commercial associate,Secondary / secondary special,Married,House / apartment,-20502,-4450,1,0,1,0,Drivers,2.0,-32,0
803,5008853,M,Y,Y,0,112500.0,Commercial associate,Secondary / secondary special,Married,House / apartment,-20502,-4450,1,0,1,0,Drivers,2.0,-33,0
804,5008853,M,Y,Y,0,112500.0,Commercial associate,Secondary / secondary special,Married,House / apartment,-20502,-4450,1,0,1,0,Drivers,2.0,-34,0
805,5008853,M,Y,Y,0,112500.0,Commercial associate,Secondary / secondary special,Married,House / apartment,-20502,-4450,1,0,1,0,Drivers,2.0,-35,0
806,5008853,M,Y,Y,0,112500.0,Commercial associate,Secondary / secondary special,Married,House / apartment,-20502,-4450,1,0,1,0,Drivers,2.0,-36,0
807,5008853,M,Y,Y,0,112500.0,Commercial associate,Secondary / secondary special,Married,House / apartment,-20502,-4450,1,0,1,0,Drivers,2.0,-37,0
808,5008853,M,Y,Y,0,112500.0,Commercial associate,Secondary / secondary special,Married,House / apartment,-20502,-4450,1,0,1,0,Drivers,2.0,-38,0
809,5008853,M,Y,Y,0,112500.0,Commercial associate,Secondary / secondary special,Married,House / apartment,-20502,-4450,1,0,1,0,Drivers,2.0,-39,0
810,5008854,F,Y,Y,2,135000.0,Working,Secondary / secondary special,Married,House / apartment,-15761,-3173,1,0,0,0,Laborers,4.0,-38,0
811,5008854,F,Y,Y,2,135000.0,Working,Secondary / secondary special,Married,House / apartment,-15761,-3173,1,0,0,0,Laborers,4.0,-39,0
812,5008855,F,Y,Y,2,135000.0,Working,Secondary / secondary special,Married,House / apartment,-15761,-3173,1,0,0,0,Laborers,4.0,0,C
813,5008855,F,Y,Y,2,135000.0,Working,Secondary / secondary special,Married,House / apartment,-15761,-3173,1,0,0,0,Laborers,4.0,-1,C
814,5008855,F,Y,Y,2,135000.0,Working,Secondary / secondary special,Married,House / apartment,-15761,-3173,1,0,0,0,Laborers,4.0,-2,C
815,5008855,F,Y,Y,2,135000.0,Working,Secondary / secondary special,Married,House / apartment,-15761,-3173,1,0,0,0,Laborers,4.0,-3,C
816,5008855,F,Y,Y,2,135000.0,Working,Secondary / secondary special,Married,House / apartment,-15761,-3173,1,0,0,0,Laborers,4.0,-4,C
817,5008855,F,Y,Y,2,135000.0,Working,Secondary / secondary special,Married,House / apartment,-15761,-3173,1,0,0,0,Laborers,4.0,-5,C
818,5008855,F,Y,Y,2,135000.0,Working,Secondary / secondary special,Married,House / apartment,-15761,-3173,1,0,0,0,Laborers,4.0,-6,C
819,5008855,F,Y,Y,2,135000.0,Working,Secondary / secondary special,Married,House / apartment,-15761,-3173,1,0,0,0,Laborers,4.0,-7,C
820,5008855,F,Y,Y,2,135000.0,Working,Secondary / secondary special,Married,House / apartment,-15761,-3173,1,0,0,0,Laborers,4.0,-8,C
821,5008855,F,Y,Y,2,135000.0,Working,Secondary / secondary special,Married,House / apartment,-15761,-3173,1,0,0,0,Laborers,4.0,-9,C
822,5008855,F,Y,Y,2,135000.0,Working,Secondary / secondary special,Married,House / apartment,-15761,-3173,1,0,0,0,Laborers,4.0,-10,C
823,5008855,F,Y,Y,2,135000.0,Working,Secondary / secondary special,Married,House / apartment,-15761,-3173,1,0,0,0,Laborers,4.0,-11,C
824,5008855,F,Y,Y,2,135000.0,Working,Secondary / secondary special,Married,House / apartment,-15761,-3173,1,0,0,0,Laborers,4.0,-12,C
825,5008855,F,Y,Y,2,135000.0,Working,Secondary / secondary special,Married,House / apartment,-15761,-3173,1,0,0,0,Laborers,4.0,-13,C
826,5008855,F,Y,Y,2,135000.0,Working,Secondary / secondary special,Married,House / apartment,-15761,-3173,1,0,0,0,Laborers,4.0,-14,C
827,5008855,F,Y,Y,2,135000.0,Working,Secondary / secondary special,Married,House / apartment,-15761,-3173,1,0,0,0,Laborers,4.0,-15,C
828,5008855,F,Y,Y,2,135000.0,Working,Secondary / secondary special,Married,House / apartment,-15761,-3173,1,0,0,0,Laborers,4.0,-16,C
829,5008855,F,Y,Y,2,135000.0,Working,Secondary / secondary special,Married,House / apartment,-15761,-3173,1,0,0,0,Laborers,4.0,-17,C
830,5008855,F,Y,Y,2,135000.0,Working,Secondary / secondary special,Married,House / apartment,-15761,-3173,1,0,0,0,Laborers,4.0,-18,C
831,5008855,F,Y,Y,2,135000.0,Working,Secondary / secondary special,Married,House / apartment,-15761,-3173,1,0,0,0,Laborers,4.0,-19,C
832,5008855,F,Y,Y,2,135000.0,Working,Secondary / secondary special,Married,House / apartment,-15761,-3173,1,0,0,0,Laborers,4.0,-20,C
833,5008855,F,Y,Y,2,135000.0,Working,Secondary / secondary special,Married,House / apartment,-15761,-3173,1,0,0,0,Laborers,4.0,-21,C
834,5008855,F,Y,Y,2,135000.0,Working,Secondary / secondary special,Married,House / apartment,-15761,-3173,1,0,0,0,Laborers,4.0,-22,0
835,5008855,F,Y,Y,2,135000.0,Working,Secondary / secondary special,Married,House / apartment,-15761,-3173,1,0,0,0,Laborers,4.0,-23,0
836,5008855,F,Y,Y,2,135000.0,Working,Secondary / secondary special,Married,House / apartment,-15761,-3173,1,0,0,0,Laborers,4.0,-24,0
837,5008855,F,Y,Y,2,135000.0,Working,Secondary / secondary special,Married,House / apartment,-15761,-3173,1,0,0,0,Laborers,4.0,-25,0
838,5008855,F,Y,Y,2,135000.0,Working,Secondary / secondary special,Married,House / apartment,-15761,-3173,1,0,0,0,Laborers,4.0,-26,0
839,5008855,F,Y,Y,2,135000.0,Working,Secondary / secondary special,Married,House / apartment,-15761,-3173,1,0,0,0,Laborers,4.0,-27,0
840,5008855,F,Y,Y,2,135000.0,Working,Secondary / secondary special,Married,House / apartment,-15761,-3173,1,0,0,0,Laborers,4.0,-28,X
841,5008856,F,Y,Y,2,135000.0,Working,Secondary / secondary special,Married,House / apartment,-15761,-3173,1,0,0,0,Laborers,4.0,0,0
842,5008856,F,Y,Y,2,135000.0,Working,Secondary / secondary special,Married,House / apartment,-15761,-3173,1,0,0,0,Laborers,4.0,-1,0
843,5008856,F,Y,Y,2,135000.0,Working,Secondary / secondary special,Married,House / apartment,-15761,-3173,1,0,0,0,Laborers,4.0,-2,0
844,5008856,F,Y,Y,2,135000.0,Working,Secondary / secondary special,Married,House / apartment,-15761,-3173,1,0,0,0,Laborers,4.0,-3,0
845,5008857,F,Y,Y,2,135000.0,Working,Secondary / secondary special,Married,House / apartment,-15761,-3173,1,0,0,0,Laborers,4.0,0,X
846,5008857,F,Y,Y,2,135000.0,Working,Secondary / secondary special,Married,House / apartment,-15761,-3173,1,0,0,0,Laborers,4.0,-1,X
847,5008857,F,Y,Y,2,135000.0,Working,Secondary / secondary special,Married,House / apartment,-15761,-3173,1,0,0,0,Laborers,4.0,-2,X
848,5008857,F,Y,Y,2,135000.0,Working,Secondary / secondary special,Married,House / apartment,-15761,-3173,1,0,0,0,Laborers,4.0,-3,X
849,5008857,F,Y,Y,2,135000.0,Working,Secondary / secondary special,Married,House / apartment,-15761,-3173,1,0,0,0,Laborers,4.0,-4,X
850,5008857,F,Y,Y,2,135000.0,Working,Secondary / secondary special,Married,House / apartment,-15761,-3173,1,0,0,0,Laborers,4.0,-5,X
851,5008857,F,Y,Y,2,135000.0,Working,Secondary / secondary special,Married,House / apartment,-15761,-3173,1,0,0,0,Laborers,4.0,-6,X
852,5008857,F,Y,Y,2,135000.0,Working,Secondary / secondary special,Married,House / apartment,-15761,-3173,1,0,0,0,Laborers,4.0,-7,X
853,5008857,F,Y,Y,2,135000.0,Working,Secondary / secondary special,Married,House / apartment,-15761,-3173,1,0,0,0,Laborers,4.0,-8,X
854,5008857,F,Y,Y,2,135000.0,Working,Secondary / secondary special,Married,House / apartment,-15761,-3173,1,0,0,0,Laborers,4.0,-9,X
855,5008857,F,Y,Y,2,135000.0,Working,Secondary / secondary special,Married,House / apartment,-15761,-3173,1,0,0,0,Laborers,4.0,-10,X
856,5008857,F,Y,Y,2,135000.0,Working,Secondary / secondary special,Married,House / apartment,-15761,-3173,1,0,0,0,Laborers,4.0,-11,X
857,5008857,F,Y,Y,2,135000.0,Working,Secondary / secondary special,Married,House / apartment,-15761,-3173,1,0,0,0,Laborers,4.0,-12,X
858,5008857,F,Y,Y,2,135000.0,Working,Secondary / secondary special,Married,House / apartment,-15761,-3173,1,0,0,0,Laborers,4.0,-13,X
859,5008857,F,Y,Y,2,135000.0,Working,Secondary / secondary special,Married,House / apartment,-15761,-3173,1,0,0,0,Laborers,4.0,-14,X
860,5008857,F,Y,Y,2,135000.0,Working,Secondary / secondary special,Married,House / apartment,-15761,-3173,1,0,0,0,Laborers,4.0,-15,X
861,5008857,F,Y,Y,2,135000.0,Working,Secondary / secondary special,Married,House / apartment,-15761,-3173,1,0,0,0,Laborers,4.0,-16,X
862,5008857,F,Y,Y,2,135000.0,Working,Secondary / secondary special,Married,House / apartment,-15761,-3173,1,0,0,0,Laborers,4.0,-17,X
863,5008857,F,Y,Y,2,135000.0,Working,Secondary / secondary special,Married,House / apartment,-15761,-3173,1,0,0,0,Laborers,4.0,-18,X
864,5008857,F,Y,Y,2,135000.0,Working,Secondary / secondary special,Married,House / apartment,-15761,-3173,1,0,0,0,Laborers,4.0,-19,X
865,5008857,F,Y,Y,2,135000.0,Working,Secondary / secondary special,Married,House / apartment,-15761,-3173,1,0,0,0,Laborers,4.0,-20,X
866,5008857,F,Y,Y,2,135000.0,Working,Secondary / secondary special,Married,House / apartment,-15761,-3173,1,0,0,0,Laborers,4.0,-21,X
867,5008857,F,Y,Y,2,135000.0,Working,Secondary / secondary special,Married,House / apartment,-15761,-3173,1,0,0,0,Laborers,4.0,-22,X
868,5008857,F,Y,Y,2,135000.0,Working,Secondary / secondary special,Married,House / apartment,-15761,-3173,1,0,0,0,Laborers,4.0,-23,X
869,5008857,F,Y,Y,2,135000.0,Working,Secondary / secondary special,Married,House / apartment,-15761,-3173,1,0,0,0,Laborers,4.0,-24,X
870,5008857,F,Y,Y,2,135000.0,Working,Secondary / secondary special,Married,House / apartment,-15761,-3173,1,0,0,0,Laborers,4.0,-25,X
871,5008857,F,Y,Y,2,135000.0,Working,Secondary / secondary special,Married,House / apartment,-15761,-3173,1,0,0,0,Laborers,4.0,-26,X
872,5008857,F,Y,Y,2,135000.0,Working,Secondary / secondary special,Married,House / apartment,-15761,-3173,1,0,0,0,Laborers,4.0,-27,X
873,5008858,F,Y,Y,2,135000.0,Working,Secondary / secondary special,Married,House / apartment,-15761,-3173,1,0,0,0,Laborers,4.0,0,C
874,5008858,F,Y,Y,2,135000.0,Working,Secondary / secondary special,Married,House / apartment,-15761,-3173,1,0,0,0,Laborers,4.0,-1,0
875,5008858,F,Y,Y,2,135000.0,Working,Secondary / secondary special,Married,House / apartment,-15761,-3173,1,0,0,0,Laborers,4.0,-2,0
876,5008858,F,Y,Y,2,135000.0,Working,Secondary / secondary special,Married,House / apartment,-15761,-3173,1,0,0,0,Laborers,4.0,-3,0
877,5008858,F,Y,Y,2,135000.0,Working,Secondary / secondary special,Married,House / apartment,-15761,-3173,1,0,0,0,Laborers,4.0,-4,0
878,5008858,F,Y,Y,2,135000.0,Working,Secondary / secondary special,Married,House / apartment,-15761,-3173,1,0,0,0,Laborers,4.0,-5,0
879,5008858,F,Y,Y,2,135000.0,Working,Secondary / secondary special,Married,House / apartment,-15761,-3173,1,0,0,0,Laborers,4.0,-6,0
880,5008858,F,Y,Y,2,135000.0,Working,Secondary / secondary special,Married,House / apartment,-15761,-3173,1,0,0,0,Laborers,4.0,-7,0
881,5008858,F,Y,Y,2,135000.0,Working,Secondary / secondary special,Married,House / apartment,-15761,-3173,1,0,0,0,Laborers,4.0,-8,0
882,5008858,F,Y,Y,2,135000.0,Working,Secondary / secondary special,Married,House / apartment,-15761,-3173,1,0,0,0,Laborers,4.0,-9,0
883,5008858,F,Y,Y,2,135000.0,Working,Secondary / secondary special,Married,House / apartment,-15761,-3173,1,0,0,0,Laborers,4.0,-10,0
884,5008859,F,Y,Y,2,135000.0,Working,Secondary / secondary special,Married,House / apartment,-15761,-3173,1,0,0,0,Laborers,4.0,0,0
885,5008859,F,Y,Y,2,135000.0,Working,Secondary / secondary special,Married,House / apartment,-15761,-3173,1,0,0,0,Laborers,4.0,-1,0
886,5008859,F,Y,Y,2,135000.0,Working,Secondary / secondary special,Married,House / apartment,-15761,-3173,1,0,0,0,Laborers,4.0,-2,0
887,5008859,F,Y,Y,2,135000.0,Working,Secondary / secondary special,Married,House / apartment,-15761,-3173,1,0,0,0,Laborers,4.0,-3,0
888,5008859,F,Y,Y,2,135000.0,Working,Secondary / secondary special,Married,House / apartment,-15761,-3173,1,0,0,0,Laborers,4.0,-4,0
889,5008860,F,Y,Y,2,135000.0,Working,Secondary / secondary special,Married,House / apartment,-15761,-3173,1,0,0,0,Laborers,4.0,0,0
890,5008860,F,Y,Y,2,135000.0,Working,Secondary / secondary special,Married,House / apartment,-15761,-3173,1,0,0,0,Laborers,4.0,-1,0
891,5008860,F,Y,Y,2,135000.0,Working,Secondary / secondary special,Married,House / apartment,-15761,-3173,1,0,0,0,Laborers,4.0,-2,0
892,5008860,F,Y,Y,2,135000.0,Working,Secondary / secondary special,Married,House / apartment,-15761,-3173,1,0,0,0,Laborers,4.0,-3,X
893,5008861,F,Y,Y,2,135000.0,Working,Secondary / secondary special,Married,House / apartment,-15761,-3173,1,0,0,0,Laborers,4.0,0,0
894,5008861,F,Y,Y,2,135000.0,Working,Secondary / secondary special,Married,House / apartment,-15761,-3173,1,0,0,0,Laborers,4.0,-1,0
895,5008861,F,Y,Y,2,135000.0,Working,Secondary / secondary special,Married,House / apartment,-15761,-3173,1,0,0,0,Laborers,4.0,-2,0
896,5008861,F,Y,Y,2,135000.0,Working,Secondary / secondary special,Married,House / apartment,-15761,-3173,1,0,0,0,Laborers,4.0,-3,X
897,5008862,F,Y,Y,2,135000.0,Working,Secondary / secondary special,Married,House / apartment,-15761,-3173,1,0,0,0,Laborers,4.0,0,0
898,5008862,F,Y,Y,2,135000.0,Working,Secondary / secondary special,Married,House / apartment,-15761,-3173,1,0,0,0,Laborers,4.0,-1,0
899,5008862,F,Y,Y,2,135000.0,Working,Secondary / secondary special,Married,House / apartment,-15761,-3173,1,0,0,0,Laborers,4.0,-2,X
900,5008863,F,Y,Y,2,135000.0,Working,Secondary / secondary special,Married,House / apartment,-15761,-3173,1,0,0,0,Laborers,4.0,-1,0
901,5008863,F,Y,Y,2,135000.0,Working,Secondary / secondary special,Married,House / apartment,-15761,-3173,1,0,0,0,Laborers,4.0,-2,0
902,5008864,F,Y,Y,2,135000.0,Working,Secondary / secondary special,Married,House / apartment,-15761,-3173,1,0,0,0,Laborers,4.0,0,0
903,5008864,F,Y,Y,2,135000.0,Working,Secondary / secondary special,Married,House / apartment,-15761,-3173,1,0,0,0,Laborers,4.0,-1,0
904,5008864,F,Y,Y,2,135000.0,Working,Secondary / secondary special,Married,House / apartment,-15761,-3173,1,0,0,0,Laborers,4.0,-2,X
905,5008865,F,Y,Y,2,135000.0,Working,Secondary / secondary special,Married,House / apartment,-15761,-3173,1,0,0,0,Laborers,4.0,-7,0
906,5008865,F,Y,Y,2,135000.0,Working,Secondary / secondary special,Married,House / apartment,-15761,-3173,1,0,0,0,Laborers,4.0,-8,0
907,5008866,F,Y,Y,2,135000.0,Working,Secondary / secondary special,Married,House / apartment,-15761,-3173,1,0,0,0,Laborers,4.0,-18,0
908,5008866,F,Y,Y,2,135000.0,Working,Secondary / secondary special,Married,House / apartment,-15761,-3173,1,0,0,0,Laborers,4.0,-19,0
909,5008867,F,Y,Y,2,135000.0,Working,Secondary / secondary special,Married,House / apartment,-15761,-3173,1,0,0,0,Laborers,4.0,-22,X
910,5008867,F,Y,Y,2,135000.0,Working,Secondary / secondary special,Married,House / apartment,-15761,-3173,1,0,0,0,Laborers,4.0,-23,0
911,5008867,F,Y,Y,2,135000.0,Working,Secondary / secondary special,Married,House / apartment,-15761,-3173,1,0,0,0,Laborers,4.0,-24,0
912,5008867,F,Y,Y,2,135000.0,Working,Secondary / secondary special,Married,House / apartment,-15761,-3173,1,0,0,0,Laborers,4.0,-25,X
913,5112846,F,Y,Y,2,135000.0,Working,Secondary / secondary special,Married,House / apartment,-15761,-3173,1,0,0,0,Laborers,4.0,-15,C
914,5112846,F,Y,Y,2,135000.0,Working,Secondary / secondary special,Married,House / apartment,-15761,-3173,1,0,0,0,Laborers,4.0,-16,C
915,5112846,F,Y,Y,2,135000.0,Working,Secondary / secondary special,Married,House / apartment,-15761,-3173,1,0,0,0,Laborers,4.0,-17,C
916,5112846,F,Y,Y,2,135000.0,Working,Secondary / secondary special,Married,House / apartment,-15761,-3173,1,0,0,0,Laborers,4.0,-18,C
917,5008868,F,N,Y,1,211500.0,State servant,Secondary / secondary special,Civil marriage,House / apartment,-16212,-7099,1,0,0,0,Core staff,3.0,0,0
918,5008868,F,N,Y,1,211500.0,State servant,Secondary / secondary special,Civil marriage,House / apartment,-16212,-7099,1,0,0,0,Core staff,3.0,-1,0
919,5008868,F,N,Y,1,211500.0,State servant,Secondary / secondary special,Civil marriage,House / apartment,-16212,-7099,1,0,0,0,Core staff,3.0,-2,0
920,5008868,F,N,Y,1,211500.0,State servant,Secondary / secondary special,Civil marriage,House / apartment,-16212,-7099,1,0,0,0,Core staff,3.0,-3,0
921,5008868,F,N,Y,1,211500.0,State servant,Secondary / secondary special,Civil marriage,House / apartment,-16212,-7099,1,0,0,0,Core staff,3.0,-4,0
922,5008868,F,N,Y,1,211500.0,State servant,Secondary / secondary special,Civil marriage,House / apartment,-16212,-7099,1,0,0,0,Core staff,3.0,-5,0
923,5008868,F,N,Y,1,211500.0,State servant,Secondary / secondary special,Civil marriage,House / apartment,-16212,-7099,1,0,0,0,Core staff,3.0,-6,0
924,5008868,F,N,Y,1,211500.0,State servant,Secondary / secondary special,Civil marriage,House / apartment,-16212,-7099,1,0,0,0,Core staff,3.0,-7,0
925,5008868,F,N,Y,1,211500.0,State servant,Secondary / secondary special,Civil marriage,House / apartment,-16212,-7099,1,0,0,0,Core staff,3.0,-8,0
926,5008868,F,N,Y,1,211500.0,State servant,Secondary / secondary special,Civil marriage,House / apartment,-16212,-7099,1,0,0,0,Core staff,3.0,-9,0
927,5008868,F,N,Y,1,211500.0,State servant,Secondary / secondary special,Civil marriage,House / apartment,-16212,-7099,1,0,0,0,Core staff,3.0,-10,0
928,5008868,F,N,Y,1,211500.0,State servant,Secondary / secondary special,Civil marriage,House / apartment,-16212,-7099,1,0,0,0,Core staff,3.0,-11,0
929,5008868,F,N,Y,1,211500.0,State servant,Secondary / secondary special,Civil marriage,House / apartment,-16212,-7099,1,0,0,0,Core staff,3.0,-12,0
930,5008868,F,N,Y,1,211500.0,State servant,Secondary / secondary special,Civil marriage,House / apartment,-16212,-7099,1,0,0,0,Core staff,3.0,-13,0
931,5008868,F,N,Y,1,211500.0,State servant,Secondary / secondary special,Civil marriage,House / apartment,-16212,-7099,1,0,0,0,Core staff,3.0,-14,0
932,5008868,F,N,Y,1,211500.0,State servant,Secondary / secondary special,Civil marriage,House / apartment,-16212,-7099,1,0,0,0,Core staff,3.0,-15,0
933,5008868,F,N,Y,1,211500.0,State servant,Secondary / secondary special,Civil marriage,House / apartment,-16212,-7099,1,0,0,0,Core staff,3.0,-16,0
934,5008868,F,N,Y,1,211500.0,State servant,Secondary / secondary special,Civil marriage,House / apartment,-16212,-7099,1,0,0,0,Core staff,3.0,-17,0
935,5008868,F,N,Y,1,211500.0,State servant,Secondary / secondary special,Civil marriage,House / apartment,-16212,-7099,1,0,0,0,Core staff,3.0,-18,0
936,5008868,F,N,Y,1,211500.0,State servant,Secondary / secondary special,Civil marriage,House / apartment,-16212,-7099,1,0,0,0,Core staff,3.0,-19,0
937,5008868,F,N,Y,1,211500.0,State servant,Secondary / secondary special,Civil marriage,House / apartment,-16212,-7099,1,0,0,0,Core staff,3.0,-20,0
938,5008868,F,N,Y,1,211500.0,State servant,Secondary / secondary special,Civil marriage,House / apartment,-16212,-7099,1,0,0,0,Core staff,3.0,-21,0
939,5008868,F,N,Y,1,211500.0,State servant,Secondary / secondary special,Civil marriage,House / apartment,-16212,-7099,1,0,0,0,Core staff,3.0,-22,0
940,5008868,F,N,Y,1,211500.0,State servant,Secondary / secondary special,Civil marriage,House / apartment,-16212,-7099,1,0,0,0,Core staff,3.0,-23,0
941,5008868,F,N,Y,1,211500.0,State servant,Secondary / secondary special,Civil marriage,House / apartment,-16212,-7099,1,0,0,0,Core staff,3.0,-24,0
942,5008870,F,N,Y,1,211500.0,State servant,Secondary / secondary special,Civil marriage,House / apartment,-16212,-7099,1,0,0,0,Core staff,3.0,-9,0
943,5008870,F,N,Y,1,211500.0,State servant,Secondary / secondary special,Civil marriage,House / apartment,-16212,-7099,1,0,0,0,Core staff,3.0,-10,0
944,5008870,F,N,Y,1,211500.0,State servant,Secondary / secondary special,Civil marriage,House / apartment,-16212,-7099,1,0,0,0,Core staff,3.0,-11,0
945,5008870,F,N,Y,1,211500.0,State servant,Secondary / secondary special,Civil marriage,House / apartment,-16212,-7099,1,0,0,0,Core staff,3.0,-12,0
946,5008870,F,N,Y,1,211500.0,State servant,Secondary / secondary special,Civil marriage,House / apartment,-16212,-7099,1,0,0,0,Core staff,3.0,-13,0
947,5008870,F,N,Y,1,211500.0,State servant,Secondary / secondary special,Civil marriage,House / apartment,-16212,-7099,1,0,0,0,Core staff,3.0,-14,0
948,5008870,F,N,Y,1,211500.0,State servant,Secondary / secondary special,Civil marriage,House / apartment,-16212,-7099,1,0,0,0,Core staff,3.0,-15,0
949,5008870,F,N,Y,1,211500.0,State servant,Secondary / secondary special,Civil marriage,House / apartment,-16212,-7099,1,0,0,0,Core staff,3.0,-16,0
950,5008870,F,N,Y,1,211500.0,State servant,Secondary / secondary special,Civil marriage,House / apartment,-16212,-7099,1,0,0,0,Core staff,3.0,-17,0
951,5008870,F,N,Y,1,211500.0,State servant,Secondary / secondary special,Civil marriage,House / apartment,-16212,-7099,1,0,0,0,Core staff,3.0,-18,0
952,5008870,F,N,Y,1,211500.0,State servant,Secondary / secondary special,Civil marriage,House / apartment,-16212,-7099,1,0,0,0,Core staff,3.0,-19,0
953,5008870,F,N,Y,1,211500.0,State servant,Secondary / secondary special,Civil marriage,House / apartment,-16212,-7099,1,0,0,0,Core staff,3.0,-20,0
954,5008872,M,Y,Y,0,360000.0,Commercial associate,Secondary / secondary special,Married,House / apartment,-16670,-5364,1,0,1,0,Security staff,2.0,0,0
955,5008872,M,Y,Y,0,360000.0,Commercial associate,Secondary / secondary special,Married,House / apartment,-16670,-5364,1,0,1,0,Security staff,2.0,-1,0
956,5008872,M,Y,Y,0,360000.0,Commercial associate,Secondary / secondary special,Married,House / apartment,-16670,-5364,1,0,1,0,Security staff,2.0,-2,0
957,5008872,M,Y,Y,0,360000.0,Commercial associate,Secondary / secondary special,Married,House / apartment,-16670,-5364,1,0,1,0,Security staff,2.0,-3,0
958,5008872,M,Y,Y,0,360000.0,Commercial associate,Secondary / secondary special,Married,House / apartment,-16670,-5364,1,0,1,0,Security staff,2.0,-4,0
959,5008872,M,Y,Y,0,360000.0,Commercial associate,Secondary / secondary special,Married,House / apartment,-16670,-5364,1,0,1,0,Security staff,2.0,-5,0
960,5008872,M,Y,Y,0,360000.0,Commercial associate,Secondary / secondary special,Married,House / apartment,-16670,-5364,1,0,1,0,Security staff,2.0,-6,0
961,5008872,M,Y,Y,0,360000.0,Commercial associate,Secondary / secondary special,Married,House / apartment,-16670,-5364,1,0,1,0,Security staff,2.0,-7,0
962,5008872,M,Y,Y,0,360000.0,Commercial associate,Secondary / secondary special,Married,House / apartment,-16670,-5364,1,0,1,0,Security staff,2.0,-8,1
963,5008872,M,Y,Y,0,360000.0,Commercial associate,Secondary / secondary special,Married,House / apartment,-16670,-5364,1,0,1,0,Security staff,2.0,-9,X
964,5008872,M,Y,Y,0,360000.0,Commercial associate,Secondary / secondary special,Married,House / apartment,-16670,-5364,1,0,1,0,Security staff,2.0,-10,X
965,5008873,F,N,Y,2,126000.0,Commercial associate,Higher education,Married,House / apartment,-12411,-1773,1,0,0,1,Managers,4.0,0,C
966,5008873,F,N,Y,2,126000.0,Commercial associate,Higher education,Married,House / apartment,-12411,-1773,1,0,0,1,Managers,4.0,-1,C
967,5008873,F,N,Y,2,126000.0,Commercial associate,Higher education,Married,House / apartment,-12411,-1773,1,0,0,1,Managers,4.0,-2,C
968,5008873,F,N,Y,2,126000.0,Commercial associate,Higher education,Married,House / apartment,-12411,-1773,1,0,0,1,Managers,4.0,-3,C
969,5008873,F,N,Y,2,126000.0,Commercial associate,Higher education,Married,House / apartment,-12411,-1773,1,0,0,1,Managers,4.0,-4,C
970,5008873,F,N,Y,2,126000.0,Commercial associate,Higher education,Married,House / apartment,-12411,-1773,1,0,0,1,Managers,4.0,-5,C
971,5008873,F,N,Y,2,126000.0,Commercial associate,Higher education,Married,House / apartment,-12411,-1773,1,0,0,1,Managers,4.0,-6,C
972,5008873,F,N,Y,2,126000.0,Commercial associate,Higher education,Married,House / apartment,-12411,-1773,1,0,0,1,Managers,4.0,-7,C
973,5008873,F,N,Y,2,126000.0,Commercial associate,Higher education,Married,House / apartment,-12411,-1773,1,0,0,1,Managers,4.0,-8,C
974,5008873,F,N,Y,2,126000.0,Commercial associate,Higher education,Married,House / apartment,-12411,-1773,1,0,0,1,Managers,4.0,-9,C
975,5008873,F,N,Y,2,126000.0,Commercial associate,Higher education,Married,House / apartment,-12411,-1773,1,0,0,1,Managers,4.0,-10,C
976,5008873,F,N,Y,2,126000.0,Commercial associate,Higher education,Married,House / apartment,-12411,-1773,1,0,0,1,Managers,4.0,-11,C
977,5008873,F,N,Y,2,126000.0,Commercial associate,Higher education,Married,House / apartment,-12411,-1773,1,0,0,1,Managers,4.0,-12,C
978,5008873,F,N,Y,2,126000.0,Commercial associate,Higher education,Married,House / apartment,-12411,-1773,1,0,0,1,Managers,4.0,-13,C
979,5008873,F,N,Y,2,126000.0,Commercial associate,Higher education,Married,House / apartment,-12411,-1773,1,0,0,1,Managers,4.0,-14,C
980,5008873,F,N,Y,2,126000.0,Commercial associate,Higher education,Married,House / apartment,-12411,-1773,1,0,0,1,Managers,4.0,-15,C
981,5008873,F,N,Y,2,126000.0,Commercial associate,Higher education,Married,House / apartment,-12411,-1773,1,0,0,1,Managers,4.0,-16,0
982,5008873,F,N,Y,2,126000.0,Commercial associate,Higher education,Married,House / apartment,-12411,-1773,1,0,0,1,Managers,4.0,-17,0
983,5008873,F,N,Y,2,126000.0,Commercial associate,Higher education,Married,House / apartment,-12411,-1773,1,0,0,1,Managers,4.0,-18,0
984,5008873,F,N,Y,2,126000.0,Commercial associate,Higher education,Married,House / apartment,-12411,-1773,1,0,0,1,Managers,4.0,-19,0
985,5008873,F,N,Y,2,126000.0,Commercial associate,Higher education,Married,House / apartment,-12411,-1773,1,0,0,1,Managers,4.0,-20,0
986,5008873,F,N,Y,2,126000.0,Commercial associate,Higher education,Married,House / apartment,-12411,-1773,1,0,0,1,Managers,4.0,-21,0
987,5008874,F,N,Y,2,126000.0,Commercial associate,Higher education,Married,House / apartment,-12411,-1773,1,0,0,1,Managers,4.0,0,C
988,5008874,F,N,Y,2,126000.0,Commercial associate,Higher education,Married,House / apartment,-12411,-1773,1,0,0,1,Managers,4.0,-1,C
989,5008874,F,N,Y,2,126000.0,Commercial associate,Higher education,Married,House / apartment,-12411,-1773,1,0,0,1,Managers,4.0,-2,C
990,5008874,F,N,Y,2,126000.0,Commercial associate,Higher education,Married,House / apartment,-12411,-1773,1,0,0,1,Managers,4.0,-3,C
991,5008874,F,N,Y,2,126000.0,Commercial associate,Higher education,Married,House / apartment,-12411,-1773,1,0,0,1,Managers,4.0,-4,C
992,5008874,F,N,Y,2,126000.0,Commercial associate,Higher education,Married,House / apartment,-12411,-1773,1,0,0,1,Managers,4.0,-5,C
993,5008874,F,N,Y,2,126000.0,Commercial associate,Higher education,Married,House / apartment,-12411,-1773,1,0,0,1,Managers,4.0,-6,C
994,5008874,F,N,Y,2,126000.0,Commercial associate,Higher education,Married,House / apartment,-12411,-1773,1,0,0,1,Managers,4.0,-7,C
995,5008874,F,N,Y,2,126000.0,Commercial associate,Higher education,Married,House / apartment,-12411,-1773,1,0,0,1,Managers,4.0,-8,C
996,5008874,F,N,Y,2,126000.0,Commercial associate,Higher education,Married,House / apartment,-12411,-1773,1,0,0,1,Managers,4.0,-9,C
997,5008874,F,N,Y,2,126000.0,Commercial associate,Higher education,Married,House / apartment,-12411,-1773,1,0,0,1,Managers,4.0,-10,C
998,5008874,F,N,Y,2,126000.0,Commercial associate,Higher education,Married,House / apartment,-12411,-1773,1,0,0,1,Managers,4.0,-11,C
999,5008874,F,N,Y,2,126000.0,Commercial associate,Higher education,Married,House / apartment,-12411,-1773,1,0,0,1,Managers,4.0,-12,C
1000,5008874,F,N,Y,2,126000.0,Commercial associate,Higher education,Married,House / apartment,-12411,-1773,1,0,0,1,Managers,4.0,-13,C
1001,5008874,F,N,Y,2,126000.0,Commercial associate,Higher education,Married,House / apartment,-12411,-1773,1,0,0,1,Managers,4.0,-14,C
1002,5008874,F,N,Y,2,126000.0,Commercial associate,Higher education,Married,House / apartment,-12411,-1773,1,0,0,1,Managers,4.0,-15,C
1003,5008874,F,N,Y,2,126000.0,Commercial associate,Higher education,Married,House / apartment,-12411,-1773,1,0,0,1,Managers,4.0,-16,C
1004,5008874,F,N,Y,2,126000.0,Commercial associate,Higher education,Married,House / apartment,-12411,-1773,1,0,0,1,Managers,4.0,-17,C
1005,5008874,F,N,Y,2,126000.0,Commercial associate,Higher education,Married,House / apartment,-12411,-1773,1,0,0,1,Managers,4.0,-18,C
1006,5008874,F,N,Y,2,126000.0,Commercial associate,Higher education,Married,House / apartment,-12411,-1773,1,0,0,1,Managers,4.0,-19,C
1007,5008874,F,N,Y,2,126000.0,Commercial associate,Higher education,Married,House / apartment,-12411,-1773,1,0,0,1,Managers,4.0,-20,C
1008,5008874,F,N,Y,2,126000.0,Commercial associate,Higher education,Married,House / apartment,-12411,-1773,1,0,0,1,Managers,4.0,-21,C
1009,5008874,F,N,Y,2,126000.0,Commercial associate,Higher education,Married,House / apartment,-12411,-1773,1,0,0,1,Managers,4.0,-22,C
1010,5008874,F,N,Y,2,126000.0,Commercial associate,Higher education,Married,House / apartment,-12411,-1773,1,0,0,1,Managers,4.0,-23,C
1011,5008874,F,N,Y,2,126000.0,Commercial associate,Higher education,Married,House / apartment,-12411,-1773,1,0,0,1,Managers,4.0,-24,C
1012,5008874,F,N,Y,2,126000.0,Commercial associate,Higher education,Married,House / apartment,-12411,-1773,1,0,0,1,Managers,4.0,-25,C
1013,5008874,F,N,Y,2,126000.0,Commercial associate,Higher education,Married,House / apartment,-12411,-1773,1,0,0,1,Managers,4.0,-26,C
1014,5008874,F,N,Y,2,126000.0,Commercial associate,Higher education,Married,House / apartment,-12411,-1773,1,0,0,1,Managers,4.0,-27,C
1015,5008874,F,N,Y,2,126000.0,Commercial associate,Higher education,Married,House / apartment,-12411,-1773,1,0,0,1,Managers,4.0,-28,C
1016,5008874,F,N,Y,2,126000.0,Commercial associate,Higher education,Married,House / apartment,-12411,-1773,1,0,0,1,Managers,4.0,-29,C
1017,5008874,F,N,Y,2,126000.0,Commercial associate,Higher education,Married,House / apartment,-12411,-1773,1,0,0,1,Managers,4.0,-30,C
1018,5008874,F,N,Y,2,126000.0,Commercial associate,Higher education,Married,House / apartment,-12411,-1773,1,0,0,1,Managers,4.0,-31,C
1019,5008874,F,N,Y,2,126000.0,Commercial associate,Higher education,Married,House / apartment,-12411,-1773,1,0,0,1,Managers,4.0,-32,C
1020,5008874,F,N,Y,2,126000.0,Commercial associate,Higher education,Married,House / apartment,-12411,-1773,1,0,0,1,Managers,4.0,-33,C
1021,5008874,F,N,Y,2,126000.0,Commercial associate,Higher education,Married,House / apartment,-12411,-1773,1,0,0,1,Managers,4.0,-34,C
1022,5008874,F,N,Y,2,126000.0,Commercial associate,Higher education,Married,House / apartment,-12411,-1773,1,0,0,1,Managers,4.0,-35,C
1023,5008874,F,N,Y,2,126000.0,Commercial associate,Higher education,Married,House / apartment,-12411,-1773,1,0,0,1,Managers,4.0,-36,C
1024,5008874,F,N,Y,2,126000.0,Commercial associate,Higher education,Married,House / apartment,-12411,-1773,1,0,0,1,Managers,4.0,-37,C
1025,5008874,F,N,Y,2,126000.0,Commercial associate,Higher education,Married,House / apartment,-12411,-1773,1,0,0,1,Managers,4.0,-38,C
1026,5008874,F,N,Y,2,126000.0,Commercial associate,Higher education,Married,House / apartment,-12411,-1773,1,0,0,1,Managers,4.0,-39,C
1027,5008874,F,N,Y,2,126000.0,Commercial associate,Higher education,Married,House / apartment,-12411,-1773,1,0,0,1,Managers,4.0,-40,0
1028,5008874,F,N,Y,2,126000.0,Commercial associate,Higher education,Married,House / apartment,-12411,-1773,1,0,0,1,Managers,4.0,-41,0
1029,5008874,F,N,Y,2,126000.0,Commercial associate,Higher education,Married,House / apartment,-12411,-1773,1,0,0,1,Managers,4.0,-42,0
1030,5008874,F,N,Y,2,126000.0,Commercial associate,Higher education,Married,House / apartment,-12411,-1773,1,0,0,1,Managers,4.0,-43,0
1031,5008874,F,N,Y,2,126000.0,Commercial associate,Higher education,Married,House / apartment,-12411,-1773,1,0,0,1,Managers,4.0,-44,0
1032,5008874,F,N,Y,2,126000.0,Commercial associate,Higher education,Married,House / apartment,-12411,-1773,1,0,0,1,Managers,4.0,-45,0
1033,5008875,F,N,Y,2,126000.0,Commercial associate,Higher education,Married,House / apartment,-12411,-1773,1,0,0,1,Managers,4.0,0,C
1034,5008875,F,N,Y,2,126000.0,Commercial associate,Higher education,Married,House / apartment,-12411,-1773,1,0,0,1,Managers,4.0,-1,C
1035,5008875,F,N,Y,2,126000.0,Commercial associate,Higher education,Married,House / apartment,-12411,-1773,1,0,0,1,Managers,4.0,-2,C
1036,5008875,F,N,Y,2,126000.0,Commercial associate,Higher education,Married,House / apartment,-12411,-1773,1,0,0,1,Managers,4.0,-3,C
1037,5008875,F,N,Y,2,126000.0,Commercial associate,Higher education,Married,House / apartment,-12411,-1773,1,0,0,1,Managers,4.0,-4,C
1038,5008875,F,N,Y,2,126000.0,Commercial associate,Higher education,Married,House / apartment,-12411,-1773,1,0,0,1,Managers,4.0,-5,C
1039,5008875,F,N,Y,2,126000.0,Commercial associate,Higher education,Married,House / apartment,-12411,-1773,1,0,0,1,Managers,4.0,-6,C
1040,5008875,F,N,Y,2,126000.0,Commercial associate,Higher education,Married,House / apartment,-12411,-1773,1,0,0,1,Managers,4.0,-7,C
1041,5008875,F,N,Y,2,126000.0,Commercial associate,Higher education,Married,House / apartment,-12411,-1773,1,0,0,1,Managers,4.0,-8,C
1042,5008875,F,N,Y,2,126000.0,Commercial associate,Higher education,Married,House / apartment,-12411,-1773,1,0,0,1,Managers,4.0,-9,C
1043,5008875,F,N,Y,2,126000.0,Commercial associate,Higher education,Married,House / apartment,-12411,-1773,1,0,0,1,Managers,4.0,-10,C
1044,5008875,F,N,Y,2,126000.0,Commercial associate,Higher education,Married,House / apartment,-12411,-1773,1,0,0,1,Managers,4.0,-11,C
1045,5008875,F,N,Y,2,126000.0,Commercial associate,Higher education,Married,House / apartment,-12411,-1773,1,0,0,1,Managers,4.0,-12,C
1046,5008875,F,N,Y,2,126000.0,Commercial associate,Higher education,Married,House / apartment,-12411,-1773,1,0,0,1,Managers,4.0,-13,C
1047,5008875,F,N,Y,2,126000.0,Commercial associate,Higher education,Married,House / apartment,-12411,-1773,1,0,0,1,Managers,4.0,-14,C
1048,5008875,F,N,Y,2,126000.0,Commercial associate,Higher education,Married,House / apartment,-12411,-1773,1,0,0,1,Managers,4.0,-15,C
1049,5008875,F,N,Y,2,126000.0,Commercial associate,Higher education,Married,House / apartment,-12411,-1773,1,0,0,1,Managers,4.0,-16,C
1050,5008875,F,N,Y,2,126000.0,Commercial associate,Higher education,Married,House / apartment,-12411,-1773,1,0,0,1,Managers,4.0,-17,C
1051,5008875,F,N,Y,2,126000.0,Commercial associate,Higher education,Married,House / apartment,-12411,-1773,1,0,0,1,Managers,4.0,-18,C
1052,5008875,F,N,Y,2,126000.0,Commercial associate,Higher education,Married,House / apartment,-12411,-1773,1,0,0,1,Managers,4.0,-19,C
1053,5008875,F,N,Y,2,126000.0,Commercial associate,Higher education,Married,House / apartment,-12411,-1773,1,0,0,1,Managers,4.0,-20,C
1054,5008875,F,N,Y,2,126000.0,Commercial associate,Higher education,Married,House / apartment,-12411,-1773,1,0,0,1,Managers,4.0,-21,C
1055,5008875,F,N,Y,2,126000.0,Commercial associate,Higher education,Married,House / apartment,-12411,-1773,1,0,0,1,Managers,4.0,-22,C
1056,5008875,F,N,Y,2,126000.0,Commercial associate,Higher education,Married,House / apartment,-12411,-1773,1,0,0,1,Managers,4.0,-23,C
1057,5008875,F,N,Y,2,126000.0,Commercial associate,Higher education,Married,House / apartment,-12411,-1773,1,0,0,1,Managers,4.0,-24,C
1058,5008875,F,N,Y,2,126000.0,Commercial associate,Higher education,Married,House / apartment,-12411,-1773,1,0,0,1,Managers,4.0,-25,C
1059,5008875,F,N,Y,2,126000.0,Commercial associate,Higher education,Married,House / apartment,-12411,-1773,1,0,0,1,Managers,4.0,-26,C
1060,5008875,F,N,Y,2,126000.0,Commercial associate,Higher education,Married,House / apartment,-12411,-1773,1,0,0,1,Managers,4.0,-27,C
1061,5008875,F,N,Y,2,126000.0,Commercial associate,Higher education,Married,House / apartment,-12411,-1773,1,0,0,1,Managers,4.0,-28,C
1062,5008875,F,N,Y,2,126000.0,Commercial associate,Higher education,Married,House / apartment,-12411,-1773,1,0,0,1,Managers,4.0,-29,C
1063,5008875,F,N,Y,2,126000.0,Commercial associate,Higher education,Married,House / apartment,-12411,-1773,1,0,0,1,Managers,4.0,-30,C
1064,5008875,F,N,Y,2,126000.0,Commercial associate,Higher education,Married,House / apartment,-12411,-1773,1,0,0,1,Managers,4.0,-31,0
1065,5008875,F,N,Y,2,126000.0,Commercial associate,Higher education,Married,House / apartment,-12411,-1773,1,0,0,1,Managers,4.0,-32,0
1066,5008875,F,N,Y,2,126000.0,Commercial associate,Higher education,Married,House / apartment,-12411,-1773,1,0,0,1,Managers,4.0,-33,0
1067,5008875,F,N,Y,2,126000.0,Commercial associate,Higher education,Married,House / apartment,-12411,-1773,1,0,0,1,Managers,4.0,-34,0
1068,5008875,F,N,Y,2,126000.0,Commercial associate,Higher education,Married,House / apartment,-12411,-1773,1,0,0,1,Managers,4.0,-35,0
1069,5008875,F,N,Y,2,126000.0,Commercial associate,Higher education,Married,House / apartment,-12411,-1773,1,0,0,1,Managers,4.0,-36,0
1070,5008875,F,N,Y,2,126000.0,Commercial associate,Higher education,Married,House / apartment,-12411,-1773,1,0,0,1,Managers,4.0,-37,0
1071,5008875,F,N,Y,2,126000.0,Commercial associate,Higher education,Married,House / apartment,-12411,-1773,1,0,0,1,Managers,4.0,-38,0
1072,5008875,F,N,Y,2,126000.0,Commercial associate,Higher education,Married,House / apartment,-12411,-1773,1,0,0,1,Managers,4.0,-39,0
1073,5008876,F,N,Y,2,126000.0,Commercial associate,Higher education,Married,House / apartment,-12411,-1773,1,0,0,1,Managers,4.0,0,C
1074,5008876,F,N,Y,2,126000.0,Commercial associate,Higher education,Married,House / apartment,-12411,-1773,1,0,0,1,Managers,4.0,-1,C
1075,5008876,F,N,Y,2,126000.0,Commercial associate,Higher education,Married,House / apartment,-12411,-1773,1,0,0,1,Managers,4.0,-2,C
1076,5008876,F,N,Y,2,126000.0,Commercial associate,Higher education,Married,House / apartment,-12411,-1773,1,0,0,1,Managers,4.0,-3,C
1077,5008876,F,N,Y,2,126000.0,Commercial associate,Higher education,Married,House / apartment,-12411,-1773,1,0,0,1,Managers,4.0,-4,C
1078,5008876,F,N,Y,2,126000.0,Commercial associate,Higher education,Married,House / apartment,-12411,-1773,1,0,0,1,Managers,4.0,-5,C
1079,5008876,F,N,Y,2,126000.0,Commercial associate,Higher education,Married,House / apartment,-12411,-1773,1,0,0,1,Managers,4.0,-6,C
1080,5008876,F,N,Y,2,126000.0,Commercial associate,Higher education,Married,House / apartment,-12411,-1773,1,0,0,1,Managers,4.0,-7,C
1081,5008876,F,N,Y,2,126000.0,Commercial associate,Higher education,Married,House / apartment,-12411,-1773,1,0,0,1,Managers,4.0,-8,C
1082,5008876,F,N,Y,2,126000.0,Commercial associate,Higher education,Married,House / apartment,-12411,-1773,1,0,0,1,Managers,4.0,-9,C
1083,5008876,F,N,Y,2,126000.0,Commercial associate,Higher education,Married,House / apartment,-12411,-1773,1,0,0,1,Managers,4.0,-10,C
1084,5008876,F,N,Y,2,126000.0,Commercial associate,Higher education,Married,House / apartment,-12411,-1773,1,0,0,1,Managers,4.0,-11,C
1085,5008876,F,N,Y,2,126000.0,Commercial associate,Higher education,Married,House / apartment,-12411,-1773,1,0,0,1,Managers,4.0,-12,C
1086,5008876,F,N,Y,2,126000.0,Commercial associate,Higher education,Married,House / apartment,-12411,-1773,1,0,0,1,Managers,4.0,-13,C
1087,5008876,F,N,Y,2,126000.0,Commercial associate,Higher education,Married,House / apartment,-12411,-1773,1,0,0,1,Managers,4.0,-14,C
1088,5008876,F,N,Y,2,126000.0,Commercial associate,Higher education,Married,House / apartment,-12411,-1773,1,0,0,1,Managers,4.0,-15,C
1089,5008876,F,N,Y,2,126000.0,Commercial associate,Higher education,Married,House / apartment,-12411,-1773,1,0,0,1,Managers,4.0,-16,C
1090,5008876,F,N,Y,2,126000.0,Commercial associate,Higher education,Married,House / apartment,-12411,-1773,1,0,0,1,Managers,4.0,-17,C
1091,5008876,F,N,Y,2,126000.0,Commercial associate,Higher education,Married,House / apartment,-12411,-1773,1,0,0,1,Managers,4.0,-18,C
1092,5008876,F,N,Y,2,126000.0,Commercial associate,Higher education,Married,House / apartment,-12411,-1773,1,0,0,1,Managers,4.0,-19,C
1093,5008876,F,N,Y,2,126000.0,Commercial associate,Higher education,Married,House / apartment,-12411,-1773,1,0,0,1,Managers,4.0,-20,C
1094,5008876,F,N,Y,2,126000.0,Commercial associate,Higher education,Married,House / apartment,-12411,-1773,1,0,0,1,Managers,4.0,-21,C
1095,5008876,F,N,Y,2,126000.0,Commercial associate,Higher education,Married,House / apartment,-12411,-1773,1,0,0,1,Managers,4.0,-22,C
1096,5008876,F,N,Y,2,126000.0,Commercial associate,Higher education,Married,House / apartment,-12411,-1773,1,0,0,1,Managers,4.0,-23,C
1097,5008876,F,N,Y,2,126000.0,Commercial associate,Higher education,Married,House / apartment,-12411,-1773,1,0,0,1,Managers,4.0,-24,C
1098,5008876,F,N,Y,2,126000.0,Commercial associate,Higher education,Married,House / apartment,-12411,-1773,1,0,0,1,Managers,4.0,-25,C
1099,5008876,F,N,Y,2,126000.0,Commercial associate,Higher education,Married,House / apartment,-12411,-1773,1,0,0,1,Managers,4.0,-26,C
1100,5008876,F,N,Y,2,126000.0,Commercial associate,Higher education,Married,House / apartment,-12411,-1773,1,0,0,1,Managers,4.0,-27,C
1101,5008876,F,N,Y,2,126000.0,Commercial associate,Higher education,Married,House / apartment,-12411,-1773,1,0,0,1,Managers,4.0,-28,C
1102,5008876,F,N,Y,2,126000.0,Commercial associate,Higher education,Married,House / apartment,-12411,-1773,1,0,0,1,Managers,4.0,-29,C
1103,5008876,F,N,Y,2,126000.0,Commercial associate,Higher education,Married,House / apartment,-12411,-1773,1,0,0,1,Managers,4.0,-30,C
1104,5008876,F,N,Y,2,126000.0,Commercial associate,Higher education,Married,House / apartment,-12411,-1773,1,0,0,1,Managers,4.0,-31,C
1105,5008876,F,N,Y,2,126000.0,Commercial associate,Higher education,Married,House / apartment,-12411,-1773,1,0,0,1,Managers,4.0,-32,C
1106,5008876,F,N,Y,2,126000.0,Commercial associate,Higher education,Married,House / apartment,-12411,-1773,1,0,0,1,Managers,4.0,-33,C
1107,5008876,F,N,Y,2,126000.0,Commercial associate,Higher education,Married,House / apartment,-12411,-1773,1,0,0,1,Managers,4.0,-34,C
1108,5008876,F,N,Y,2,126000.0,Commercial associate,Higher education,Married,House / apartment,-12411,-1773,1,0,0,1,Managers,4.0,-35,C
1109,5008876,F,N,Y,2,126000.0,Commercial associate,Higher education,Married,House / apartment,-12411,-1773,1,0,0,1,Managers,4.0,-36,C
1110,5008876,F,N,Y,2,126000.0,Commercial associate,Higher education,Married,House / apartment,-12411,-1773,1,0,0,1,Managers,4.0,-37,C
1111,5008876,F,N,Y,2,126000.0,Commercial associate,Higher education,Married,House / apartment,-12411,-1773,1,0,0,1,Managers,4.0,-38,C
1112,5008876,F,N,Y,2,126000.0,Commercial associate,Higher education,Married,House / apartment,-12411,-1773,1,0,0,1,Managers,4.0,-39,C
1113,5008876,F,N,Y,2,126000.0,Commercial associate,Higher education,Married,House / apartment,-12411,-1773,1,0,0,1,Managers,4.0,-40,C
1114,5008876,F,N,Y,2,126000.0,Commercial associate,Higher education,Married,House / apartment,-12411,-1773,1,0,0,1,Managers,4.0,-41,0
1115,5008876,F,N,Y,2,126000.0,Commercial associate,Higher education,Married,House / apartment,-12411,-1773,1,0,0,1,Managers,4.0,-42,0
1116,5008876,F,N,Y,2,126000.0,Commercial associate,Higher education,Married,House / apartment,-12411,-1773,1,0,0,1,Managers,4.0,-43,0
1117,5008877,F,N,Y,2,126000.0,Commercial associate,Higher education,Married,House / apartment,-12411,-1773,1,0,0,1,Managers,4.0,0,C
1118,5008877,F,N,Y,2,126000.0,Commercial associate,Higher education,Married,House / apartment,-12411,-1773,1,0,0,1,Managers,4.0,-1,C
1119,5008877,F,N,Y,2,126000.0,Commercial associate,Higher education,Married,House / apartment,-12411,-1773,1,0,0,1,Managers,4.0,-2,0
1120,5008877,F,N,Y,2,126000.0,Commercial associate,Higher education,Married,House / apartment,-12411,-1773,1,0,0,1,Managers,4.0,-3,0
1121,5008877,F,N,Y,2,126000.0,Commercial associate,Higher education,Married,House / apartment,-12411,-1773,1,0,0,1,Managers,4.0,-4,0
1122,5008877,F,N,Y,2,126000.0,Commercial associate,Higher education,Married,House / apartment,-12411,-1773,1,0,0,1,Managers,4.0,-5,0
1123,5008877,F,N,Y,2,126000.0,Commercial associate,Higher education,Married,House / apartment,-12411,-1773,1,0,0,1,Managers,4.0,-6,0
1124,5008877,F,N,Y,2,126000.0,Commercial associate,Higher education,Married,House / apartment,-12411,-1773,1,0,0,1,Managers,4.0,-7,0
1125,5008878,F,N,Y,2,126000.0,Commercial associate,Higher education,Married,House / apartment,-12411,-1773,1,0,0,1,Managers,4.0,-32,1
1126,5008878,F,N,Y,2,126000.0,Commercial associate,Higher education,Married,House / apartment,-12411,-1773,1,0,0,1,Managers,4.0,-33,1
1127,5008878,F,N,Y,2,126000.0,Commercial associate,Higher education,Married,House / apartment,-12411,-1773,1,0,0,1,Managers,4.0,-34,0
1128,5008878,F,N,Y,2,126000.0,Commercial associate,Higher education,Married,House / apartment,-12411,-1773,1,0,0,1,Managers,4.0,-35,0
1129,5008878,F,N,Y,2,126000.0,Commercial associate,Higher education,Married,House / apartment,-12411,-1773,1,0,0,1,Managers,4.0,-36,0
1130,5008878,F,N,Y,2,126000.0,Commercial associate,Higher education,Married,House / apartment,-12411,-1773,1,0,0,1,Managers,4.0,-37,1
1131,5008878,F,N,Y,2,126000.0,Commercial associate,Higher education,Married,House / apartment,-12411,-1773,1,0,0,1,Managers,4.0,-38,0
1132,5008878,F,N,Y,2,126000.0,Commercial associate,Higher education,Married,House / apartment,-12411,-1773,1,0,0,1,Managers,4.0,-39,0
1133,5008878,F,N,Y,2,126000.0,Commercial associate,Higher education,Married,House / apartment,-12411,-1773,1,0,0,1,Managers,4.0,-40,0
1134,5008878,F,N,Y,2,126000.0,Commercial associate,Higher education,Married,House / apartment,-12411,-1773,1,0,0,1,Managers,4.0,-41,0
1135,5008878,F,N,Y,2,126000.0,Commercial associate,Higher education,Married,House / apartment,-12411,-1773,1,0,0,1,Managers,4.0,-42,0
1136,5008878,F,N,Y,2,126000.0,Commercial associate,Higher education,Married,House / apartment,-12411,-1773,1,0,0,1,Managers,4.0,-43,0
1137,5008879,F,N,Y,2,126000.0,Commercial associate,Higher education,Married,House / apartment,-12411,-1773,1,0,0,1,Managers,4.0,0,C
1138,5008879,F,N,Y,2,126000.0,Commercial associate,Higher education,Married,House / apartment,-12411,-1773,1,0,0,1,Managers,4.0,-1,C
1139,5008879,F,N,Y,2,126000.0,Commercial associate,Higher education,Married,House / apartment,-12411,-1773,1,0,0,1,Managers,4.0,-2,C
1140,5008879,F,N,Y,2,126000.0,Commercial associate,Higher education,Married,House / apartment,-12411,-1773,1,0,0,1,Managers,4.0,-3,C
1141,5008879,F,N,Y,2,126000.0,Commercial associate,Higher education,Married,House / apartment,-12411,-1773,1,0,0,1,Managers,4.0,-4,C
1142,5008879,F,N,Y,2,126000.0,Commercial associate,Higher education,Married,House / apartment,-12411,-1773,1,0,0,1,Managers,4.0,-5,C
1143,5008879,F,N,Y,2,126000.0,Commercial associate,Higher education,Married,House / apartment,-12411,-1773,1,0,0,1,Managers,4.0,-6,C
1144,5008879,F,N,Y,2,126000.0,Commercial associate,Higher education,Married,House / apartment,-12411,-1773,1,0,0,1,Managers,4.0,-7,C
1145,5008879,F,N,Y,2,126000.0,Commercial associate,Higher education,Married,House / apartment,-12411,-1773,1,0,0,1,Managers,4.0,-8,C
1146,5008879,F,N,Y,2,126000.0,Commercial associate,Higher education,Married,House / apartment,-12411,-1773,1,0,0,1,Managers,4.0,-9,C
1147,5008879,F,N,Y,2,126000.0,Commercial associate,Higher education,Married,House / apartment,-12411,-1773,1,0,0,1,Managers,4.0,-10,C
1148,5008879,F,N,Y,2,126000.0,Commercial associate,Higher education,Married,House / apartment,-12411,-1773,1,0,0,1,Managers,4.0,-11,C
1149,5008879,F,N,Y,2,126000.0,Commercial associate,Higher education,Married,House / apartment,-12411,-1773,1,0,0,1,Managers,4.0,-12,C
1150,5008879,F,N,Y,2,126000.0,Commercial associate,Higher education,Married,House / apartment,-12411,-1773,1,0,0,1,Managers,4.0,-13,C
1151,5008879,F,N,Y,2,126000.0,Commercial associate,Higher education,Married,House / apartment,-12411,-1773,1,0,0,1,Managers,4.0,-14,C
1152,5008879,F,N,Y,2,126000.0,Commercial associate,Higher education,Married,House / apartment,-12411,-1773,1,0,0,1,Managers,4.0,-15,C
1153,5008879,F,N,Y,2,126000.0,Commercial associate,Higher education,Married,House / apartment,-12411,-1773,1,0,0,1,Managers,4.0,-16,0
1154,5008879,F,N,Y,2,126000.0,Commercial associate,Higher education,Married,House / apartment,-12411,-1773,1,0,0,1,Managers,4.0,-17,0
1155,5008879,F,N,Y,2,126000.0,Commercial associate,Higher education,Married,House / apartment,-12411,-1773,1,0,0,1,Managers,4.0,-18,0
1156,5008879,F,N,Y,2,126000.0,Commercial associate,Higher education,Married,House / apartment,-12411,-1773,1,0,0,1,Managers,4.0,-19,0
1157,5008879,F,N,Y,2,126000.0,Commercial associate,Higher education,Married,House / apartment,-12411,-1773,1,0,0,1,Managers,4.0,-20,0
1158,5008879,F,N,Y,2,126000.0,Commercial associate,Higher education,Married,House / apartment,-12411,-1773,1,0,0,1,Managers,4.0,-21,0
1159,5008880,F,N,Y,2,126000.0,Commercial associate,Higher education,Married,House / apartment,-12411,-1773,1,0,0,1,Managers,4.0,0,C
1160,5008880,F,N,Y,2,126000.0,Commercial associate,Higher education,Married,House / apartment,-12411,-1773,1,0,0,1,Managers,4.0,-1,C
1161,5008880,F,N,Y,2,126000.0,Commercial associate,Higher education,Married,House / apartment,-12411,-1773,1,0,0,1,Managers,4.0,-2,C
1162,5008880,F,N,Y,2,126000.0,Commercial associate,Higher education,Married,House / apartment,-12411,-1773,1,0,0,1,Managers,4.0,-3,C
1163,5008880,F,N,Y,2,126000.0,Commercial associate,Higher education,Married,House / apartment,-12411,-1773,1,0,0,1,Managers,4.0,-4,C
1164,5008880,F,N,Y,2,126000.0,Commercial associate,Higher education,Married,House / apartment,-12411,-1773,1,0,0,1,Managers,4.0,-5,0
1165,5008880,F,N,Y,2,126000.0,Commercial associate,Higher education,Married,House / apartment,-12411,-1773,1,0,0,1,Managers,4.0,-6,0
1166,5008880,F,N,Y,2,126000.0,Commercial associate,Higher education,Married,House / apartment,-12411,-1773,1,0,0,1,Managers,4.0,-7,0
1167,5008880,F,N,Y,2,126000.0,Commercial associate,Higher education,Married,House / apartment,-12411,-1773,1,0,0,1,Managers,4.0,-8,0
1168,5008880,F,N,Y,2,126000.0,Commercial associate,Higher education,Married,House / apartment,-12411,-1773,1,0,0,1,Managers,4.0,-9,0
1169,5008880,F,N,Y,2,126000.0,Commercial associate,Higher education,Married,House / apartment,-12411,-1773,1,0,0,1,Managers,4.0,-10,0
1170,5008881,F,N,Y,2,126000.0,Commercial associate,Higher education,Married,House / apartment,-12411,-1773,1,0,0,1,Managers,4.0,0,C
1171,5008881,F,N,Y,2,126000.0,Commercial associate,Higher education,Married,House / apartment,-12411,-1773,1,0,0,1,Managers,4.0,-1,C
1172,5008881,F,N,Y,2,126000.0,Commercial associate,Higher education,Married,House / apartment,-12411,-1773,1,0,0,1,Managers,4.0,-2,C
1173,5008881,F,N,Y,2,126000.0,Commercial associate,Higher education,Married,House / apartment,-12411,-1773,1,0,0,1,Managers,4.0,-3,C
1174,5008881,F,N,Y,2,126000.0,Commercial associate,Higher education,Married,House / apartment,-12411,-1773,1,0,0,1,Managers,4.0,-4,C
1175,5008881,F,N,Y,2,126000.0,Commercial associate,Higher education,Married,House / apartment,-12411,-1773,1,0,0,1,Managers,4.0,-5,C
1176,5008881,F,N,Y,2,126000.0,Commercial associate,Higher education,Married,House / apartment,-12411,-1773,1,0,0,1,Managers,4.0,-6,C
1177,5008881,F,N,Y,2,126000.0,Commercial associate,Higher education,Married,House / apartment,-12411,-1773,1,0,0,1,Managers,4.0,-7,C
1178,5008881,F,N,Y,2,126000.0,Commercial associate,Higher education,Married,House / apartment,-12411,-1773,1,0,0,1,Managers,4.0,-8,C
1179,5008881,F,N,Y,2,126000.0,Commercial associate,Higher education,Married,House / apartment,-12411,-1773,1,0,0,1,Managers,4.0,-9,C
1180,5008881,F,N,Y,2,126000.0,Commercial associate,Higher education,Married,House / apartment,-12411,-1773,1,0,0,1,Managers,4.0,-10,C
1181,5008881,F,N,Y,2,126000.0,Commercial associate,Higher education,Married,House / apartment,-12411,-1773,1,0,0,1,Managers,4.0,-11,C
1182,5008881,F,N,Y,2,126000.0,Commercial associate,Higher education,Married,House / apartment,-12411,-1773,1,0,0,1,Managers,4.0,-12,C
1183,5008881,F,N,Y,2,126000.0,Commercial associate,Higher education,Married,House / apartment,-12411,-1773,1,0,0,1,Managers,4.0,-13,C
1184,5008881,F,N,Y,2,126000.0,Commercial associate,Higher education,Married,House / apartment,-12411,-1773,1,0,0,1,Managers,4.0,-14,0
1185,5008881,F,N,Y,2,126000.0,Commercial associate,Higher education,Married,House / apartment,-12411,-1773,1,0,0,1,Managers,4.0,-15,0
1186,5008881,F,N,Y,2,126000.0,Commercial associate,Higher education,Married,House / apartment,-12411,-1773,1,0,0,1,Managers,4.0,-16,0
1187,5008881,F,N,Y,2,126000.0,Commercial associate,Higher education,Married,House / apartment,-12411,-1773,1,0,0,1,Managers,4.0,-17,0
1188,5008881,F,N,Y,2,126000.0,Commercial associate,Higher education,Married,House / apartment,-12411,-1773,1,0,0,1,Managers,4.0,-18,0
1189,5008881,F,N,Y,2,126000.0,Commercial associate,Higher education,Married,House / apartment,-12411,-1773,1,0,0,1,Managers,4.0,-19,0
1190,5008882,F,N,Y,2,126000.0,Commercial associate,Higher education,Married,House / apartment,-12411,-1773,1,0,0,1,Managers,4.0,-6,C
1191,5008882,F,N,Y,2,126000.0,Commercial associate,Higher education,Married,House / apartment,-12411,-1773,1,0,0,1,Managers,4.0,-7,C
1192,5008882,F,N,Y,2,126000.0,Commercial associate,Higher education,Married,House / apartment,-12411,-1773,1,0,0,1,Managers,4.0,-8,C
1193,5008882,F,N,Y,2,126000.0,Commercial associate,Higher education,Married,House / apartment,-12411,-1773,1,0,0,1,Managers,4.0,-9,C
1194,5008882,F,N,Y,2,126000.0,Commercial associate,Higher education,Married,House / apartment,-12411,-1773,1,0,0,1,Managers,4.0,-10,C
1195,5008882,F,N,Y,2,126000.0,Commercial associate,Higher education,Married,House / apartment,-12411,-1773,1,0,0,1,Managers,4.0,-11,C
1196,5008882,F,N,Y,2,126000.0,Commercial associate,Higher education,Married,House / apartment,-12411,-1773,1,0,0,1,Managers,4.0,-12,C
1197,5008882,F,N,Y,2,126000.0,Commercial associate,Higher education,Married,House / apartment,-12411,-1773,1,0,0,1,Managers,4.0,-13,C
1198,5008882,F,N,Y,2,126000.0,Commercial associate,Higher education,Married,House / apartment,-12411,-1773,1,0,0,1,Managers,4.0,-14,C
1199,5008882,F,N,Y,2,126000.0,Commercial associate,Higher education,Married,House / apartment,-12411,-1773,1,0,0,1,Managers,4.0,-15,C
1200,5008882,F,N,Y,2,126000.0,Commercial associate,Higher education,Married,House / apartment,-12411,-1773,1,0,0,1,Managers,4.0,-16,C
1201,5008882,F,N,Y,2,126000.0,Commercial associate,Higher education,Married,House / apartment,-12411,-1773,1,0,0,1,Managers,4.0,-17,C
1202,5008882,F,N,Y,2,126000.0,Commercial associate,Higher education,Married,House / apartment,-12411,-1773,1,0,0,1,Managers,4.0,-18,C
1203,5008882,F,N,Y,2,126000.0,Commercial associate,Higher education,Married,House / apartment,-12411,-1773,1,0,0,1,Managers,4.0,-19,C
1204,5008882,F,N,Y,2,126000.0,Commercial associate,Higher education,Married,House / apartment,-12411,-1773,1,0,0,1,Managers,4.0,-20,C
1205,5008882,F,N,Y,2,126000.0,Commercial associate,Higher education,Married,House / apartment,-12411,-1773,1,0,0,1,Managers,4.0,-21,C
1206,5008882,F,N,Y,2,126000.0,Commercial associate,Higher education,Married,House / apartment,-12411,-1773,1,0,0,1,Managers,4.0,-22,C
1207,5008882,F,N,Y,2,126000.0,Commercial associate,Higher education,Married,House / apartment,-12411,-1773,1,0,0,1,Managers,4.0,-23,C
1208,5008882,F,N,Y,2,126000.0,Commercial associate,Higher education,Married,House / apartment,-12411,-1773,1,0,0,1,Managers,4.0,-24,C
1209,5008882,F,N,Y,2,126000.0,Commercial associate,Higher education,Married,House / apartment,-12411,-1773,1,0,0,1,Managers,4.0,-25,C
1210,5008882,F,N,Y,2,126000.0,Commercial associate,Higher education,Married,House / apartment,-12411,-1773,1,0,0,1,Managers,4.0,-26,C
1211,5008882,F,N,Y,2,126000.0,Commercial associate,Higher education,Married,House / apartment,-12411,-1773,1,0,0,1,Managers,4.0,-27,C
1212,5008882,F,N,Y,2,126000.0,Commercial associate,Higher education,Married,House / apartment,-12411,-1773,1,0,0,1,Managers,4.0,-28,C
1213,5008882,F,N,Y,2,126000.0,Commercial associate,Higher education,Married,House / apartment,-12411,-1773,1,0,0,1,Managers,4.0,-29,C
1214,5008882,F,N,Y,2,126000.0,Commercial associate,Higher education,Married,House / apartment,-12411,-1773,1,0,0,1,Managers,4.0,-30,C
1215,5008882,F,N,Y,2,126000.0,Commercial associate,Higher education,Married,House / apartment,-12411,-1773,1,0,0,1,Managers,4.0,-31,C
1216,5008882,F,N,Y,2,126000.0,Commercial associate,Higher education,Married,House / apartment,-12411,-1773,1,0,0,1,Managers,4.0,-32,C
1217,5008882,F,N,Y,2,126000.0,Commercial associate,Higher education,Married,House / apartment,-12411,-1773,1,0,0,1,Managers,4.0,-33,C
1218,5008882,F,N,Y,2,126000.0,Commercial associate,Higher education,Married,House / apartment,-12411,-1773,1,0,0,1,Managers,4.0,-34,C
1219,5008882,F,N,Y,2,126000.0,Commercial associate,Higher education,Married,House / apartment,-12411,-1773,1,0,0,1,Managers,4.0,-35,C
1220,5008882,F,N,Y,2,126000.0,Commercial associate,Higher education,Married,House / apartment,-12411,-1773,1,0,0,1,Managers,4.0,-36,C
1221,5008882,F,N,Y,2,126000.0,Commercial associate,Higher education,Married,House / apartment,-12411,-1773,1,0,0,1,Managers,4.0,-37,0
1222,5008882,F,N,Y,2,126000.0,Commercial associate,Higher education,Married,House / apartment,-12411,-1773,1,0,0,1,Managers,4.0,-38,0
1223,5008882,F,N,Y,2,126000.0,Commercial associate,Higher education,Married,House / apartment,-12411,-1773,1,0,0,1,Managers,4.0,-39,0
1224,5008882,F,N,Y,2,126000.0,Commercial associate,Higher education,Married,House / apartment,-12411,-1773,1,0,0,1,Managers,4.0,-40,0
1225,5008882,F,N,Y,2,126000.0,Commercial associate,Higher education,Married,House / apartment,-12411,-1773,1,0,0,1,Managers,4.0,-41,0
1226,5008882,F,N,Y,2,126000.0,Commercial associate,Higher education,Married,House / apartment,-12411,-1773,1,0,0,1,Managers,4.0,-42,0
1227,5008882,F,N,Y,2,126000.0,Commercial associate,Higher education,Married,House / apartment,-12411,-1773,1,0,0,1,Managers,4.0,-43,0
1228,5008882,F,N,Y,2,126000.0,Commercial associate,Higher education,Married,House / apartment,-12411,-1773,1,0,0,1,Managers,4.0,-44,0
1229,5008882,F,N,Y,2,126000.0,Commercial associate,Higher education,Married,House / apartment,-12411,-1773,1,0,0,1,Managers,4.0,-45,0
1230,5008884,F,N,Y,0,315000.0,Pensioner,Secondary / secondary special,Widow,House / apartment,-20186,365243,1,0,0,0,,1.0,0,C
1231,5008884,F,N,Y,0,315000.0,Pensioner,Secondary / secondary special,Widow,House / apartment,-20186,365243,1,0,0,0,,1.0,-1,C
1232,5008884,F,N,Y,0,315000.0,Pensioner,Secondary / secondary special,Widow,House / apartment,-20186,365243,1,0,0,0,,1.0,-2,C
1233,5008884,F,N,Y,0,315000.0,Pensioner,Secondary / secondary special,Widow,House / apartment,-20186,365243,1,0,0,0,,1.0,-3,C
1234,5008884,F,N,Y,0,315000.0,Pensioner,Secondary / secondary special,Widow,House / apartment,-20186,365243,1,0,0,0,,1.0,-4,C
1235,5008884,F,N,Y,0,315000.0,Pensioner,Secondary / secondary special,Widow,House / apartment,-20186,365243,1,0,0,0,,1.0,-5,C
1236,5008884,F,N,Y,0,315000.0,Pensioner,Secondary / secondary special,Widow,House / apartment,-20186,365243,1,0,0,0,,1.0,-6,C
1237,5008884,F,N,Y,0,315000.0,Pensioner,Secondary / secondary special,Widow,House / apartment,-20186,365243,1,0,0,0,,1.0,-7,C
1238,5008884,F,N,Y,0,315000.0,Pensioner,Secondary / secondary special,Widow,House / apartment,-20186,365243,1,0,0,0,,1.0,-8,C
1239,5008884,F,N,Y,0,315000.0,Pensioner,Secondary / secondary special,Widow,House / apartment,-20186,365243,1,0,0,0,,1.0,-9,C
1240,5008884,F,N,Y,0,315000.0,Pensioner,Secondary / secondary special,Widow,House / apartment,-20186,365243,1,0,0,0,,1.0,-10,C
1241,5008884,F,N,Y,0,315000.0,Pensioner,Secondary / secondary special,Widow,House / apartment,-20186,365243,1,0,0,0,,1.0,-11,C
1242,5008884,F,N,Y,0,315000.0,Pensioner,Secondary / secondary special,Widow,House / apartment,-20186,365243,1,0,0,0,,1.0,-12,C
1243,5008884,F,N,Y,0,315000.0,Pensioner,Secondary / secondary special,Widow,House / apartment,-20186,365243,1,0,0,0,,1.0,-13,C
1244,5008884,F,N,Y,0,315000.0,Pensioner,Secondary / secondary special,Widow,House / apartment,-20186,365243,1,0,0,0,,1.0,-14,C
1245,5008884,F,N,Y,0,315000.0,Pensioner,Secondary / secondary special,Widow,House / apartment,-20186,365243,1,0,0,0,,1.0,-15,C
1246,5008884,F,N,Y,0,315000.0,Pensioner,Secondary / secondary special,Widow,House / apartment,-20186,365243,1,0,0,0,,1.0,-16,C
1247,5008884,F,N,Y,0,315000.0,Pensioner,Secondary / secondary special,Widow,House / apartment,-20186,365243,1,0,0,0,,1.0,-17,C
1248,5008884,F,N,Y,0,315000.0,Pensioner,Secondary / secondary special,Widow,House / apartment,-20186,365243,1,0,0,0,,1.0,-18,C
1249,5008884,F,N,Y,0,315000.0,Pensioner,Secondary / secondary special,Widow,House / apartment,-20186,365243,1,0,0,0,,1.0,-19,C
1250,5008884,F,N,Y,0,315000.0,Pensioner,Secondary / secondary special,Widow,House / apartment,-20186,365243,1,0,0,0,,1.0,-20,C
1251,5008884,F,N,Y,0,315000.0,Pensioner,Secondary / secondary special,Widow,House / apartment,-20186,365243,1,0,0,0,,1.0,-21,C
1252,5008884,F,N,Y,0,315000.0,Pensioner,Secondary / secondary special,Widow,House / apartment,-20186,365243,1,0,0,0,,1.0,-22,C
1253,5008884,F,N,Y,0,315000.0,Pensioner,Secondary / secondary special,Widow,House / apartment,-20186,365243,1,0,0,0,,1.0,-23,X
1254,5008884,F,N,Y,0,315000.0,Pensioner,Secondary / secondary special,Widow,House / apartment,-20186,365243,1,0,0,0,,1.0,-24,X
1255,5008884,F,N,Y,0,315000.0,Pensioner,Secondary / secondary special,Widow,House / apartment,-20186,365243,1,0,0,0,,1.0,-25,X
1256,5008884,F,N,Y,0,315000.0,Pensioner,Secondary / secondary special,Widow,House / apartment,-20186,365243,1,0,0,0,,1.0,-26,X
1257,5008884,F,N,Y,0,315000.0,Pensioner,Secondary / secondary special,Widow,House / apartment,-20186,365243,1,0,0,0,,1.0,-27,X
1258,5008884,F,N,Y,0,315000.0,Pensioner,Secondary / secondary special,Widow,House / apartment,-20186,365243,1,0,0,0,,1.0,-28,X
1259,5008884,F,N,Y,0,315000.0,Pensioner,Secondary / secondary special,Widow,House / apartment,-20186,365243,1,0,0,0,,1.0,-29,X
1260,5008884,F,N,Y,0,315000.0,Pensioner,Secondary / secondary special,Widow,House / apartment,-20186,365243,1,0,0,0,,1.0,-30,X
1261,5008884,F,N,Y,0,315000.0,Pensioner,Secondary / secondary special,Widow,House / apartment,-20186,365243,1,0,0,0,,1.0,-31,X
1262,5008884,F,N,Y,0,315000.0,Pensioner,Secondary / secondary special,Widow,House / apartment,-20186,365243,1,0,0,0,,1.0,-32,X
1263,5008884,F,N,Y,0,315000.0,Pensioner,Secondary / secondary special,Widow,House / apartment,-20186,365243,1,0,0,0,,1.0,-33,0
1264,5008884,F,N,Y,0,315000.0,Pensioner,Secondary / secondary special,Widow,House / apartment,-20186,365243,1,0,0,0,,1.0,-34,0
1265,5008884,F,N,Y,0,315000.0,Pensioner,Secondary / secondary special,Widow,House / apartment,-20186,365243,1,0,0,0,,1.0,-35,0
1266,5008884,F,N,Y,0,315000.0,Pensioner,Secondary / secondary special,Widow,House / apartment,-20186,365243,1,0,0,0,,1.0,-36,X
1267,5008884,F,N,Y,0,315000.0,Pensioner,Secondary / secondary special,Widow,House / apartment,-20186,365243,1,0,0,0,,1.0,-37,X
1268,5008884,F,N,Y,0,315000.0,Pensioner,Secondary / secondary special,Widow,House / apartment,-20186,365243,1,0,0,0,,1.0,-38,0
1269,5008884,F,N,Y,0,315000.0,Pensioner,Secondary / secondary special,Widow,House / apartment,-20186,365243,1,0,0,0,,1.0,-39,X
1270,5008884,F,N,Y,0,315000.0,Pensioner,Secondary / secondary special,Widow,House / apartment,-20186,365243,1,0,0,0,,1.0,-40,X
1271,5008888,F,N,Y,0,247500.0,Commercial associate,Higher education,Separated,Rented apartment,-17016,-1347,1,0,0,0,Core staff,1.0,-6,X
1272,5008888,F,N,Y,0,247500.0,Commercial associate,Higher education,Separated,Rented apartment,-17016,-1347,1,0,0,0,Core staff,1.0,-7,0
1273,5008888,F,N,Y,0,247500.0,Commercial associate,Higher education,Separated,Rented apartment,-17016,-1347,1,0,0,0,Core staff,1.0,-8,0
1274,5008888,F,N,Y,0,247500.0,Commercial associate,Higher education,Separated,Rented apartment,-17016,-1347,1,0,0,0,Core staff,1.0,-9,0
1275,5008888,F,N,Y,0,247500.0,Commercial associate,Higher education,Separated,Rented apartment,-17016,-1347,1,0,0,0,Core staff,1.0,-10,0
1276,5008888,F,N,Y,0,247500.0,Commercial associate,Higher education,Separated,Rented apartment,-17016,-1347,1,0,0,0,Core staff,1.0,-11,X
1277,5008889,F,N,Y,0,247500.0,Commercial associate,Higher education,Separated,Rented apartment,-17016,-1347,1,0,0,0,Core staff,1.0,0,0
1278,5008889,F,N,Y,0,247500.0,Commercial associate,Higher education,Separated,Rented apartment,-17016,-1347,1,0,0,0,Core staff,1.0,-1,0
1279,5008889,F,N,Y,0,247500.0,Commercial associate,Higher education,Separated,Rented apartment,-17016,-1347,1,0,0,0,Core staff,1.0,-2,X
1280,5008889,F,N,Y,0,247500.0,Commercial associate,Higher education,Separated,Rented apartment,-17016,-1347,1,0,0,0,Core staff,1.0,-3,0
1281,5008889,F,N,Y,0,247500.0,Commercial associate,Higher education,Separated,Rented apartment,-17016,-1347,1,0,0,0,Core staff,1.0,-4,X
1282,5008890,F,N,Y,0,247500.0,Commercial associate,Higher education,Separated,Rented apartment,-17016,-1347,1,0,0,0,Core staff,1.0,-43,X
1283,5008890,F,N,Y,0,247500.0,Commercial associate,Higher education,Separated,Rented apartment,-17016,-1347,1,0,0,0,Core staff,1.0,-44,0
1284,5008890,F,N,Y,0,247500.0,Commercial associate,Higher education,Separated,Rented apartment,-17016,-1347,1,0,0,0,Core staff,1.0,-45,0
1285,5008890,F,N,Y,0,247500.0,Commercial associate,Higher education,Separated,Rented apartment,-17016,-1347,1,0,0,0,Core staff,1.0,-46,0
1286,5008890,F,N,Y,0,247500.0,Commercial associate,Higher education,Separated,Rented apartment,-17016,-1347,1,0,0,0,Core staff,1.0,-47,0
1287,5008890,F,N,Y,0,247500.0,Commercial associate,Higher education,Separated,Rented apartment,-17016,-1347,1,0,0,0,Core staff,1.0,-48,X
1288,5112847,F,N,Y,0,247500.0,Commercial associate,Higher education,Separated,Rented apartment,-17016,-1347,1,0,0,0,Core staff,1.0,-20,X
1289,5112847,F,N,Y,0,247500.0,Commercial associate,Higher education,Separated,Rented apartment,-17016,-1347,1,0,0,0,Core staff,1.0,-21,0
1290,5112847,F,N,Y,0,247500.0,Commercial associate,Higher education,Separated,Rented apartment,-17016,-1347,1,0,0,0,Core staff,1.0,-22,0
1291,5112847,F,N,Y,0,247500.0,Commercial associate,Higher education,Separated,Rented apartment,-17016,-1347,1,0,0,0,Core staff,1.0,-23,0
1292,5112847,F,N,Y,0,247500.0,Commercial associate,Higher education,Separated,Rented apartment,-17016,-1347,1,0,0,0,Core staff,1.0,-24,0
1293,5112847,F,N,Y,0,247500.0,Commercial associate,Higher education,Separated,Rented apartment,-17016,-1347,1,0,0,0,Core staff,1.0,-25,X
1294,5008891,F,N,Y,0,297000.0,Commercial associate,Secondary / secondary special,Single / not married,Rented apartment,-15519,-3234,1,0,0,0,Laborers,1.0,0,C
1295,5008891,F,N,Y,0,297000.0,Commercial associate,Secondary / secondary special,Single / not married,Rented apartment,-15519,-3234,1,0,0,0,Laborers,1.0,-1,C
1296,5008891,F,N,Y,0,297000.0,Commercial associate,Secondary / secondary special,Single / not married,Rented apartment,-15519,-3234,1,0,0,0,Laborers,1.0,-2,C
1297,5008891,F,N,Y,0,297000.0,Commercial associate,Secondary / secondary special,Single / not married,Rented apartment,-15519,-3234,1,0,0,0,Laborers,1.0,-3,C
1298,5008891,F,N,Y,0,297000.0,Commercial associate,Secondary / secondary special,Single / not married,Rented apartment,-15519,-3234,1,0,0,0,Laborers,1.0,-4,C
1299,5008891,F,N,Y,0,297000.0,Commercial associate,Secondary / secondary special,Single / not married,Rented apartment,-15519,-3234,1,0,0,0,Laborers,1.0,-5,C
1300,5008891,F,N,Y,0,297000.0,Commercial associate,Secondary / secondary special,Single / not married,Rented apartment,-15519,-3234,1,0,0,0,Laborers,1.0,-6,C
1301,5008891,F,N,Y,0,297000.0,Commercial associate,Secondary / secondary special,Single / not married,Rented apartment,-15519,-3234,1,0,0,0,Laborers,1.0,-7,0
1302,5008892,F,N,Y,0,297000.0,Commercial associate,Secondary / secondary special,Single / not married,Rented apartment,-15519,-3234,1,0,0,0,Laborers,1.0,-22,C
1303,5008892,F,N,Y,0,297000.0,Commercial associate,Secondary / secondary special,Single / not married,Rented apartment,-15519,-3234,1,0,0,0,Laborers,1.0,-23,C
1304,5008892,F,N,Y,0,297000.0,Commercial associate,Secondary / secondary special,Single / not married,Rented apartment,-15519,-3234,1,0,0,0,Laborers,1.0,-24,C
1305,5008892,F,N,Y,0,297000.0,Commercial associate,Secondary / secondary special,Single / not married,Rented apartment,-15519,-3234,1,0,0,0,Laborers,1.0,-25,C
1306,5008892,F,N,Y,0,297000.0,Commercial associate,Secondary / secondary special,Single / not married,Rented apartment,-15519,-3234,1,0,0,0,Laborers,1.0,-26,C
1307,5008892,F,N,Y,0,297000.0,Commercial associate,Secondary / secondary special,Single / not married,Rented apartment,-15519,-3234,1,0,0,0,Laborers,1.0,-27,C
1308,5008892,F,N,Y,0,297000.0,Commercial associate,Secondary / secondary special,Single / not married,Rented apartment,-15519,-3234,1,0,0,0,Laborers,1.0,-28,C
1309,5008892,F,N,Y,0,297000.0,Commercial associate,Secondary / secondary special,Single / not married,Rented apartment,-15519,-3234,1,0,0,0,Laborers,1.0,-29,C
1310,5008892,F,N,Y,0,297000.0,Commercial associate,Secondary / secondary special,Single / not married,Rented apartment,-15519,-3234,1,0,0,0,Laborers,1.0,-30,C
1311,5008892,F,N,Y,0,297000.0,Commercial associate,Secondary / secondary special,Single / not married,Rented apartment,-15519,-3234,1,0,0,0,Laborers,1.0,-31,C
1312,5008892,F,N,Y,0,297000.0,Commercial associate,Secondary / secondary special,Single / not married,Rented apartment,-15519,-3234,1,0,0,0,Laborers,1.0,-32,C
1313,5008892,F,N,Y,0,297000.0,Commercial associate,Secondary / secondary special,Single / not married,Rented apartment,-15519,-3234,1,0,0,0,Laborers,1.0,-33,C
1314,5008892,F,N,Y,0,297000.0,Commercial associate,Secondary / secondary special,Single / not married,Rented apartment,-15519,-3234,1,0,0,0,Laborers,1.0,-34,C
1315,5008892,F,N,Y,0,297000.0,Commercial associate,Secondary / secondary special,Single / not married,Rented apartment,-15519,-3234,1,0,0,0,Laborers,1.0,-35,C
1316,5008892,F,N,Y,0,297000.0,Commercial associate,Secondary / secondary special,Single / not married,Rented apartment,-15519,-3234,1,0,0,0,Laborers,1.0,-36,C
1317,5008892,F,N,Y,0,297000.0,Commercial associate,Secondary / secondary special,Single / not married,Rented apartment,-15519,-3234,1,0,0,0,Laborers,1.0,-37,0
1318,5008893,F,N,Y,0,297000.0,Commercial associate,Secondary / secondary special,Single / not married,Rented apartment,-15519,-3234,1,0,0,0,Laborers,1.0,0,C
1319,5008893,F,N,Y,0,297000.0,Commercial associate,Secondary / secondary special,Single / not married,Rented apartment,-15519,-3234,1,0,0,0,Laborers,1.0,-1,C
1320,5008893,F,N,Y,0,297000.0,Commercial associate,Secondary / secondary special,Single / not married,Rented apartment,-15519,-3234,1,0,0,0,Laborers,1.0,-2,C
1321,5008893,F,N,Y,0,297000.0,Commercial associate,Secondary / secondary special,Single / not married,Rented apartment,-15519,-3234,1,0,0,0,Laborers,1.0,-3,C
1322,5008893,F,N,Y,0,297000.0,Commercial associate,Secondary / secondary special,Single / not married,Rented apartment,-15519,-3234,1,0,0,0,Laborers,1.0,-4,C
1323,5008893,F,N,Y,0,297000.0,Commercial associate,Secondary / secondary special,Single / not married,Rented apartment,-15519,-3234,1,0,0,0,Laborers,1.0,-5,C
1324,5008893,F,N,Y,0,297000.0,Commercial associate,Secondary / secondary special,Single / not married,Rented apartment,-15519,-3234,1,0,0,0,Laborers,1.0,-6,C
1325,5008893,F,N,Y,0,297000.0,Commercial associate,Secondary / secondary special,Single / not married,Rented apartment,-15519,-3234,1,0,0,0,Laborers,1.0,-7,C
1326,5008893,F,N,Y,0,297000.0,Commercial associate,Secondary / secondary special,Single / not married,Rented apartment,-15519,-3234,1,0,0,0,Laborers,1.0,-8,C
1327,5008893,F,N,Y,0,297000.0,Commercial associate,Secondary / secondary special,Single / not married,Rented apartment,-15519,-3234,1,0,0,0,Laborers,1.0,-9,C
1328,5008893,F,N,Y,0,297000.0,Commercial associate,Secondary / secondary special,Single / not married,Rented apartment,-15519,-3234,1,0,0,0,Laborers,1.0,-10,C
1329,5008893,F,N,Y,0,297000.0,Commercial associate,Secondary / secondary special,Single / not married,Rented apartment,-15519,-3234,1,0,0,0,Laborers,1.0,-11,C
1330,5008893,F,N,Y,0,297000.0,Commercial associate,Secondary / secondary special,Single / not married,Rented apartment,-15519,-3234,1,0,0,0,Laborers,1.0,-12,C
1331,5008893,F,N,Y,0,297000.0,Commercial associate,Secondary / secondary special,Single / not married,Rented apartment,-15519,-3234,1,0,0,0,Laborers,1.0,-13,C
1332,5008893,F,N,Y,0,297000.0,Commercial associate,Secondary / secondary special,Single / not married,Rented apartment,-15519,-3234,1,0,0,0,Laborers,1.0,-14,C
1333,5008893,F,N,Y,0,297000.0,Commercial associate,Secondary / secondary special,Single / not married,Rented apartment,-15519,-3234,1,0,0,0,Laborers,1.0,-15,C
1334,5008893,F,N,Y,0,297000.0,Commercial associate,Secondary / secondary special,Single / not married,Rented apartment,-15519,-3234,1,0,0,0,Laborers,1.0,-16,C
1335,5008893,F,N,Y,0,297000.0,Commercial associate,Secondary / secondary special,Single / not married,Rented apartment,-15519,-3234,1,0,0,0,Laborers,1.0,-17,C
1336,5008893,F,N,Y,0,297000.0,Commercial associate,Secondary / secondary special,Single / not married,Rented apartment,-15519,-3234,1,0,0,0,Laborers,1.0,-18,C
1337,5008893,F,N,Y,0,297000.0,Commercial associate,Secondary / secondary special,Single / not married,Rented apartment,-15519,-3234,1,0,0,0,Laborers,1.0,-19,C
1338,5008893,F,N,Y,0,297000.0,Commercial associate,Secondary / secondary special,Single / not married,Rented apartment,-15519,-3234,1,0,0,0,Laborers,1.0,-20,C
1339,5008893,F,N,Y,0,297000.0,Commercial associate,Secondary / secondary special,Single / not married,Rented apartment,-15519,-3234,1,0,0,0,Laborers,1.0,-21,C
1340,5008893,F,N,Y,0,297000.0,Commercial associate,Secondary / secondary special,Single / not married,Rented apartment,-15519,-3234,1,0,0,0,Laborers,1.0,-22,C
1341,5008893,F,N,Y,0,297000.0,Commercial associate,Secondary / secondary special,Single / not married,Rented apartment,-15519,-3234,1,0,0,0,Laborers,1.0,-23,C
1342,5008893,F,N,Y,0,297000.0,Commercial associate,Secondary / secondary special,Single / not married,Rented apartment,-15519,-3234,1,0,0,0,Laborers,1.0,-24,C
1343,5008893,F,N,Y,0,297000.0,Commercial associate,Secondary / secondary special,Single / not married,Rented apartment,-15519,-3234,1,0,0,0,Laborers,1.0,-25,C
1344,5008893,F,N,Y,0,297000.0,Commercial associate,Secondary / secondary special,Single / not married,Rented apartment,-15519,-3234,1,0,0,0,Laborers,1.0,-26,C
1345,5008893,F,N,Y,0,297000.0,Commercial associate,Secondary / secondary special,Single / not married,Rented apartment,-15519,-3234,1,0,0,0,Laborers,1.0,-27,C
1346,5008893,F,N,Y,0,297000.0,Commercial associate,Secondary / secondary special,Single / not married,Rented apartment,-15519,-3234,1,0,0,0,Laborers,1.0,-28,C
1347,5008893,F,N,Y,0,297000.0,Commercial associate,Secondary / secondary special,Single / not married,Rented apartment,-15519,-3234,1,0,0,0,Laborers,1.0,-29,C
1348,5008893,F,N,Y,0,297000.0,Commercial associate,Secondary / secondary special,Single / not married,Rented apartment,-15519,-3234,1,0,0,0,Laborers,1.0,-30,C
1349,5008893,F,N,Y,0,297000.0,Commercial associate,Secondary / secondary special,Single / not married,Rented apartment,-15519,-3234,1,0,0,0,Laborers,1.0,-31,C
1350,5008893,F,N,Y,0,297000.0,Commercial associate,Secondary / secondary special,Single / not married,Rented apartment,-15519,-3234,1,0,0,0,Laborers,1.0,-32,C
1351,5008893,F,N,Y,0,297000.0,Commercial associate,Secondary / secondary special,Single / not married,Rented apartment,-15519,-3234,1,0,0,0,Laborers,1.0,-33,C
1352,5008893,F,N,Y,0,297000.0,Commercial associate,Secondary / secondary special,Single / not married,Rented apartment,-15519,-3234,1,0,0,0,Laborers,1.0,-34,C
1353,5008893,F,N,Y,0,297000.0,Commercial associate,Secondary / secondary special,Single / not married,Rented apartment,-15519,-3234,1,0,0,0,Laborers,1.0,-35,C
1354,5008893,F,N,Y,0,297000.0,Commercial associate,Secondary / secondary special,Single / not married,Rented apartment,-15519,-3234,1,0,0,0,Laborers,1.0,-36,C
1355,5008894,F,N,Y,0,297000.0,Commercial associate,Secondary / secondary special,Single / not married,Rented apartment,-15519,-3234,1,0,0,0,Laborers,1.0,0,C
1356,5008894,F,N,Y,0,297000.0,Commercial associate,Secondary / secondary special,Single / not married,Rented apartment,-15519,-3234,1,0,0,0,Laborers,1.0,-1,C
1357,5008894,F,N,Y,0,297000.0,Commercial associate,Secondary / secondary special,Single / not married,Rented apartment,-15519,-3234,1,0,0,0,Laborers,1.0,-2,C
1358,5008894,F,N,Y,0,297000.0,Commercial associate,Secondary / secondary special,Single / not married,Rented apartment,-15519,-3234,1,0,0,0,Laborers,1.0,-3,C
1359,5008894,F,N,Y,0,297000.0,Commercial associate,Secondary / secondary special,Single / not married,Rented apartment,-15519,-3234,1,0,0,0,Laborers,1.0,-4,C
1360,5008894,F,N,Y,0,297000.0,Commercial associate,Secondary / secondary special,Single / not married,Rented apartment,-15519,-3234,1,0,0,0,Laborers,1.0,-5,C
1361,5008894,F,N,Y,0,297000.0,Commercial associate,Secondary / secondary special,Single / not married,Rented apartment,-15519,-3234,1,0,0,0,Laborers,1.0,-6,C
1362,5008894,F,N,Y,0,297000.0,Commercial associate,Secondary / secondary special,Single / not married,Rented apartment,-15519,-3234,1,0,0,0,Laborers,1.0,-7,C
1363,5008894,F,N,Y,0,297000.0,Commercial associate,Secondary / secondary special,Single / not married,Rented apartment,-15519,-3234,1,0,0,0,Laborers,1.0,-8,C
1364,5008894,F,N,Y,0,297000.0,Commercial associate,Secondary / secondary special,Single / not married,Rented apartment,-15519,-3234,1,0,0,0,Laborers,1.0,-9,C
1365,5008894,F,N,Y,0,297000.0,Commercial associate,Secondary / secondary special,Single / not married,Rented apartment,-15519,-3234,1,0,0,0,Laborers,1.0,-10,C
1366,5008894,F,N,Y,0,297000.0,Commercial associate,Secondary / secondary special,Single / not married,Rented apartment,-15519,-3234,1,0,0,0,Laborers,1.0,-11,C
1367,5008894,F,N,Y,0,297000.0,Commercial associate,Secondary / secondary special,Single / not married,Rented apartment,-15519,-3234,1,0,0,0,Laborers,1.0,-12,C
1368,5008894,F,N,Y,0,297000.0,Commercial associate,Secondary / secondary special,Single / not married,Rented apartment,-15519,-3234,1,0,0,0,Laborers,1.0,-13,C
1369,5008894,F,N,Y,0,297000.0,Commercial associate,Secondary / secondary special,Single / not married,Rented apartment,-15519,-3234,1,0,0,0,Laborers,1.0,-14,C
1370,5008894,F,N,Y,0,297000.0,Commercial associate,Secondary / secondary special,Single / not married,Rented apartment,-15519,-3234,1,0,0,0,Laborers,1.0,-15,C
1371,5008894,F,N,Y,0,297000.0,Commercial associate,Secondary / secondary special,Single / not married,Rented apartment,-15519,-3234,1,0,0,0,Laborers,1.0,-16,C
1372,5008894,F,N,Y,0,297000.0,Commercial associate,Secondary / secondary special,Single / not married,Rented apartment,-15519,-3234,1,0,0,0,Laborers,1.0,-17,C
1373,5008894,F,N,Y,0,297000.0,Commercial associate,Secondary / secondary special,Single / not married,Rented apartment,-15519,-3234,1,0,0,0,Laborers,1.0,-18,C
1374,5008894,F,N,Y,0,297000.0,Commercial associate,Secondary / secondary special,Single / not married,Rented apartment,-15519,-3234,1,0,0,0,Laborers,1.0,-19,C
1375,5008894,F,N,Y,0,297000.0,Commercial associate,Secondary / secondary special,Single / not married,Rented apartment,-15519,-3234,1,0,0,0,Laborers,1.0,-20,C
1376,5008894,F,N,Y,0,297000.0,Commercial associate,Secondary / secondary special,Single / not married,Rented apartment,-15519,-3234,1,0,0,0,Laborers,1.0,-21,C
1377,5008894,F,N,Y,0,297000.0,Commercial associate,Secondary / secondary special,Single / not married,Rented apartment,-15519,-3234,1,0,0,0,Laborers,1.0,-22,C
1378,5008894,F,N,Y,0,297000.0,Commercial associate,Secondary / secondary special,Single / not married,Rented apartment,-15519,-3234,1,0,0,0,Laborers,1.0,-23,C
1379,5008894,F,N,Y,0,297000.0,Commercial associate,Secondary / secondary special,Single / not married,Rented apartment,-15519,-3234,1,0,0,0,Laborers,1.0,-24,C
1380,5008894,F,N,Y,0,297000.0,Commercial associate,Secondary / secondary special,Single / not married,Rented apartment,-15519,-3234,1,0,0,0,Laborers,1.0,-25,C
1381,5008894,F,N,Y,0,297000.0,Commercial associate,Secondary / secondary special,Single / not married,Rented apartment,-15519,-3234,1,0,0,0,Laborers,1.0,-26,C
1382,5008894,F,N,Y,0,297000.0,Commercial associate,Secondary / secondary special,Single / not married,Rented apartment,-15519,-3234,1,0,0,0,Laborers,1.0,-27,C
1383,5008894,F,N,Y,0,297000.0,Commercial associate,Secondary / secondary special,Single / not married,Rented apartment,-15519,-3234,1,0,0,0,Laborers,1.0,-28,C
1384,5008894,F,N,Y,0,297000.0,Commercial associate,Secondary / secondary special,Single / not married,Rented apartment,-15519,-3234,1,0,0,0,Laborers,1.0,-29,C
1385,5008894,F,N,Y,0,297000.0,Commercial associate,Secondary / secondary special,Single / not married,Rented apartment,-15519,-3234,1,0,0,0,Laborers,1.0,-30,C
1386,5008894,F,N,Y,0,297000.0,Commercial associate,Secondary / secondary special,Single / not married,Rented apartment,-15519,-3234,1,0,0,0,Laborers,1.0,-31,C
1387,5008894,F,N,Y,0,297000.0,Commercial associate,Secondary / secondary special,Single / not married,Rented apartment,-15519,-3234,1,0,0,0,Laborers,1.0,-32,C
1388,5008894,F,N,Y,0,297000.0,Commercial associate,Secondary / secondary special,Single / not married,Rented apartment,-15519,-3234,1,0,0,0,Laborers,1.0,-33,C
1389,5008894,F,N,Y,0,297000.0,Commercial associate,Secondary / secondary special,Single / not married,Rented apartment,-15519,-3234,1,0,0,0,Laborers,1.0,-34,C
1390,5008894,F,N,Y,0,297000.0,Commercial associate,Secondary / secondary special,Single / not married,Rented apartment,-15519,-3234,1,0,0,0,Laborers,1.0,-35,C
1391,5008894,F,N,Y,0,297000.0,Commercial associate,Secondary / secondary special,Single / not married,Rented apartment,-15519,-3234,1,0,0,0,Laborers,1.0,-36,C
1392,5008895,F,N,Y,0,297000.0,Commercial associate,Secondary / secondary special,Single / not married,Rented apartment,-15519,-3234,1,0,0,0,Laborers,1.0,0,C
1393,5008895,F,N,Y,0,297000.0,Commercial associate,Secondary / secondary special,Single / not married,Rented apartment,-15519,-3234,1,0,0,0,Laborers,1.0,-1,C
1394,5008895,F,N,Y,0,297000.0,Commercial associate,Secondary / secondary special,Single / not married,Rented apartment,-15519,-3234,1,0,0,0,Laborers,1.0,-2,C
1395,5008895,F,N,Y,0,297000.0,Commercial associate,Secondary / secondary special,Single / not married,Rented apartment,-15519,-3234,1,0,0,0,Laborers,1.0,-3,C
1396,5008895,F,N,Y,0,297000.0,Commercial associate,Secondary / secondary special,Single / not married,Rented apartment,-15519,-3234,1,0,0,0,Laborers,1.0,-4,C
1397,5008895,F,N,Y,0,297000.0,Commercial associate,Secondary / secondary special,Single / not married,Rented apartment,-15519,-3234,1,0,0,0,Laborers,1.0,-5,C
1398,5008895,F,N,Y,0,297000.0,Commercial associate,Secondary / secondary special,Single / not married,Rented apartment,-15519,-3234,1,0,0,0,Laborers,1.0,-6,C
1399,5008895,F,N,Y,0,297000.0,Commercial associate,Secondary / secondary special,Single / not married,Rented apartment,-15519,-3234,1,0,0,0,Laborers,1.0,-7,C
1400,5008895,F,N,Y,0,297000.0,Commercial associate,Secondary / secondary special,Single / not married,Rented apartment,-15519,-3234,1,0,0,0,Laborers,1.0,-8,C
1401,5008895,F,N,Y,0,297000.0,Commercial associate,Secondary / secondary special,Single / not married,Rented apartment,-15519,-3234,1,0,0,0,Laborers,1.0,-9,C
1402,5008895,F,N,Y,0,297000.0,Commercial associate,Secondary / secondary special,Single / not married,Rented apartment,-15519,-3234,1,0,0,0,Laborers,1.0,-10,C
1403,5008895,F,N,Y,0,297000.0,Commercial associate,Secondary / secondary special,Single / not married,Rented apartment,-15519,-3234,1,0,0,0,Laborers,1.0,-11,C
1404,5008895,F,N,Y,0,297000.0,Commercial associate,Secondary / secondary special,Single / not married,Rented apartment,-15519,-3234,1,0,0,0,Laborers,1.0,-12,C
1405,5008895,F,N,Y,0,297000.0,Commercial associate,Secondary / secondary special,Single / not married,Rented apartment,-15519,-3234,1,0,0,0,Laborers,1.0,-13,C
1406,5008895,F,N,Y,0,297000.0,Commercial associate,Secondary / secondary special,Single / not married,Rented apartment,-15519,-3234,1,0,0,0,Laborers,1.0,-14,C
1407,5008895,F,N,Y,0,297000.0,Commercial associate,Secondary / secondary special,Single / not married,Rented apartment,-15519,-3234,1,0,0,0,Laborers,1.0,-15,C
1408,5008895,F,N,Y,0,297000.0,Commercial associate,Secondary / secondary special,Single / not married,Rented apartment,-15519,-3234,1,0,0,0,Laborers,1.0,-16,C
1409,5008895,F,N,Y,0,297000.0,Commercial associate,Secondary / secondary special,Single / not married,Rented apartment,-15519,-3234,1,0,0,0,Laborers,1.0,-17,C
1410,5008895,F,N,Y,0,297000.0,Commercial associate,Secondary / secondary special,Single / not married,Rented apartment,-15519,-3234,1,0,0,0,Laborers,1.0,-18,C
1411,5008895,F,N,Y,0,297000.0,Commercial associate,Secondary / secondary special,Single / not married,Rented apartment,-15519,-3234,1,0,0,0,Laborers,1.0,-19,C
1412,5008895,F,N,Y,0,297000.0,Commercial associate,Secondary / secondary special,Single / not married,Rented apartment,-15519,-3234,1,0,0,0,Laborers,1.0,-20,C
1413,5008895,F,N,Y,0,297000.0,Commercial associate,Secondary / secondary special,Single / not married,Rented apartment,-15519,-3234,1,0,0,0,Laborers,1.0,-21,C
1414,5008895,F,N,Y,0,297000.0,Commercial associate,Secondary / secondary special,Single / not married,Rented apartment,-15519,-3234,1,0,0,0,Laborers,1.0,-22,C
1415,5008895,F,N,Y,0,297000.0,Commercial associate,Secondary / secondary special,Single / not married,Rented apartment,-15519,-3234,1,0,0,0,Laborers,1.0,-23,C
1416,5008895,F,N,Y,0,297000.0,Commercial associate,Secondary / secondary special,Single / not married,Rented apartment,-15519,-3234,1,0,0,0,Laborers,1.0,-24,C
1417,5008895,F,N,Y,0,297000.0,Commercial associate,Secondary / secondary special,Single / not married,Rented apartment,-15519,-3234,1,0,0,0,Laborers,1.0,-25,C
1418,5008895,F,N,Y,0,297000.0,Commercial associate,Secondary / secondary special,Single / not married,Rented apartment,-15519,-3234,1,0,0,0,Laborers,1.0,-26,C
1419,5008895,F,N,Y,0,297000.0,Commercial associate,Secondary / secondary special,Single / not married,Rented apartment,-15519,-3234,1,0,0,0,Laborers,1.0,-27,C
1420,5008895,F,N,Y,0,297000.0,Commercial associate,Secondary / secondary special,Single / not married,Rented apartment,-15519,-3234,1,0,0,0,Laborers,1.0,-28,C
1421,5008895,F,N,Y,0,297000.0,Commercial associate,Secondary / secondary special,Single / not married,Rented apartment,-15519,-3234,1,0,0,0,Laborers,1.0,-29,C
1422,5008895,F,N,Y,0,297000.0,Commercial associate,Secondary / secondary special,Single / not married,Rented apartment,-15519,-3234,1,0,0,0,Laborers,1.0,-30,C
1423,5008895,F,N,Y,0,297000.0,Commercial associate,Secondary / secondary special,Single / not married,Rented apartment,-15519,-3234,1,0,0,0,Laborers,1.0,-31,C
1424,5008895,F,N,Y,0,297000.0,Commercial associate,Secondary / secondary special,Single / not married,Rented apartment,-15519,-3234,1,0,0,0,Laborers,1.0,-32,C
1425,5008895,F,N,Y,0,297000.0,Commercial associate,Secondary / secondary special,Single / not married,Rented apartment,-15519,-3234,1,0,0,0,Laborers,1.0,-33,C
1426,5008895,F,N,Y,0,297000.0,Commercial associate,Secondary / secondary special,Single / not married,Rented apartment,-15519,-3234,1,0,0,0,Laborers,1.0,-34,C
1427,5008896,F,N,Y,0,297000.0,Commercial associate,Secondary / secondary special,Single / not married,Rented apartment,-15519,-3234,1,0,0,0,Laborers,1.0,-19,C
1428,5008896,F,N,Y,0,297000.0,Commercial associate,Secondary / secondary special,Single / not married,Rented apartment,-15519,-3234,1,0,0,0,Laborers,1.0,-20,C
1429,5008896,F,N,Y,0,297000.0,Commercial associate,Secondary / secondary special,Single / not married,Rented apartment,-15519,-3234,1,0,0,0,Laborers,1.0,-21,C
1430,5008896,F,N,Y,0,297000.0,Commercial associate,Secondary / secondary special,Single / not married,Rented apartment,-15519,-3234,1,0,0,0,Laborers,1.0,-22,C
1431,5008896,F,N,Y,0,297000.0,Commercial associate,Secondary / secondary special,Single / not married,Rented apartment,-15519,-3234,1,0,0,0,Laborers,1.0,-23,C
1432,5008896,F,N,Y,0,297000.0,Commercial associate,Secondary / secondary special,Single / not married,Rented apartment,-15519,-3234,1,0,0,0,Laborers,1.0,-24,C
1433,5008896,F,N,Y,0,297000.0,Commercial associate,Secondary / secondary special,Single / not married,Rented apartment,-15519,-3234,1,0,0,0,Laborers,1.0,-25,C
1434,5008896,F,N,Y,0,297000.0,Commercial associate,Secondary / secondary special,Single / not married,Rented apartment,-15519,-3234,1,0,0,0,Laborers,1.0,-26,C
1435,5008896,F,N,Y,0,297000.0,Commercial associate,Secondary / secondary special,Single / not married,Rented apartment,-15519,-3234,1,0,0,0,Laborers,1.0,-27,C
1436,5008896,F,N,Y,0,297000.0,Commercial associate,Secondary / secondary special,Single / not married,Rented apartment,-15519,-3234,1,0,0,0,Laborers,1.0,-28,C
1437,5008896,F,N,Y,0,297000.0,Commercial associate,Secondary / secondary special,Single / not married,Rented apartment,-15519,-3234,1,0,0,0,Laborers,1.0,-29,C
1438,5008896,F,N,Y,0,297000.0,Commercial associate,Secondary / secondary special,Single / not married,Rented apartment,-15519,-3234,1,0,0,0,Laborers,1.0,-30,C
1439,5008896,F,N,Y,0,297000.0,Commercial associate,Secondary / secondary special,Single / not married,Rented apartment,-15519,-3234,1,0,0,0,Laborers,1.0,-31,C
1440,5008896,F,N,Y,0,297000.0,Commercial associate,Secondary / secondary special,Single / not married,Rented apartment,-15519,-3234,1,0,0,0,Laborers,1.0,-32,C
1441,5008896,F,N,Y,0,297000.0,Commercial associate,Secondary / secondary special,Single / not married,Rented apartment,-15519,-3234,1,0,0,0,Laborers,1.0,-33,C
1442,5008896,F,N,Y,0,297000.0,Commercial associate,Secondary / secondary special,Single / not married,Rented apartment,-15519,-3234,1,0,0,0,Laborers,1.0,-34,0
1443,5008897,F,N,Y,0,297000.0,Commercial associate,Secondary / secondary special,Single / not married,Rented apartment,-15519,-3234,1,0,0,0,Laborers,1.0,-17,C
1444,5008897,F,N,Y,0,297000.0,Commercial associate,Secondary / secondary special,Single / not married,Rented apartment,-15519,-3234,1,0,0,0,Laborers,1.0,-18,C
1445,5008897,F,N,Y,0,297000.0,Commercial associate,Secondary / secondary special,Single / not married,Rented apartment,-15519,-3234,1,0,0,0,Laborers,1.0,-19,C
1446,5008897,F,N,Y,0,297000.0,Commercial associate,Secondary / secondary special,Single / not married,Rented apartment,-15519,-3234,1,0,0,0,Laborers,1.0,-20,C
1447,5008897,F,N,Y,0,297000.0,Commercial associate,Secondary / secondary special,Single / not married,Rented apartment,-15519,-3234,1,0,0,0,Laborers,1.0,-21,C
1448,5008897,F,N,Y,0,297000.0,Commercial associate,Secondary / secondary special,Single / not married,Rented apartment,-15519,-3234,1,0,0,0,Laborers,1.0,-22,C
1449,5008897,F,N,Y,0,297000.0,Commercial associate,Secondary / secondary special,Single / not married,Rented apartment,-15519,-3234,1,0,0,0,Laborers,1.0,-23,C
1450,5008897,F,N,Y,0,297000.0,Commercial associate,Secondary / secondary special,Single / not married,Rented apartment,-15519,-3234,1,0,0,0,Laborers,1.0,-24,C
1451,5008897,F,N,Y,0,297000.0,Commercial associate,Secondary / secondary special,Single / not married,Rented apartment,-15519,-3234,1,0,0,0,Laborers,1.0,-25,C
1452,5008897,F,N,Y,0,297000.0,Commercial associate,Secondary / secondary special,Single / not married,Rented apartment,-15519,-3234,1,0,0,0,Laborers,1.0,-26,C
1453,5008897,F,N,Y,0,297000.0,Commercial associate,Secondary / secondary special,Single / not married,Rented apartment,-15519,-3234,1,0,0,0,Laborers,1.0,-27,C
1454,5008897,F,N,Y,0,297000.0,Commercial associate,Secondary / secondary special,Single / not married,Rented apartment,-15519,-3234,1,0,0,0,Laborers,1.0,-28,C
1455,5008897,F,N,Y,0,297000.0,Commercial associate,Secondary / secondary special,Single / not married,Rented apartment,-15519,-3234,1,0,0,0,Laborers,1.0,-29,C
1456,5008897,F,N,Y,0,297000.0,Commercial associate,Secondary / secondary special,Single / not married,Rented apartment,-15519,-3234,1,0,0,0,Laborers,1.0,-30,C
1457,5008897,F,N,Y,0,297000.0,Commercial associate,Secondary / secondary special,Single / not married,Rented apartment,-15519,-3234,1,0,0,0,Laborers,1.0,-31,C
1458,5008897,F,N,Y,0,297000.0,Commercial associate,Secondary / secondary special,Single / not married,Rented apartment,-15519,-3234,1,0,0,0,Laborers,1.0,-32,0
1459,5008898,F,N,Y,0,297000.0,Commercial associate,Secondary / secondary special,Single / not married,Rented apartment,-15519,-3234,1,0,0,0,Laborers,1.0,-11,C
1460,5008898,F,N,Y,0,297000.0,Commercial associate,Secondary / secondary special,Single / not married,Rented apartment,-15519,-3234,1,0,0,0,Laborers,1.0,-12,C
1461,5008898,F,N,Y,0,297000.0,Commercial associate,Secondary / secondary special,Single / not married,Rented apartment,-15519,-3234,1,0,0,0,Laborers,1.0,-13,C
1462,5008898,F,N,Y,0,297000.0,Commercial associate,Secondary / secondary special,Single / not married,Rented apartment,-15519,-3234,1,0,0,0,Laborers,1.0,-14,C
1463,5008898,F,N,Y,0,297000.0,Commercial associate,Secondary / secondary special,Single / not married,Rented apartment,-15519,-3234,1,0,0,0,Laborers,1.0,-15,C
1464,5008898,F,N,Y,0,297000.0,Commercial associate,Secondary / secondary special,Single / not married,Rented apartment,-15519,-3234,1,0,0,0,Laborers,1.0,-16,C
1465,5008898,F,N,Y,0,297000.0,Commercial associate,Secondary / secondary special,Single / not married,Rented apartment,-15519,-3234,1,0,0,0,Laborers,1.0,-17,C
1466,5008898,F,N,Y,0,297000.0,Commercial associate,Secondary / secondary special,Single / not married,Rented apartment,-15519,-3234,1,0,0,0,Laborers,1.0,-18,C
1467,5008898,F,N,Y,0,297000.0,Commercial associate,Secondary / secondary special,Single / not married,Rented apartment,-15519,-3234,1,0,0,0,Laborers,1.0,-19,C
1468,5008898,F,N,Y,0,297000.0,Commercial associate,Secondary / secondary special,Single / not married,Rented apartment,-15519,-3234,1,0,0,0,Laborers,1.0,-20,C
1469,5008898,F,N,Y,0,297000.0,Commercial associate,Secondary / secondary special,Single / not married,Rented apartment,-15519,-3234,1,0,0,0,Laborers,1.0,-21,C
1470,5008898,F,N,Y,0,297000.0,Commercial associate,Secondary / secondary special,Single / not married,Rented apartment,-15519,-3234,1,0,0,0,Laborers,1.0,-22,C
1471,5008898,F,N,Y,0,297000.0,Commercial associate,Secondary / secondary special,Single / not married,Rented apartment,-15519,-3234,1,0,0,0,Laborers,1.0,-23,C
1472,5008898,F,N,Y,0,297000.0,Commercial associate,Secondary / secondary special,Single / not married,Rented apartment,-15519,-3234,1,0,0,0,Laborers,1.0,-24,C
1473,5008898,F,N,Y,0,297000.0,Commercial associate,Secondary / secondary special,Single / not married,Rented apartment,-15519,-3234,1,0,0,0,Laborers,1.0,-25,C
1474,5008898,F,N,Y,0,297000.0,Commercial associate,Secondary / secondary special,Single / not married,Rented apartment,-15519,-3234,1,0,0,0,Laborers,1.0,-26,C
1475,5008898,F,N,Y,0,297000.0,Commercial associate,Secondary / secondary special,Single / not married,Rented apartment,-15519,-3234,1,0,0,0,Laborers,1.0,-27,C
1476,5008898,F,N,Y,0,297000.0,Commercial associate,Secondary / secondary special,Single / not married,Rented apartment,-15519,-3234,1,0,0,0,Laborers,1.0,-28,C
1477,5008898,F,N,Y,0,297000.0,Commercial associate,Secondary / secondary special,Single / not married,Rented apartment,-15519,-3234,1,0,0,0,Laborers,1.0,-29,C
1478,5008898,F,N,Y,0,297000.0,Commercial associate,Secondary / secondary special,Single / not married,Rented apartment,-15519,-3234,1,0,0,0,Laborers,1.0,-30,C
1479,5008898,F,N,Y,0,297000.0,Commercial associate,Secondary / secondary special,Single / not married,Rented apartment,-15519,-3234,1,0,0,0,Laborers,1.0,-31,C
1480,5008899,F,N,Y,0,297000.0,Commercial associate,Secondary / secondary special,Single / not married,Rented apartment,-15519,-3234,1,0,0,0,Laborers,1.0,-15,C
1481,5008899,F,N,Y,0,297000.0,Commercial associate,Secondary / secondary special,Single / not married,Rented apartment,-15519,-3234,1,0,0,0,Laborers,1.0,-16,C
1482,5008899,F,N,Y,0,297000.0,Commercial associate,Secondary / secondary special,Single / not married,Rented apartment,-15519,-3234,1,0,0,0,Laborers,1.0,-17,C
1483,5008899,F,N,Y,0,297000.0,Commercial associate,Secondary / secondary special,Single / not married,Rented apartment,-15519,-3234,1,0,0,0,Laborers,1.0,-18,C
1484,5008899,F,N,Y,0,297000.0,Commercial associate,Secondary / secondary special,Single / not married,Rented apartment,-15519,-3234,1,0,0,0,Laborers,1.0,-19,C
1485,5008899,F,N,Y,0,297000.0,Commercial associate,Secondary / secondary special,Single / not married,Rented apartment,-15519,-3234,1,0,0,0,Laborers,1.0,-20,C
1486,5008899,F,N,Y,0,297000.0,Commercial associate,Secondary / secondary special,Single / not married,Rented apartment,-15519,-3234,1,0,0,0,Laborers,1.0,-21,C
1487,5008899,F,N,Y,0,297000.0,Commercial associate,Secondary / secondary special,Single / not married,Rented apartment,-15519,-3234,1,0,0,0,Laborers,1.0,-22,C
1488,5008899,F,N,Y,0,297000.0,Commercial associate,Secondary / secondary special,Single / not married,Rented apartment,-15519,-3234,1,0,0,0,Laborers,1.0,-23,C
1489,5008899,F,N,Y,0,297000.0,Commercial associate,Secondary / secondary special,Single / not married,Rented apartment,-15519,-3234,1,0,0,0,Laborers,1.0,-24,C
1490,5008899,F,N,Y,0,297000.0,Commercial associate,Secondary / secondary special,Single / not married,Rented apartment,-15519,-3234,1,0,0,0,Laborers,1.0,-25,C
1491,5008899,F,N,Y,0,297000.0,Commercial associate,Secondary / secondary special,Single / not married,Rented apartment,-15519,-3234,1,0,0,0,Laborers,1.0,-26,C
1492,5008899,F,N,Y,0,297000.0,Commercial associate,Secondary / secondary special,Single / not married,Rented apartment,-15519,-3234,1,0,0,0,Laborers,1.0,-27,C
1493,5008899,F,N,Y,0,297000.0,Commercial associate,Secondary / secondary special,Single / not married,Rented apartment,-15519,-3234,1,0,0,0,Laborers,1.0,-28,C
1494,5008899,F,N,Y,0,297000.0,Commercial associate,Secondary / secondary special,Single / not married,Rented apartment,-15519,-3234,1,0,0,0,Laborers,1.0,-29,C
1495,5008899,F,N,Y,0,297000.0,Commercial associate,Secondary / secondary special,Single / not married,Rented apartment,-15519,-3234,1,0,0,0,Laborers,1.0,-30,0
1496,5008900,F,N,Y,0,297000.0,Commercial associate,Secondary / secondary special,Single / not married,Rented apartment,-15519,-3234,1,0,0,0,Laborers,1.0,-9,C
1497,5008900,F,N,Y,0,297000.0,Commercial associate,Secondary / secondary special,Single / not married,Rented apartment,-15519,-3234,1,0,0,0,Laborers,1.0,-10,C
1498,5008900,F,N,Y,0,297000.0,Commercial associate,Secondary / secondary special,Single / not married,Rented apartment,-15519,-3234,1,0,0,0,Laborers,1.0,-11,C
1499,5008900,F,N,Y,0,297000.0,Commercial associate,Secondary / secondary special,Single / not married,Rented apartment,-15519,-3234,1,0,0,0,Laborers,1.0,-12,C
1500,5008900,F,N,Y,0,297000.0,Commercial associate,Secondary / secondary special,Single / not married,Rented apartment,-15519,-3234,1,0,0,0,Laborers,1.0,-13,C
1501,5008900,F,N,Y,0,297000.0,Commercial associate,Secondary / secondary special,Single / not married,Rented apartment,-15519,-3234,1,0,0,0,Laborers,1.0,-14,C
1502,5008900,F,N,Y,0,297000.0,Commercial associate,Secondary / secondary special,Single / not married,Rented apartment,-15519,-3234,1,0,0,0,Laborers,1.0,-15,C
1503,5008900,F,N,Y,0,297000.0,Commercial associate,Secondary / secondary special,Single / not married,Rented apartment,-15519,-3234,1,0,0,0,Laborers,1.0,-16,C
1504,5008900,F,N,Y,0,297000.0,Commercial associate,Secondary / secondary special,Single / not married,Rented apartment,-15519,-3234,1,0,0,0,Laborers,1.0,-17,C
1505,5008900,F,N,Y,0,297000.0,Commercial associate,Secondary / secondary special,Single / not married,Rented apartment,-15519,-3234,1,0,0,0,Laborers,1.0,-18,C
1506,5008900,F,N,Y,0,297000.0,Commercial associate,Secondary / secondary special,Single / not married,Rented apartment,-15519,-3234,1,0,0,0,Laborers,1.0,-19,C
1507,5008900,F,N,Y,0,297000.0,Commercial associate,Secondary / secondary special,Single / not married,Rented apartment,-15519,-3234,1,0,0,0,Laborers,1.0,-20,C
1508,5008900,F,N,Y,0,297000.0,Commercial associate,Secondary / secondary special,Single / not married,Rented apartment,-15519,-3234,1,0,0,0,Laborers,1.0,-21,C
1509,5008900,F,N,Y,0,297000.0,Commercial associate,Secondary / secondary special,Single / not married,Rented apartment,-15519,-3234,1,0,0,0,Laborers,1.0,-22,C
1510,5008900,F,N,Y,0,297000.0,Commercial associate,Secondary / secondary special,Single / not married,Rented apartment,-15519,-3234,1,0,0,0,Laborers,1.0,-23,C
1511,5008900,F,N,Y,0,297000.0,Commercial associate,Secondary / secondary special,Single / not married,Rented apartment,-15519,-3234,1,0,0,0,Laborers,1.0,-24,C
1512,5008900,F,N,Y,0,297000.0,Commercial associate,Secondary / secondary special,Single / not married,Rented apartment,-15519,-3234,1,0,0,0,Laborers,1.0,-25,C
1513,5008900,F,N,Y,0,297000.0,Commercial associate,Secondary / secondary special,Single / not married,Rented apartment,-15519,-3234,1,0,0,0,Laborers,1.0,-26,C
1514,5008900,F,N,Y,0,297000.0,Commercial associate,Secondary / secondary special,Single / not married,Rented apartment,-15519,-3234,1,0,0,0,Laborers,1.0,-27,C
1515,5008900,F,N,Y,0,297000.0,Commercial associate,Secondary / secondary special,Single / not married,Rented apartment,-15519,-3234,1,0,0,0,Laborers,1.0,-28,C
1516,5008900,F,N,Y,0,297000.0,Commercial associate,Secondary / secondary special,Single / not married,Rented apartment,-15519,-3234,1,0,0,0,Laborers,1.0,-29,C
1517,5008901,F,N,Y,0,297000.0,Commercial associate,Secondary / secondary special,Single / not married,Rented apartment,-15519,-3234,1,0,0,0,Laborers,1.0,-12,C
1518,5008901,F,N,Y,0,297000.0,Commercial associate,Secondary / secondary special,Single / not married,Rented apartment,-15519,-3234,1,0,0,0,Laborers,1.0,-13,C
1519,5008901,F,N,Y,0,297000.0,Commercial associate,Secondary / secondary special,Single / not married,Rented apartment,-15519,-3234,1,0,0,0,Laborers,1.0,-14,C
1520,5008901,F,N,Y,0,297000.0,Commercial associate,Secondary / secondary special,Single / not married,Rented apartment,-15519,-3234,1,0,0,0,Laborers,1.0,-15,C
1521,5008901,F,N,Y,0,297000.0,Commercial associate,Secondary / secondary special,Single / not married,Rented apartment,-15519,-3234,1,0,0,0,Laborers,1.0,-16,C
1522,5008901,F,N,Y,0,297000.0,Commercial associate,Secondary / secondary special,Single / not married,Rented apartment,-15519,-3234,1,0,0,0,Laborers,1.0,-17,C
1523,5008901,F,N,Y,0,297000.0,Commercial associate,Secondary / secondary special,Single / not married,Rented apartment,-15519,-3234,1,0,0,0,Laborers,1.0,-18,C
1524,5008901,F,N,Y,0,297000.0,Commercial associate,Secondary / secondary special,Single / not married,Rented apartment,-15519,-3234,1,0,0,0,Laborers,1.0,-19,C
1525,5008901,F,N,Y,0,297000.0,Commercial associate,Secondary / secondary special,Single / not married,Rented apartment,-15519,-3234,1,0,0,0,Laborers,1.0,-20,C
1526,5008901,F,N,Y,0,297000.0,Commercial associate,Secondary / secondary special,Single / not married,Rented apartment,-15519,-3234,1,0,0,0,Laborers,1.0,-21,C
1527,5008901,F,N,Y,0,297000.0,Commercial associate,Secondary / secondary special,Single / not married,Rented apartment,-15519,-3234,1,0,0,0,Laborers,1.0,-22,C
1528,5008901,F,N,Y,0,297000.0,Commercial associate,Secondary / secondary special,Single / not married,Rented apartment,-15519,-3234,1,0,0,0,Laborers,1.0,-23,C
1529,5008901,F,N,Y,0,297000.0,Commercial associate,Secondary / secondary special,Single / not married,Rented apartment,-15519,-3234,1,0,0,0,Laborers,1.0,-24,C
1530,5008901,F,N,Y,0,297000.0,Commercial associate,Secondary / secondary special,Single / not married,Rented apartment,-15519,-3234,1,0,0,0,Laborers,1.0,-25,C
1531,5008901,F,N,Y,0,297000.0,Commercial associate,Secondary / secondary special,Single / not married,Rented apartment,-15519,-3234,1,0,0,0,Laborers,1.0,-26,C
1532,5008901,F,N,Y,0,297000.0,Commercial associate,Secondary / secondary special,Single / not married,Rented apartment,-15519,-3234,1,0,0,0,Laborers,1.0,-27,0
1533,5008902,F,N,Y,0,297000.0,Commercial associate,Secondary / secondary special,Single / not married,Rented apartment,-15519,-3234,1,0,0,0,Laborers,1.0,-7,C
1534,5008902,F,N,Y,0,297000.0,Commercial associate,Secondary / secondary special,Single / not married,Rented apartment,-15519,-3234,1,0,0,0,Laborers,1.0,-8,C
1535,5008902,F,N,Y,0,297000.0,Commercial associate,Secondary / secondary special,Single / not married,Rented apartment,-15519,-3234,1,0,0,0,Laborers,1.0,-9,C
1536,5008902,F,N,Y,0,297000.0,Commercial associate,Secondary / secondary special,Single / not married,Rented apartment,-15519,-3234,1,0,0,0,Laborers,1.0,-10,C
1537,5008902,F,N,Y,0,297000.0,Commercial associate,Secondary / secondary special,Single / not married,Rented apartment,-15519,-3234,1,0,0,0,Laborers,1.0,-11,C
1538,5008902,F,N,Y,0,297000.0,Commercial associate,Secondary / secondary special,Single / not married,Rented apartment,-15519,-3234,1,0,0,0,Laborers,1.0,-12,C
1539,5008902,F,N,Y,0,297000.0,Commercial associate,Secondary / secondary special,Single / not married,Rented apartment,-15519,-3234,1,0,0,0,Laborers,1.0,-13,C
1540,5008902,F,N,Y,0,297000.0,Commercial associate,Secondary / secondary special,Single / not married,Rented apartment,-15519,-3234,1,0,0,0,Laborers,1.0,-14,C
1541,5008902,F,N,Y,0,297000.0,Commercial associate,Secondary / secondary special,Single / not married,Rented apartment,-15519,-3234,1,0,0,0,Laborers,1.0,-15,C
1542,5008902,F,N,Y,0,297000.0,Commercial associate,Secondary / secondary special,Single / not married,Rented apartment,-15519,-3234,1,0,0,0,Laborers,1.0,-16,0
1543,5008902,F,N,Y,0,297000.0,Commercial associate,Secondary / secondary special,Single / not married,Rented apartment,-15519,-3234,1,0,0,0,Laborers,1.0,-17,0
1544,5008902,F,N,Y,0,297000.0,Commercial associate,Secondary / secondary special,Single / not married,Rented apartment,-15519,-3234,1,0,0,0,Laborers,1.0,-18,1
1545,5008902,F,N,Y,0,297000.0,Commercial associate,Secondary / secondary special,Single / not married,Rented apartment,-15519,-3234,1,0,0,0,Laborers,1.0,-19,0
1546,5008902,F,N,Y,0,297000.0,Commercial associate,Secondary / secondary special,Single / not married,Rented apartment,-15519,-3234,1,0,0,0,Laborers,1.0,-20,0
1547,5008902,F,N,Y,0,297000.0,Commercial associate,Secondary / secondary special,Single / not married,Rented apartment,-15519,-3234,1,0,0,0,Laborers,1.0,-21,0
1548,5008902,F,N,Y,0,297000.0,Commercial associate,Secondary / secondary special,Single / not married,Rented apartment,-15519,-3234,1,0,0,0,Laborers,1.0,-22,0
1549,5008902,F,N,Y,0,297000.0,Commercial associate,Secondary / secondary special,Single / not married,Rented apartment,-15519,-3234,1,0,0,0,Laborers,1.0,-23,0
1550,5008902,F,N,Y,0,297000.0,Commercial associate,Secondary / secondary special,Single / not married,Rented apartment,-15519,-3234,1,0,0,0,Laborers,1.0,-24,0
1551,5008902,F,N,Y,0,297000.0,Commercial associate,Secondary / secondary special,Single / not married,Rented apartment,-15519,-3234,1,0,0,0,Laborers,1.0,-25,0
1552,5008902,F,N,Y,0,297000.0,Commercial associate,Secondary / secondary special,Single / not married,Rented apartment,-15519,-3234,1,0,0,0,Laborers,1.0,-26,0
1553,5008902,F,N,Y,0,297000.0,Commercial associate,Secondary / secondary special,Single / not married,Rented apartment,-15519,-3234,1,0,0,0,Laborers,1.0,-27,X
1554,5008903,F,N,Y,0,297000.0,Commercial associate,Secondary / secondary special,Single / not married,Rented apartment,-15519,-3234,1,0,0,0,Laborers,1.0,-12,C
1555,5008903,F,N,Y,0,297000.0,Commercial associate,Secondary / secondary special,Single / not married,Rented apartment,-15519,-3234,1,0,0,0,Laborers,1.0,-13,C
1556,5008903,F,N,Y,0,297000.0,Commercial associate,Secondary / secondary special,Single / not married,Rented apartment,-15519,-3234,1,0,0,0,Laborers,1.0,-14,C
1557,5008903,F,N,Y,0,297000.0,Commercial associate,Secondary / secondary special,Single / not married,Rented apartment,-15519,-3234,1,0,0,0,Laborers,1.0,-15,C
1558,5008903,F,N,Y,0,297000.0,Commercial associate,Secondary / secondary special,Single / not married,Rented apartment,-15519,-3234,1,0,0,0,Laborers,1.0,-16,C
1559,5008903,F,N,Y,0,297000.0,Commercial associate,Secondary / secondary special,Single / not married,Rented apartment,-15519,-3234,1,0,0,0,Laborers,1.0,-17,C
1560,5008903,F,N,Y,0,297000.0,Commercial associate,Secondary / secondary special,Single / not married,Rented apartment,-15519,-3234,1,0,0,0,Laborers,1.0,-18,C
1561,5008903,F,N,Y,0,297000.0,Commercial associate,Secondary / secondary special,Single / not married,Rented apartment,-15519,-3234,1,0,0,0,Laborers,1.0,-19,C
1562,5008903,F,N,Y,0,297000.0,Commercial associate,Secondary / secondary special,Single / not married,Rented apartment,-15519,-3234,1,0,0,0,Laborers,1.0,-20,C
1563,5008903,F,N,Y,0,297000.0,Commercial associate,Secondary / secondary special,Single / not married,Rented apartment,-15519,-3234,1,0,0,0,Laborers,1.0,-21,C
1564,5008903,F,N,Y,0,297000.0,Commercial associate,Secondary / secondary special,Single / not married,Rented apartment,-15519,-3234,1,0,0,0,Laborers,1.0,-22,C
1565,5008903,F,N,Y,0,297000.0,Commercial associate,Secondary / secondary special,Single / not married,Rented apartment,-15519,-3234,1,0,0,0,Laborers,1.0,-23,C
1566,5008903,F,N,Y,0,297000.0,Commercial associate,Secondary / secondary special,Single / not married,Rented apartment,-15519,-3234,1,0,0,0,Laborers,1.0,-24,C
1567,5008903,F,N,Y,0,297000.0,Commercial associate,Secondary / secondary special,Single / not married,Rented apartment,-15519,-3234,1,0,0,0,Laborers,1.0,-25,C
1568,5008903,F,N,Y,0,297000.0,Commercial associate,Secondary / secondary special,Single / not married,Rented apartment,-15519,-3234,1,0,0,0,Laborers,1.0,-26,C
1569,5008903,F,N,Y,0,297000.0,Commercial associate,Secondary / secondary special,Single / not married,Rented apartment,-15519,-3234,1,0,0,0,Laborers,1.0,-27,0
1570,5008904,F,N,Y,0,297000.0,Commercial associate,Secondary / secondary special,Single / not married,Rented apartment,-15519,-3234,1,0,0,0,Laborers,1.0,-6,C
1571,5008904,F,N,Y,0,297000.0,Commercial associate,Secondary / secondary special,Single / not married,Rented apartment,-15519,-3234,1,0,0,0,Laborers,1.0,-7,C
1572,5008904,F,N,Y,0,297000.0,Commercial associate,Secondary / secondary special,Single / not married,Rented apartment,-15519,-3234,1,0,0,0,Laborers,1.0,-8,C
1573,5008904,F,N,Y,0,297000.0,Commercial associate,Secondary / secondary special,Single / not married,Rented apartment,-15519,-3234,1,0,0,0,Laborers,1.0,-9,C
1574,5008904,F,N,Y,0,297000.0,Commercial associate,Secondary / secondary special,Single / not married,Rented apartment,-15519,-3234,1,0,0,0,Laborers,1.0,-10,C
1575,5008904,F,N,Y,0,297000.0,Commercial associate,Secondary / secondary special,Single / not married,Rented apartment,-15519,-3234,1,0,0,0,Laborers,1.0,-11,C
1576,5008904,F,N,Y,0,297000.0,Commercial associate,Secondary / secondary special,Single / not married,Rented apartment,-15519,-3234,1,0,0,0,Laborers,1.0,-12,C
1577,5008904,F,N,Y,0,297000.0,Commercial associate,Secondary / secondary special,Single / not married,Rented apartment,-15519,-3234,1,0,0,0,Laborers,1.0,-13,C
1578,5008904,F,N,Y,0,297000.0,Commercial associate,Secondary / secondary special,Single / not married,Rented apartment,-15519,-3234,1,0,0,0,Laborers,1.0,-14,C
1579,5008904,F,N,Y,0,297000.0,Commercial associate,Secondary / secondary special,Single / not married,Rented apartment,-15519,-3234,1,0,0,0,Laborers,1.0,-15,0
1580,5008904,F,N,Y,0,297000.0,Commercial associate,Secondary / secondary special,Single / not married,Rented apartment,-15519,-3234,1,0,0,0,Laborers,1.0,-16,0
1581,5008904,F,N,Y,0,297000.0,Commercial associate,Secondary / secondary special,Single / not married,Rented apartment,-15519,-3234,1,0,0,0,Laborers,1.0,-17,1
1582,5008904,F,N,Y,0,297000.0,Commercial associate,Secondary / secondary special,Single / not married,Rented apartment,-15519,-3234,1,0,0,0,Laborers,1.0,-18,0
1583,5008904,F,N,Y,0,297000.0,Commercial associate,Secondary / secondary special,Single / not married,Rented apartment,-15519,-3234,1,0,0,0,Laborers,1.0,-19,0
1584,5008904,F,N,Y,0,297000.0,Commercial associate,Secondary / secondary special,Single / not married,Rented apartment,-15519,-3234,1,0,0,0,Laborers,1.0,-20,0
1585,5008904,F,N,Y,0,297000.0,Commercial associate,Secondary / secondary special,Single / not married,Rented apartment,-15519,-3234,1,0,0,0,Laborers,1.0,-21,0
1586,5008904,F,N,Y,0,297000.0,Commercial associate,Secondary / secondary special,Single / not married,Rented apartment,-15519,-3234,1,0,0,0,Laborers,1.0,-22,0
1587,5008904,F,N,Y,0,297000.0,Commercial associate,Secondary / secondary special,Single / not married,Rented apartment,-15519,-3234,1,0,0,0,Laborers,1.0,-23,0
1588,5008904,F,N,Y,0,297000.0,Commercial associate,Secondary / secondary special,Single / not married,Rented apartment,-15519,-3234,1,0,0,0,Laborers,1.0,-24,0
1589,5008904,F,N,Y,0,297000.0,Commercial associate,Secondary / secondary special,Single / not married,Rented apartment,-15519,-3234,1,0,0,0,Laborers,1.0,-25,0
1590,5008904,F,N,Y,0,297000.0,Commercial associate,Secondary / secondary special,Single / not married,Rented apartment,-15519,-3234,1,0,0,0,Laborers,1.0,-26,X
1591,5008905,F,N,Y,0,297000.0,Commercial associate,Secondary / secondary special,Single / not married,Rented apartment,-15519,-3234,1,0,0,0,Laborers,1.0,-10,C
1592,5008905,F,N,Y,0,297000.0,Commercial associate,Secondary / secondary special,Single / not married,Rented apartment,-15519,-3234,1,0,0,0,Laborers,1.0,-11,C
1593,5008905,F,N,Y,0,297000.0,Commercial associate,Secondary / secondary special,Single / not married,Rented apartment,-15519,-3234,1,0,0,0,Laborers,1.0,-12,C
1594,5008905,F,N,Y,0,297000.0,Commercial associate,Secondary / secondary special,Single / not married,Rented apartment,-15519,-3234,1,0,0,0,Laborers,1.0,-13,C
1595,5008905,F,N,Y,0,297000.0,Commercial associate,Secondary / secondary special,Single / not married,Rented apartment,-15519,-3234,1,0,0,0,Laborers,1.0,-14,C
1596,5008905,F,N,Y,0,297000.0,Commercial associate,Secondary / secondary special,Single / not married,Rented apartment,-15519,-3234,1,0,0,0,Laborers,1.0,-15,C
1597,5008905,F,N,Y,0,297000.0,Commercial associate,Secondary / secondary special,Single / not married,Rented apartment,-15519,-3234,1,0,0,0,Laborers,1.0,-16,C
1598,5008905,F,N,Y,0,297000.0,Commercial associate,Secondary / secondary special,Single / not married,Rented apartment,-15519,-3234,1,0,0,0,Laborers,1.0,-17,C
1599,5008905,F,N,Y,0,297000.0,Commercial associate,Secondary / secondary special,Single / not married,Rented apartment,-15519,-3234,1,0,0,0,Laborers,1.0,-18,C
1600,5008905,F,N,Y,0,297000.0,Commercial associate,Secondary / secondary special,Single / not married,Rented apartment,-15519,-3234,1,0,0,0,Laborers,1.0,-19,C
1601,5008905,F,N,Y,0,297000.0,Commercial associate,Secondary / secondary special,Single / not married,Rented apartment,-15519,-3234,1,0,0,0,Laborers,1.0,-20,C
1602,5008905,F,N,Y,0,297000.0,Commercial associate,Secondary / secondary special,Single / not married,Rented apartment,-15519,-3234,1,0,0,0,Laborers,1.0,-21,C
1603,5008905,F,N,Y,0,297000.0,Commercial associate,Secondary / secondary special,Single / not married,Rented apartment,-15519,-3234,1,0,0,0,Laborers,1.0,-22,C
1604,5008905,F,N,Y,0,297000.0,Commercial associate,Secondary / secondary special,Single / not married,Rented apartment,-15519,-3234,1,0,0,0,Laborers,1.0,-23,C
1605,5008905,F,N,Y,0,297000.0,Commercial associate,Secondary / secondary special,Single / not married,Rented apartment,-15519,-3234,1,0,0,0,Laborers,1.0,-24,C
1606,5008905,F,N,Y,0,297000.0,Commercial associate,Secondary / secondary special,Single / not married,Rented apartment,-15519,-3234,1,0,0,0,Laborers,1.0,-25,0
1607,5008906,F,N,Y,0,297000.0,Commercial associate,Secondary / secondary special,Single / not married,Rented apartment,-15519,-3234,1,0,0,0,Laborers,1.0,-4,C
1608,5008906,F,N,Y,0,297000.0,Commercial associate,Secondary / secondary special,Single / not married,Rented apartment,-15519,-3234,1,0,0,0,Laborers,1.0,-5,C
1609,5008906,F,N,Y,0,297000.0,Commercial associate,Secondary / secondary special,Single / not married,Rented apartment,-15519,-3234,1,0,0,0,Laborers,1.0,-6,C
1610,5008906,F,N,Y,0,297000.0,Commercial associate,Secondary / secondary special,Single / not married,Rented apartment,-15519,-3234,1,0,0,0,Laborers,1.0,-7,C
1611,5008906,F,N,Y,0,297000.0,Commercial associate,Secondary / secondary special,Single / not married,Rented apartment,-15519,-3234,1,0,0,0,Laborers,1.0,-8,C
1612,5008906,F,N,Y,0,297000.0,Commercial associate,Secondary / secondary special,Single / not married,Rented apartment,-15519,-3234,1,0,0,0,Laborers,1.0,-9,C
1613,5008906,F,N,Y,0,297000.0,Commercial associate,Secondary / secondary special,Single / not married,Rented apartment,-15519,-3234,1,0,0,0,Laborers,1.0,-10,C
1614,5008906,F,N,Y,0,297000.0,Commercial associate,Secondary / secondary special,Single / not married,Rented apartment,-15519,-3234,1,0,0,0,Laborers,1.0,-11,C
1615,5008906,F,N,Y,0,297000.0,Commercial associate,Secondary / secondary special,Single / not married,Rented apartment,-15519,-3234,1,0,0,0,Laborers,1.0,-12,C
1616,5008906,F,N,Y,0,297000.0,Commercial associate,Secondary / secondary special,Single / not married,Rented apartment,-15519,-3234,1,0,0,0,Laborers,1.0,-13,0
1617,5008906,F,N,Y,0,297000.0,Commercial associate,Secondary / secondary special,Single / not married,Rented apartment,-15519,-3234,1,0,0,0,Laborers,1.0,-14,0
1618,5008906,F,N,Y,0,297000.0,Commercial associate,Secondary / secondary special,Single / not married,Rented apartment,-15519,-3234,1,0,0,0,Laborers,1.0,-15,1
1619,5008906,F,N,Y,0,297000.0,Commercial associate,Secondary / secondary special,Single / not married,Rented apartment,-15519,-3234,1,0,0,0,Laborers,1.0,-16,0
1620,5008906,F,N,Y,0,297000.0,Commercial associate,Secondary / secondary special,Single / not married,Rented apartment,-15519,-3234,1,0,0,0,Laborers,1.0,-17,0
1621,5008906,F,N,Y,0,297000.0,Commercial associate,Secondary / secondary special,Single / not married,Rented apartment,-15519,-3234,1,0,0,0,Laborers,1.0,-18,0
1622,5008906,F,N,Y,0,297000.0,Commercial associate,Secondary / secondary special,Single / not married,Rented apartment,-15519,-3234,1,0,0,0,Laborers,1.0,-19,0
1623,5008906,F,N,Y,0,297000.0,Commercial associate,Secondary / secondary special,Single / not married,Rented apartment,-15519,-3234,1,0,0,0,Laborers,1.0,-20,0
1624,5008906,F,N,Y,0,297000.0,Commercial associate,Secondary / secondary special,Single / not married,Rented apartment,-15519,-3234,1,0,0,0,Laborers,1.0,-21,0
1625,5008906,F,N,Y,0,297000.0,Commercial associate,Secondary / secondary special,Single / not married,Rented apartment,-15519,-3234,1,0,0,0,Laborers,1.0,-22,0
1626,5008906,F,N,Y,0,297000.0,Commercial associate,Secondary / secondary special,Single / not married,Rented apartment,-15519,-3234,1,0,0,0,Laborers,1.0,-23,0
1627,5008906,F,N,Y,0,297000.0,Commercial associate,Secondary / secondary special,Single / not married,Rented apartment,-15519,-3234,1,0,0,0,Laborers,1.0,-24,X
1628,5008907,F,N,Y,0,297000.0,Commercial associate,Secondary / secondary special,Single / not married,Rented apartment,-15519,-3234,1,0,0,0,Laborers,1.0,-8,C
1629,5008907,F,N,Y,0,297000.0,Commercial associate,Secondary / secondary special,Single / not married,Rented apartment,-15519,-3234,1,0,0,0,Laborers,1.0,-9,C
1630,5008907,F,N,Y,0,297000.0,Commercial associate,Secondary / secondary special,Single / not married,Rented apartment,-15519,-3234,1,0,0,0,Laborers,1.0,-10,C
1631,5008907,F,N,Y,0,297000.0,Commercial associate,Secondary / secondary special,Single / not married,Rented apartment,-15519,-3234,1,0,0,0,Laborers,1.0,-11,C
1632,5008907,F,N,Y,0,297000.0,Commercial associate,Secondary / secondary special,Single / not married,Rented apartment,-15519,-3234,1,0,0,0,Laborers,1.0,-12,C
1633,5008907,F,N,Y,0,297000.0,Commercial associate,Secondary / secondary special,Single / not married,Rented apartment,-15519,-3234,1,0,0,0,Laborers,1.0,-13,C
1634,5008907,F,N,Y,0,297000.0,Commercial associate,Secondary / secondary special,Single / not married,Rented apartment,-15519,-3234,1,0,0,0,Laborers,1.0,-14,C
1635,5008907,F,N,Y,0,297000.0,Commercial associate,Secondary / secondary special,Single / not married,Rented apartment,-15519,-3234,1,0,0,0,Laborers,1.0,-15,C
1636,5008907,F,N,Y,0,297000.0,Commercial associate,Secondary / secondary special,Single / not married,Rented apartment,-15519,-3234,1,0,0,0,Laborers,1.0,-16,C
1637,5008907,F,N,Y,0,297000.0,Commercial associate,Secondary / secondary special,Single / not married,Rented apartment,-15519,-3234,1,0,0,0,Laborers,1.0,-17,C
1638,5008907,F,N,Y,0,297000.0,Commercial associate,Secondary / secondary special,Single / not married,Rented apartment,-15519,-3234,1,0,0,0,Laborers,1.0,-18,C
1639,5008907,F,N,Y,0,297000.0,Commercial associate,Secondary / secondary special,Single / not married,Rented apartment,-15519,-3234,1,0,0,0,Laborers,1.0,-19,C
1640,5008907,F,N,Y,0,297000.0,Commercial associate,Secondary / secondary special,Single / not married,Rented apartment,-15519,-3234,1,0,0,0,Laborers,1.0,-20,C
1641,5008907,F,N,Y,0,297000.0,Commercial associate,Secondary / secondary special,Single / not married,Rented apartment,-15519,-3234,1,0,0,0,Laborers,1.0,-21,C
1642,5008907,F,N,Y,0,297000.0,Commercial associate,Secondary / secondary special,Single / not married,Rented apartment,-15519,-3234,1,0,0,0,Laborers,1.0,-22,C
1643,5008907,F,N,Y,0,297000.0,Commercial associate,Secondary / secondary special,Single / not married,Rented apartment,-15519,-3234,1,0,0,0,Laborers,1.0,-23,0
1644,5008908,F,N,Y,0,297000.0,Commercial associate,Secondary / secondary special,Single / not married,Rented apartment,-15519,-3234,1,0,0,0,Laborers,1.0,-2,C
1645,5008908,F,N,Y,0,297000.0,Commercial associate,Secondary / secondary special,Single / not married,Rented apartment,-15519,-3234,1,0,0,0,Laborers,1.0,-3,C
1646,5008908,F,N,Y,0,297000.0,Commercial associate,Secondary / secondary special,Single / not married,Rented apartment,-15519,-3234,1,0,0,0,Laborers,1.0,-4,C
1647,5008908,F,N,Y,0,297000.0,Commercial associate,Secondary / secondary special,Single / not married,Rented apartment,-15519,-3234,1,0,0,0,Laborers,1.0,-5,C
1648,5008908,F,N,Y,0,297000.0,Commercial associate,Secondary / secondary special,Single / not married,Rented apartment,-15519,-3234,1,0,0,0,Laborers,1.0,-6,C
1649,5008908,F,N,Y,0,297000.0,Commercial associate,Secondary / secondary special,Single / not married,Rented apartment,-15519,-3234,1,0,0,0,Laborers,1.0,-7,C
1650,5008908,F,N,Y,0,297000.0,Commercial associate,Secondary / secondary special,Single / not married,Rented apartment,-15519,-3234,1,0,0,0,Laborers,1.0,-8,C
1651,5008908,F,N,Y,0,297000.0,Commercial associate,Secondary / secondary special,Single / not married,Rented apartment,-15519,-3234,1,0,0,0,Laborers,1.0,-9,C
1652,5008908,F,N,Y,0,297000.0,Commercial associate,Secondary / secondary special,Single / not married,Rented apartment,-15519,-3234,1,0,0,0,Laborers,1.0,-10,C
1653,5008908,F,N,Y,0,297000.0,Commercial associate,Secondary / secondary special,Single / not married,Rented apartment,-15519,-3234,1,0,0,0,Laborers,1.0,-11,0
1654,5008908,F,N,Y,0,297000.0,Commercial associate,Secondary / secondary special,Single / not married,Rented apartment,-15519,-3234,1,0,0,0,Laborers,1.0,-12,0
1655,5008908,F,N,Y,0,297000.0,Commercial associate,Secondary / secondary special,Single / not married,Rented apartment,-15519,-3234,1,0,0,0,Laborers,1.0,-13,1
1656,5008908,F,N,Y,0,297000.0,Commercial associate,Secondary / secondary special,Single / not married,Rented apartment,-15519,-3234,1,0,0,0,Laborers,1.0,-14,0
1657,5008908,F,N,Y,0,297000.0,Commercial associate,Secondary / secondary special,Single / not married,Rented apartment,-15519,-3234,1,0,0,0,Laborers,1.0,-15,0
1658,5008908,F,N,Y,0,297000.0,Commercial associate,Secondary / secondary special,Single / not married,Rented apartment,-15519,-3234,1,0,0,0,Laborers,1.0,-16,0
1659,5008908,F,N,Y,0,297000.0,Commercial associate,Secondary / secondary special,Single / not married,Rented apartment,-15519,-3234,1,0,0,0,Laborers,1.0,-17,0
1660,5008908,F,N,Y,0,297000.0,Commercial associate,Secondary / secondary special,Single / not married,Rented apartment,-15519,-3234,1,0,0,0,Laborers,1.0,-18,0
1661,5008908,F,N,Y,0,297000.0,Commercial associate,Secondary / secondary special,Single / not married,Rented apartment,-15519,-3234,1,0,0,0,Laborers,1.0,-19,0
1662,5008908,F,N,Y,0,297000.0,Commercial associate,Secondary / secondary special,Single / not married,Rented apartment,-15519,-3234,1,0,0,0,Laborers,1.0,-20,0
1663,5008908,F,N,Y,0,297000.0,Commercial associate,Secondary / secondary special,Single / not married,Rented apartment,-15519,-3234,1,0,0,0,Laborers,1.0,-21,0
1664,5008908,F,N,Y,0,297000.0,Commercial associate,Secondary / secondary special,Single / not married,Rented apartment,-15519,-3234,1,0,0,0,Laborers,1.0,-22,X
1665,5008909,F,N,Y,0,297000.0,Commercial associate,Secondary / secondary special,Single / not married,Rented apartment,-15519,-3234,1,0,0,0,Laborers,1.0,-7,C
1666,5008909,F,N,Y,0,297000.0,Commercial associate,Secondary / secondary special,Single / not married,Rented apartment,-15519,-3234,1,0,0,0,Laborers,1.0,-8,C
1667,5008909,F,N,Y,0,297000.0,Commercial associate,Secondary / secondary special,Single / not married,Rented apartment,-15519,-3234,1,0,0,0,Laborers,1.0,-9,C
1668,5008909,F,N,Y,0,297000.0,Commercial associate,Secondary / secondary special,Single / not married,Rented apartment,-15519,-3234,1,0,0,0,Laborers,1.0,-10,C
1669,5008909,F,N,Y,0,297000.0,Commercial associate,Secondary / secondary special,Single / not married,Rented apartment,-15519,-3234,1,0,0,0,Laborers,1.0,-11,C
1670,5008909,F,N,Y,0,297000.0,Commercial associate,Secondary / secondary special,Single / not married,Rented apartment,-15519,-3234,1,0,0,0,Laborers,1.0,-12,C
1671,5008909,F,N,Y,0,297000.0,Commercial associate,Secondary / secondary special,Single / not married,Rented apartment,-15519,-3234,1,0,0,0,Laborers,1.0,-13,C
1672,5008909,F,N,Y,0,297000.0,Commercial associate,Secondary / secondary special,Single / not married,Rented apartment,-15519,-3234,1,0,0,0,Laborers,1.0,-14,C
1673,5008909,F,N,Y,0,297000.0,Commercial associate,Secondary / secondary special,Single / not married,Rented apartment,-15519,-3234,1,0,0,0,Laborers,1.0,-15,C
1674,5008909,F,N,Y,0,297000.0,Commercial associate,Secondary / secondary special,Single / not married,Rented apartment,-15519,-3234,1,0,0,0,Laborers,1.0,-16,C
1675,5008909,F,N,Y,0,297000.0,Commercial associate,Secondary / secondary special,Single / not married,Rented apartment,-15519,-3234,1,0,0,0,Laborers,1.0,-17,C
1676,5008909,F,N,Y,0,297000.0,Commercial associate,Secondary / secondary special,Single / not married,Rented apartment,-15519,-3234,1,0,0,0,Laborers,1.0,-18,C
1677,5008909,F,N,Y,0,297000.0,Commercial associate,Secondary / secondary special,Single / not married,Rented apartment,-15519,-3234,1,0,0,0,Laborers,1.0,-19,C
1678,5008909,F,N,Y,0,297000.0,Commercial associate,Secondary / secondary special,Single / not married,Rented apartment,-15519,-3234,1,0,0,0,Laborers,1.0,-20,C
1679,5008909,F,N,Y,0,297000.0,Commercial associate,Secondary / secondary special,Single / not married,Rented apartment,-15519,-3234,1,0,0,0,Laborers,1.0,-21,C
1680,5008909,F,N,Y,0,297000.0,Commercial associate,Secondary / secondary special,Single / not married,Rented apartment,-15519,-3234,1,0,0,0,Laborers,1.0,-22,0
1681,5008910,F,N,Y,0,297000.0,Commercial associate,Secondary / secondary special,Single / not married,Rented apartment,-15519,-3234,1,0,0,0,Laborers,1.0,-1,C
1682,5008910,F,N,Y,0,297000.0,Commercial associate,Secondary / secondary special,Single / not married,Rented apartment,-15519,-3234,1,0,0,0,Laborers,1.0,-2,C
1683,5008910,F,N,Y,0,297000.0,Commercial associate,Secondary / secondary special,Single / not married,Rented apartment,-15519,-3234,1,0,0,0,Laborers,1.0,-3,C
1684,5008910,F,N,Y,0,297000.0,Commercial associate,Secondary / secondary special,Single / not married,Rented apartment,-15519,-3234,1,0,0,0,Laborers,1.0,-4,C
1685,5008910,F,N,Y,0,297000.0,Commercial associate,Secondary / secondary special,Single / not married,Rented apartment,-15519,-3234,1,0,0,0,Laborers,1.0,-5,C
1686,5008910,F,N,Y,0,297000.0,Commercial associate,Secondary / secondary special,Single / not married,Rented apartment,-15519,-3234,1,0,0,0,Laborers,1.0,-6,C
1687,5008910,F,N,Y,0,297000.0,Commercial associate,Secondary / secondary special,Single / not married,Rented apartment,-15519,-3234,1,0,0,0,Laborers,1.0,-7,C
1688,5008910,F,N,Y,0,297000.0,Commercial associate,Secondary / secondary special,Single / not married,Rented apartment,-15519,-3234,1,0,0,0,Laborers,1.0,-8,C
1689,5008910,F,N,Y,0,297000.0,Commercial associate,Secondary / secondary special,Single / not married,Rented apartment,-15519,-3234,1,0,0,0,Laborers,1.0,-9,C
1690,5008910,F,N,Y,0,297000.0,Commercial associate,Secondary / secondary special,Single / not married,Rented apartment,-15519,-3234,1,0,0,0,Laborers,1.0,-10,0
1691,5008910,F,N,Y,0,297000.0,Commercial associate,Secondary / secondary special,Single / not married,Rented apartment,-15519,-3234,1,0,0,0,Laborers,1.0,-11,0
1692,5008910,F,N,Y,0,297000.0,Commercial associate,Secondary / secondary special,Single / not married,Rented apartment,-15519,-3234,1,0,0,0,Laborers,1.0,-12,1
1693,5008910,F,N,Y,0,297000.0,Commercial associate,Secondary / secondary special,Single / not married,Rented apartment,-15519,-3234,1,0,0,0,Laborers,1.0,-13,0
1694,5008910,F,N,Y,0,297000.0,Commercial associate,Secondary / secondary special,Single / not married,Rented apartment,-15519,-3234,1,0,0,0,Laborers,1.0,-14,0
1695,5008910,F,N,Y,0,297000.0,Commercial associate,Secondary / secondary special,Single / not married,Rented apartment,-15519,-3234,1,0,0,0,Laborers,1.0,-15,0
1696,5008910,F,N,Y,0,297000.0,Commercial associate,Secondary / secondary special,Single / not married,Rented apartment,-15519,-3234,1,0,0,0,Laborers,1.0,-16,0
1697,5008910,F,N,Y,0,297000.0,Commercial associate,Secondary / secondary special,Single / not married,Rented apartment,-15519,-3234,1,0,0,0,Laborers,1.0,-17,0
1698,5008910,F,N,Y,0,297000.0,Commercial associate,Secondary / secondary special,Single / not married,Rented apartment,-15519,-3234,1,0,0,0,Laborers,1.0,-18,0
1699,5008910,F,N,Y,0,297000.0,Commercial associate,Secondary / secondary special,Single / not married,Rented apartment,-15519,-3234,1,0,0,0,Laborers,1.0,-19,0
1700,5008910,F,N,Y,0,297000.0,Commercial associate,Secondary / secondary special,Single / not married,Rented apartment,-15519,-3234,1,0,0,0,Laborers,1.0,-20,0
1701,5008910,F,N,Y,0,297000.0,Commercial associate,Secondary / secondary special,Single / not married,Rented apartment,-15519,-3234,1,0,0,0,Laborers,1.0,-21,X
1702,5008911,F,N,Y,0,297000.0,Commercial associate,Secondary / secondary special,Single / not married,Rented apartment,-15519,-3234,1,0,0,0,Laborers,1.0,-6,C
1703,5008911,F,N,Y,0,297000.0,Commercial associate,Secondary / secondary special,Single / not married,Rented apartment,-15519,-3234,1,0,0,0,Laborers,1.0,-7,C
1704,5008911,F,N,Y,0,297000.0,Commercial associate,Secondary / secondary special,Single / not married,Rented apartment,-15519,-3234,1,0,0,0,Laborers,1.0,-8,C
1705,5008911,F,N,Y,0,297000.0,Commercial associate,Secondary / secondary special,Single / not married,Rented apartment,-15519,-3234,1,0,0,0,Laborers,1.0,-9,C
1706,5008911,F,N,Y,0,297000.0,Commercial associate,Secondary / secondary special,Single / not married,Rented apartment,-15519,-3234,1,0,0,0,Laborers,1.0,-10,C
1707,5008911,F,N,Y,0,297000.0,Commercial associate,Secondary / secondary special,Single / not married,Rented apartment,-15519,-3234,1,0,0,0,Laborers,1.0,-11,C
1708,5008911,F,N,Y,0,297000.0,Commercial associate,Secondary / secondary special,Single / not married,Rented apartment,-15519,-3234,1,0,0,0,Laborers,1.0,-12,C
1709,5008911,F,N,Y,0,297000.0,Commercial associate,Secondary / secondary special,Single / not married,Rented apartment,-15519,-3234,1,0,0,0,Laborers,1.0,-13,C
1710,5008911,F,N,Y,0,297000.0,Commercial associate,Secondary / secondary special,Single / not married,Rented apartment,-15519,-3234,1,0,0,0,Laborers,1.0,-14,C
1711,5008911,F,N,Y,0,297000.0,Commercial associate,Secondary / secondary special,Single / not married,Rented apartment,-15519,-3234,1,0,0,0,Laborers,1.0,-15,C
1712,5008911,F,N,Y,0,297000.0,Commercial associate,Secondary / secondary special,Single / not married,Rented apartment,-15519,-3234,1,0,0,0,Laborers,1.0,-16,C
1713,5008911,F,N,Y,0,297000.0,Commercial associate,Secondary / secondary special,Single / not married,Rented apartment,-15519,-3234,1,0,0,0,Laborers,1.0,-17,C
1714,5008911,F,N,Y,0,297000.0,Commercial associate,Secondary / secondary special,Single / not married,Rented apartment,-15519,-3234,1,0,0,0,Laborers,1.0,-18,C
1715,5008911,F,N,Y,0,297000.0,Commercial associate,Secondary / secondary special,Single / not married,Rented apartment,-15519,-3234,1,0,0,0,Laborers,1.0,-19,C
1716,5008911,F,N,Y,0,297000.0,Commercial associate,Secondary / secondary special,Single / not married,Rented apartment,-15519,-3234,1,0,0,0,Laborers,1.0,-20,C
1717,5008911,F,N,Y,0,297000.0,Commercial associate,Secondary / secondary special,Single / not married,Rented apartment,-15519,-3234,1,0,0,0,Laborers,1.0,-21,0
1718,5008912,F,N,Y,0,297000.0,Commercial associate,Secondary / secondary special,Single / not married,Rented apartment,-15519,-3234,1,0,0,0,Laborers,1.0,0,C
1719,5008912,F,N,Y,0,297000.0,Commercial associate,Secondary / secondary special,Single / not married,Rented apartment,-15519,-3234,1,0,0,0,Laborers,1.0,-1,C
1720,5008912,F,N,Y,0,297000.0,Commercial associate,Secondary / secondary special,Single / not married,Rented apartment,-15519,-3234,1,0,0,0,Laborers,1.0,-2,C
1721,5008912,F,N,Y,0,297000.0,Commercial associate,Secondary / secondary special,Single / not married,Rented apartment,-15519,-3234,1,0,0,0,Laborers,1.0,-3,C
1722,5008912,F,N,Y,0,297000.0,Commercial associate,Secondary / secondary special,Single / not married,Rented apartment,-15519,-3234,1,0,0,0,Laborers,1.0,-4,C
1723,5008912,F,N,Y,0,297000.0,Commercial associate,Secondary / secondary special,Single / not married,Rented apartment,-15519,-3234,1,0,0,0,Laborers,1.0,-5,C
1724,5008912,F,N,Y,0,297000.0,Commercial associate,Secondary / secondary special,Single / not married,Rented apartment,-15519,-3234,1,0,0,0,Laborers,1.0,-6,C
1725,5008912,F,N,Y,0,297000.0,Commercial associate,Secondary / secondary special,Single / not married,Rented apartment,-15519,-3234,1,0,0,0,Laborers,1.0,-7,C
1726,5008912,F,N,Y,0,297000.0,Commercial associate,Secondary / secondary special,Single / not married,Rented apartment,-15519,-3234,1,0,0,0,Laborers,1.0,-8,C
1727,5008912,F,N,Y,0,297000.0,Commercial associate,Secondary / secondary special,Single / not married,Rented apartment,-15519,-3234,1,0,0,0,Laborers,1.0,-9,0
1728,5008912,F,N,Y,0,297000.0,Commercial associate,Secondary / secondary special,Single / not married,Rented apartment,-15519,-3234,1,0,0,0,Laborers,1.0,-10,0
1729,5008912,F,N,Y,0,297000.0,Commercial associate,Secondary / secondary special,Single / not married,Rented apartment,-15519,-3234,1,0,0,0,Laborers,1.0,-11,1
1730,5008912,F,N,Y,0,297000.0,Commercial associate,Secondary / secondary special,Single / not married,Rented apartment,-15519,-3234,1,0,0,0,Laborers,1.0,-12,0
1731,5008912,F,N,Y,0,297000.0,Commercial associate,Secondary / secondary special,Single / not married,Rented apartment,-15519,-3234,1,0,0,0,Laborers,1.0,-13,0
1732,5008912,F,N,Y,0,297000.0,Commercial associate,Secondary / secondary special,Single / not married,Rented apartment,-15519,-3234,1,0,0,0,Laborers,1.0,-14,0
1733,5008912,F,N,Y,0,297000.0,Commercial associate,Secondary / secondary special,Single / not married,Rented apartment,-15519,-3234,1,0,0,0,Laborers,1.0,-15,0
1734,5008912,F,N,Y,0,297000.0,Commercial associate,Secondary / secondary special,Single / not married,Rented apartment,-15519,-3234,1,0,0,0,Laborers,1.0,-16,0
1735,5008912,F,N,Y,0,297000.0,Commercial associate,Secondary / secondary special,Single / not married,Rented apartment,-15519,-3234,1,0,0,0,Laborers,1.0,-17,0
1736,5008912,F,N,Y,0,297000.0,Commercial associate,Secondary / secondary special,Single / not married,Rented apartment,-15519,-3234,1,0,0,0,Laborers,1.0,-18,0
1737,5008912,F,N,Y,0,297000.0,Commercial associate,Secondary / secondary special,Single / not married,Rented apartment,-15519,-3234,1,0,0,0,Laborers,1.0,-19,0
1738,5008912,F,N,Y,0,297000.0,Commercial associate,Secondary / secondary special,Single / not married,Rented apartment,-15519,-3234,1,0,0,0,Laborers,1.0,-20,X
1739,5008913,F,N,Y,0,297000.0,Commercial associate,Secondary / secondary special,Single / not married,Rented apartment,-15519,-3234,1,0,0,0,Laborers,1.0,-4,C
1740,5008913,F,N,Y,0,297000.0,Commercial associate,Secondary / secondary special,Single / not married,Rented apartment,-15519,-3234,1,0,0,0,Laborers,1.0,-5,C
1741,5008913,F,N,Y,0,297000.0,Commercial associate,Secondary / secondary special,Single / not married,Rented apartment,-15519,-3234,1,0,0,0,Laborers,1.0,-6,C
1742,5008913,F,N,Y,0,297000.0,Commercial associate,Secondary / secondary special,Single / not married,Rented apartment,-15519,-3234,1,0,0,0,Laborers,1.0,-7,C
1743,5008913,F,N,Y,0,297000.0,Commercial associate,Secondary / secondary special,Single / not married,Rented apartment,-15519,-3234,1,0,0,0,Laborers,1.0,-8,C
1744,5008913,F,N,Y,0,297000.0,Commercial associate,Secondary / secondary special,Single / not married,Rented apartment,-15519,-3234,1,0,0,0,Laborers,1.0,-9,C
1745,5008913,F,N,Y,0,297000.0,Commercial associate,Secondary / secondary special,Single / not married,Rented apartment,-15519,-3234,1,0,0,0,Laborers,1.0,-10,C
1746,5008913,F,N,Y,0,297000.0,Commercial associate,Secondary / secondary special,Single / not married,Rented apartment,-15519,-3234,1,0,0,0,Laborers,1.0,-11,C
1747,5008913,F,N,Y,0,297000.0,Commercial associate,Secondary / secondary special,Single / not married,Rented apartment,-15519,-3234,1,0,0,0,Laborers,1.0,-12,C
1748,5008913,F,N,Y,0,297000.0,Commercial associate,Secondary / secondary special,Single / not married,Rented apartment,-15519,-3234,1,0,0,0,Laborers,1.0,-13,C
1749,5008913,F,N,Y,0,297000.0,Commercial associate,Secondary / secondary special,Single / not married,Rented apartment,-15519,-3234,1,0,0,0,Laborers,1.0,-14,C
1750,5008913,F,N,Y,0,297000.0,Commercial associate,Secondary / secondary special,Single / not married,Rented apartment,-15519,-3234,1,0,0,0,Laborers,1.0,-15,C
1751,5008913,F,N,Y,0,297000.0,Commercial associate,Secondary / secondary special,Single / not married,Rented apartment,-15519,-3234,1,0,0,0,Laborers,1.0,-16,C
1752,5008913,F,N,Y,0,297000.0,Commercial associate,Secondary / secondary special,Single / not married,Rented apartment,-15519,-3234,1,0,0,0,Laborers,1.0,-17,C
1753,5008913,F,N,Y,0,297000.0,Commercial associate,Secondary / secondary special,Single / not married,Rented apartment,-15519,-3234,1,0,0,0,Laborers,1.0,-18,C
1754,5008913,F,N,Y,0,297000.0,Commercial associate,Secondary / secondary special,Single / not married,Rented apartment,-15519,-3234,1,0,0,0,Laborers,1.0,-19,0
1755,5008914,F,N,Y,0,297000.0,Commercial associate,Secondary / secondary special,Single / not married,Rented apartment,-15519,-3234,1,0,0,0,Laborers,1.0,0,C
1756,5008914,F,N,Y,0,297000.0,Commercial associate,Secondary / secondary special,Single / not married,Rented apartment,-15519,-3234,1,0,0,0,Laborers,1.0,-1,C
1757,5008914,F,N,Y,0,297000.0,Commercial associate,Secondary / secondary special,Single / not married,Rented apartment,-15519,-3234,1,0,0,0,Laborers,1.0,-2,C
1758,5008914,F,N,Y,0,297000.0,Commercial associate,Secondary / secondary special,Single / not married,Rented apartment,-15519,-3234,1,0,0,0,Laborers,1.0,-3,C
1759,5008914,F,N,Y,0,297000.0,Commercial associate,Secondary / secondary special,Single / not married,Rented apartment,-15519,-3234,1,0,0,0,Laborers,1.0,-4,C
1760,5008914,F,N,Y,0,297000.0,Commercial associate,Secondary / secondary special,Single / not married,Rented apartment,-15519,-3234,1,0,0,0,Laborers,1.0,-5,C
1761,5008914,F,N,Y,0,297000.0,Commercial associate,Secondary / secondary special,Single / not married,Rented apartment,-15519,-3234,1,0,0,0,Laborers,1.0,-6,C
1762,5008914,F,N,Y,0,297000.0,Commercial associate,Secondary / secondary special,Single / not married,Rented apartment,-15519,-3234,1,0,0,0,Laborers,1.0,-7,0
1763,5008914,F,N,Y,0,297000.0,Commercial associate,Secondary / secondary special,Single / not married,Rented apartment,-15519,-3234,1,0,0,0,Laborers,1.0,-8,0
1764,5008914,F,N,Y,0,297000.0,Commercial associate,Secondary / secondary special,Single / not married,Rented apartment,-15519,-3234,1,0,0,0,Laborers,1.0,-9,1
1765,5008914,F,N,Y,0,297000.0,Commercial associate,Secondary / secondary special,Single / not married,Rented apartment,-15519,-3234,1,0,0,0,Laborers,1.0,-10,0
1766,5008914,F,N,Y,0,297000.0,Commercial associate,Secondary / secondary special,Single / not married,Rented apartment,-15519,-3234,1,0,0,0,Laborers,1.0,-11,0
1767,5008914,F,N,Y,0,297000.0,Commercial associate,Secondary / secondary special,Single / not married,Rented apartment,-15519,-3234,1,0,0,0,Laborers,1.0,-12,0
1768,5008914,F,N,Y,0,297000.0,Commercial associate,Secondary / secondary special,Single / not married,Rented apartment,-15519,-3234,1,0,0,0,Laborers,1.0,-13,0
1769,5008914,F,N,Y,0,297000.0,Commercial associate,Secondary / secondary special,Single / not married,Rented apartment,-15519,-3234,1,0,0,0,Laborers,1.0,-14,0
1770,5008914,F,N,Y,0,297000.0,Commercial associate,Secondary / secondary special,Single / not married,Rented apartment,-15519,-3234,1,0,0,0,Laborers,1.0,-15,0
1771,5008914,F,N,Y,0,297000.0,Commercial associate,Secondary / secondary special,Single / not married,Rented apartment,-15519,-3234,1,0,0,0,Laborers,1.0,-16,0
1772,5008914,F,N,Y,0,297000.0,Commercial associate,Secondary / secondary special,Single / not married,Rented apartment,-15519,-3234,1,0,0,0,Laborers,1.0,-17,0
1773,5008914,F,N,Y,0,297000.0,Commercial associate,Secondary / secondary special,Single / not married,Rented apartment,-15519,-3234,1,0,0,0,Laborers,1.0,-18,X
1774,5008915,F,N,Y,0,297000.0,Commercial associate,Secondary / secondary special,Single / not married,Rented apartment,-15519,-3234,1,0,0,0,Laborers,1.0,-3,C
1775,5008915,F,N,Y,0,297000.0,Commercial associate,Secondary / secondary special,Single / not married,Rented apartment,-15519,-3234,1,0,0,0,Laborers,1.0,-4,C
1776,5008915,F,N,Y,0,297000.0,Commercial associate,Secondary / secondary special,Single / not married,Rented apartment,-15519,-3234,1,0,0,0,Laborers,1.0,-5,C
1777,5008915,F,N,Y,0,297000.0,Commercial associate,Secondary / secondary special,Single / not married,Rented apartment,-15519,-3234,1,0,0,0,Laborers,1.0,-6,C
1778,5008915,F,N,Y,0,297000.0,Commercial associate,Secondary / secondary special,Single / not married,Rented apartment,-15519,-3234,1,0,0,0,Laborers,1.0,-7,C
1779,5008915,F,N,Y,0,297000.0,Commercial associate,Secondary / secondary special,Single / not married,Rented apartment,-15519,-3234,1,0,0,0,Laborers,1.0,-8,C
1780,5008915,F,N,Y,0,297000.0,Commercial associate,Secondary / secondary special,Single / not married,Rented apartment,-15519,-3234,1,0,0,0,Laborers,1.0,-9,C
1781,5008915,F,N,Y,0,297000.0,Commercial associate,Secondary / secondary special,Single / not married,Rented apartment,-15519,-3234,1,0,0,0,Laborers,1.0,-10,C
1782,5008915,F,N,Y,0,297000.0,Commercial associate,Secondary / secondary special,Single / not married,Rented apartment,-15519,-3234,1,0,0,0,Laborers,1.0,-11,C
1783,5008915,F,N,Y,0,297000.0,Commercial associate,Secondary / secondary special,Single / not married,Rented apartment,-15519,-3234,1,0,0,0,Laborers,1.0,-12,C
1784,5008915,F,N,Y,0,297000.0,Commercial associate,Secondary / secondary special,Single / not married,Rented apartment,-15519,-3234,1,0,0,0,Laborers,1.0,-13,C
1785,5008915,F,N,Y,0,297000.0,Commercial associate,Secondary / secondary special,Single / not married,Rented apartment,-15519,-3234,1,0,0,0,Laborers,1.0,-14,C
1786,5008915,F,N,Y,0,297000.0,Commercial associate,Secondary / secondary special,Single / not married,Rented apartment,-15519,-3234,1,0,0,0,Laborers,1.0,-15,C
1787,5008915,F,N,Y,0,297000.0,Commercial associate,Secondary / secondary special,Single / not married,Rented apartment,-15519,-3234,1,0,0,0,Laborers,1.0,-16,C
1788,5008915,F,N,Y,0,297000.0,Commercial associate,Secondary / secondary special,Single / not married,Rented apartment,-15519,-3234,1,0,0,0,Laborers,1.0,-17,C
1789,5008915,F,N,Y,0,297000.0,Commercial associate,Secondary / secondary special,Single / not married,Rented apartment,-15519,-3234,1,0,0,0,Laborers,1.0,-18,0
1790,5008916,F,N,Y,0,297000.0,Commercial associate,Secondary / secondary special,Single / not married,Rented apartment,-15519,-3234,1,0,0,0,Laborers,1.0,0,C
1791,5008916,F,N,Y,0,297000.0,Commercial associate,Secondary / secondary special,Single / not married,Rented apartment,-15519,-3234,1,0,0,0,Laborers,1.0,-1,C
1792,5008916,F,N,Y,0,297000.0,Commercial associate,Secondary / secondary special,Single / not married,Rented apartment,-15519,-3234,1,0,0,0,Laborers,1.0,-2,C
1793,5008916,F,N,Y,0,297000.0,Commercial associate,Secondary / secondary special,Single / not married,Rented apartment,-15519,-3234,1,0,0,0,Laborers,1.0,-3,C
1794,5008916,F,N,Y,0,297000.0,Commercial associate,Secondary / secondary special,Single / not married,Rented apartment,-15519,-3234,1,0,0,0,Laborers,1.0,-4,C
1795,5008916,F,N,Y,0,297000.0,Commercial associate,Secondary / secondary special,Single / not married,Rented apartment,-15519,-3234,1,0,0,0,Laborers,1.0,-5,C
1796,5008916,F,N,Y,0,297000.0,Commercial associate,Secondary / secondary special,Single / not married,Rented apartment,-15519,-3234,1,0,0,0,Laborers,1.0,-6,0
1797,5008916,F,N,Y,0,297000.0,Commercial associate,Secondary / secondary special,Single / not married,Rented apartment,-15519,-3234,1,0,0,0,Laborers,1.0,-7,0
1798,5008916,F,N,Y,0,297000.0,Commercial associate,Secondary / secondary special,Single / not married,Rented apartment,-15519,-3234,1,0,0,0,Laborers,1.0,-8,1
1799,5008916,F,N,Y,0,297000.0,Commercial associate,Secondary / secondary special,Single / not married,Rented apartment,-15519,-3234,1,0,0,0,Laborers,1.0,-9,0
1800,5008916,F,N,Y,0,297000.0,Commercial associate,Secondary / secondary special,Single / not married,Rented apartment,-15519,-3234,1,0,0,0,Laborers,1.0,-10,0
1801,5008916,F,N,Y,0,297000.0,Commercial associate,Secondary / secondary special,Single / not married,Rented apartment,-15519,-3234,1,0,0,0,Laborers,1.0,-11,0
1802,5008916,F,N,Y,0,297000.0,Commercial associate,Secondary / secondary special,Single / not married,Rented apartment,-15519,-3234,1,0,0,0,Laborers,1.0,-12,0
1803,5008916,F,N,Y,0,297000.0,Commercial associate,Secondary / secondary special,Single / not married,Rented apartment,-15519,-3234,1,0,0,0,Laborers,1.0,-13,0
1804,5008916,F,N,Y,0,297000.0,Commercial associate,Secondary / secondary special,Single / not married,Rented apartment,-15519,-3234,1,0,0,0,Laborers,1.0,-14,0
1805,5008916,F,N,Y,0,297000.0,Commercial associate,Secondary / secondary special,Single / not married,Rented apartment,-15519,-3234,1,0,0,0,Laborers,1.0,-15,0
1806,5008916,F,N,Y,0,297000.0,Commercial associate,Secondary / secondary special,Single / not married,Rented apartment,-15519,-3234,1,0,0,0,Laborers,1.0,-16,0
1807,5008916,F,N,Y,0,297000.0,Commercial associate,Secondary / secondary special,Single / not married,Rented apartment,-15519,-3234,1,0,0,0,Laborers,1.0,-17,X
1808,5008917,F,N,Y,0,297000.0,Commercial associate,Secondary / secondary special,Single / not married,Rented apartment,-15519,-3234,1,0,0,0,Laborers,1.0,-2,C
1809,5008917,F,N,Y,0,297000.0,Commercial associate,Secondary / secondary special,Single / not married,Rented apartment,-15519,-3234,1,0,0,0,Laborers,1.0,-3,C
1810,5008917,F,N,Y,0,297000.0,Commercial associate,Secondary / secondary special,Single / not married,Rented apartment,-15519,-3234,1,0,0,0,Laborers,1.0,-4,C
1811,5008917,F,N,Y,0,297000.0,Commercial associate,Secondary / secondary special,Single / not married,Rented apartment,-15519,-3234,1,0,0,0,Laborers,1.0,-5,C
1812,5008917,F,N,Y,0,297000.0,Commercial associate,Secondary / secondary special,Single / not married,Rented apartment,-15519,-3234,1,0,0,0,Laborers,1.0,-6,C
1813,5008917,F,N,Y,0,297000.0,Commercial associate,Secondary / secondary special,Single / not married,Rented apartment,-15519,-3234,1,0,0,0,Laborers,1.0,-7,C
1814,5008917,F,N,Y,0,297000.0,Commercial associate,Secondary / secondary special,Single / not married,Rented apartment,-15519,-3234,1,0,0,0,Laborers,1.0,-8,C
1815,5008917,F,N,Y,0,297000.0,Commercial associate,Secondary / secondary special,Single / not married,Rented apartment,-15519,-3234,1,0,0,0,Laborers,1.0,-9,C
1816,5008917,F,N,Y,0,297000.0,Commercial associate,Secondary / secondary special,Single / not married,Rented apartment,-15519,-3234,1,0,0,0,Laborers,1.0,-10,C
1817,5008917,F,N,Y,0,297000.0,Commercial associate,Secondary / secondary special,Single / not married,Rented apartment,-15519,-3234,1,0,0,0,Laborers,1.0,-11,C
1818,5008917,F,N,Y,0,297000.0,Commercial associate,Secondary / secondary special,Single / not married,Rented apartment,-15519,-3234,1,0,0,0,Laborers,1.0,-12,C
1819,5008917,F,N,Y,0,297000.0,Commercial associate,Secondary / secondary special,Single / not married,Rented apartment,-15519,-3234,1,0,0,0,Laborers,1.0,-13,C
1820,5008917,F,N,Y,0,297000.0,Commercial associate,Secondary / secondary special,Single / not married,Rented apartment,-15519,-3234,1,0,0,0,Laborers,1.0,-14,C
1821,5008917,F,N,Y,0,297000.0,Commercial associate,Secondary / secondary special,Single / not married,Rented apartment,-15519,-3234,1,0,0,0,Laborers,1.0,-15,C
1822,5008917,F,N,Y,0,297000.0,Commercial associate,Secondary / secondary special,Single / not married,Rented apartment,-15519,-3234,1,0,0,0,Laborers,1.0,-16,C
1823,5008917,F,N,Y,0,297000.0,Commercial associate,Secondary / secondary special,Single / not married,Rented apartment,-15519,-3234,1,0,0,0,Laborers,1.0,-17,0
1824,5008918,F,N,Y,0,297000.0,Commercial associate,Secondary / secondary special,Single / not married,Rented apartment,-15519,-3234,1,0,0,0,Laborers,1.0,0,C
1825,5008918,F,N,Y,0,297000.0,Commercial associate,Secondary / secondary special,Single / not married,Rented apartment,-15519,-3234,1,0,0,0,Laborers,1.0,-1,C
1826,5008918,F,N,Y,0,297000.0,Commercial associate,Secondary / secondary special,Single / not married,Rented apartment,-15519,-3234,1,0,0,0,Laborers,1.0,-2,C
1827,5008918,F,N,Y,0,297000.0,Commercial associate,Secondary / secondary special,Single / not married,Rented apartment,-15519,-3234,1,0,0,0,Laborers,1.0,-3,C
1828,5008918,F,N,Y,0,297000.0,Commercial associate,Secondary / secondary special,Single / not married,Rented apartment,-15519,-3234,1,0,0,0,Laborers,1.0,-4,C
1829,5008918,F,N,Y,0,297000.0,Commercial associate,Secondary / secondary special,Single / not married,Rented apartment,-15519,-3234,1,0,0,0,Laborers,1.0,-5,0
1830,5008918,F,N,Y,0,297000.0,Commercial associate,Secondary / secondary special,Single / not married,Rented apartment,-15519,-3234,1,0,0,0,Laborers,1.0,-6,0
1831,5008918,F,N,Y,0,297000.0,Commercial associate,Secondary / secondary special,Single / not married,Rented apartment,-15519,-3234,1,0,0,0,Laborers,1.0,-7,1
1832,5008918,F,N,Y,0,297000.0,Commercial associate,Secondary / secondary special,Single / not married,Rented apartment,-15519,-3234,1,0,0,0,Laborers,1.0,-8,0
1833,5008918,F,N,Y,0,297000.0,Commercial associate,Secondary / secondary special,Single / not married,Rented apartment,-15519,-3234,1,0,0,0,Laborers,1.0,-9,0
1834,5008918,F,N,Y,0,297000.0,Commercial associate,Secondary / secondary special,Single / not married,Rented apartment,-15519,-3234,1,0,0,0,Laborers,1.0,-10,0
1835,5008918,F,N,Y,0,297000.0,Commercial associate,Secondary / secondary special,Single / not married,Rented apartment,-15519,-3234,1,0,0,0,Laborers,1.0,-11,0
1836,5008918,F,N,Y,0,297000.0,Commercial associate,Secondary / secondary special,Single / not married,Rented apartment,-15519,-3234,1,0,0,0,Laborers,1.0,-12,0
1837,5008918,F,N,Y,0,297000.0,Commercial associate,Secondary / secondary special,Single / not married,Rented apartment,-15519,-3234,1,0,0,0,Laborers,1.0,-13,0
1838,5008918,F,N,Y,0,297000.0,Commercial associate,Secondary / secondary special,Single / not married,Rented apartment,-15519,-3234,1,0,0,0,Laborers,1.0,-14,0
1839,5008918,F,N,Y,0,297000.0,Commercial associate,Secondary / secondary special,Single / not married,Rented apartment,-15519,-3234,1,0,0,0,Laborers,1.0,-15,0
1840,5008918,F,N,Y,0,297000.0,Commercial associate,Secondary / secondary special,Single / not married,Rented apartment,-15519,-3234,1,0,0,0,Laborers,1.0,-16,X
1841,5008919,F,N,Y,0,297000.0,Commercial associate,Secondary / secondary special,Single / not married,Rented apartment,-15519,-3234,1,0,0,0,Laborers,1.0,0,C
1842,5008919,F,N,Y,0,297000.0,Commercial associate,Secondary / secondary special,Single / not married,Rented apartment,-15519,-3234,1,0,0,0,Laborers,1.0,-1,C
1843,5008919,F,N,Y,0,297000.0,Commercial associate,Secondary / secondary special,Single / not married,Rented apartment,-15519,-3234,1,0,0,0,Laborers,1.0,-2,C
1844,5008919,F,N,Y,0,297000.0,Commercial associate,Secondary / secondary special,Single / not married,Rented apartment,-15519,-3234,1,0,0,0,Laborers,1.0,-3,C
1845,5008919,F,N,Y,0,297000.0,Commercial associate,Secondary / secondary special,Single / not married,Rented apartment,-15519,-3234,1,0,0,0,Laborers,1.0,-4,C
1846,5008919,F,N,Y,0,297000.0,Commercial associate,Secondary / secondary special,Single / not married,Rented apartment,-15519,-3234,1,0,0,0,Laborers,1.0,-5,C
1847,5008919,F,N,Y,0,297000.0,Commercial associate,Secondary / secondary special,Single / not married,Rented apartment,-15519,-3234,1,0,0,0,Laborers,1.0,-6,C
1848,5008919,F,N,Y,0,297000.0,Commercial associate,Secondary / secondary special,Single / not married,Rented apartment,-15519,-3234,1,0,0,0,Laborers,1.0,-7,C
1849,5008919,F,N,Y,0,297000.0,Commercial associate,Secondary / secondary special,Single / not married,Rented apartment,-15519,-3234,1,0,0,0,Laborers,1.0,-8,C
1850,5008919,F,N,Y,0,297000.0,Commercial associate,Secondary / secondary special,Single / not married,Rented apartment,-15519,-3234,1,0,0,0,Laborers,1.0,-9,C
1851,5008919,F,N,Y,0,297000.0,Commercial associate,Secondary / secondary special,Single / not married,Rented apartment,-15519,-3234,1,0,0,0,Laborers,1.0,-10,C
1852,5008919,F,N,Y,0,297000.0,Commercial associate,Secondary / secondary special,Single / not married,Rented apartment,-15519,-3234,1,0,0,0,Laborers,1.0,-11,C
1853,5008919,F,N,Y,0,297000.0,Commercial associate,Secondary / secondary special,Single / not married,Rented apartment,-15519,-3234,1,0,0,0,Laborers,1.0,-12,C
1854,5008919,F,N,Y,0,297000.0,Commercial associate,Secondary / secondary special,Single / not married,Rented apartment,-15519,-3234,1,0,0,0,Laborers,1.0,-13,C
1855,5008919,F,N,Y,0,297000.0,Commercial associate,Secondary / secondary special,Single / not married,Rented apartment,-15519,-3234,1,0,0,0,Laborers,1.0,-14,C
1856,5008919,F,N,Y,0,297000.0,Commercial associate,Secondary / secondary special,Single / not married,Rented apartment,-15519,-3234,1,0,0,0,Laborers,1.0,-15,0
1857,5008920,F,N,Y,0,297000.0,Commercial associate,Secondary / secondary special,Single / not married,Rented apartment,-15519,-3234,1,0,0,0,Laborers,1.0,0,C
1858,5008920,F,N,Y,0,297000.0,Commercial associate,Secondary / secondary special,Single / not married,Rented apartment,-15519,-3234,1,0,0,0,Laborers,1.0,-1,C
1859,5008920,F,N,Y,0,297000.0,Commercial associate,Secondary / secondary special,Single / not married,Rented apartment,-15519,-3234,1,0,0,0,Laborers,1.0,-2,C
1860,5008920,F,N,Y,0,297000.0,Commercial associate,Secondary / secondary special,Single / not married,Rented apartment,-15519,-3234,1,0,0,0,Laborers,1.0,-3,C
1861,5008920,F,N,Y,0,297000.0,Commercial associate,Secondary / secondary special,Single / not married,Rented apartment,-15519,-3234,1,0,0,0,Laborers,1.0,-4,0
1862,5008920,F,N,Y,0,297000.0,Commercial associate,Secondary / secondary special,Single / not married,Rented apartment,-15519,-3234,1,0,0,0,Laborers,1.0,-5,0
1863,5008920,F,N,Y,0,297000.0,Commercial associate,Secondary / secondary special,Single / not married,Rented apartment,-15519,-3234,1,0,0,0,Laborers,1.0,-6,1
1864,5008920,F,N,Y,0,297000.0,Commercial associate,Secondary / secondary special,Single / not married,Rented apartment,-15519,-3234,1,0,0,0,Laborers,1.0,-7,0
1865,5008920,F,N,Y,0,297000.0,Commercial associate,Secondary / secondary special,Single / not married,Rented apartment,-15519,-3234,1,0,0,0,Laborers,1.0,-8,0
1866,5008920,F,N,Y,0,297000.0,Commercial associate,Secondary / secondary special,Single / not married,Rented apartment,-15519,-3234,1,0,0,0,Laborers,1.0,-9,0
1867,5008920,F,N,Y,0,297000.0,Commercial associate,Secondary / secondary special,Single / not married,Rented apartment,-15519,-3234,1,0,0,0,Laborers,1.0,-10,0
1868,5008920,F,N,Y,0,297000.0,Commercial associate,Secondary / secondary special,Single / not married,Rented apartment,-15519,-3234,1,0,0,0,Laborers,1.0,-11,0
1869,5008920,F,N,Y,0,297000.0,Commercial associate,Secondary / secondary special,Single / not married,Rented apartment,-15519,-3234,1,0,0,0,Laborers,1.0,-12,0
1870,5008920,F,N,Y,0,297000.0,Commercial associate,Secondary / secondary special,Single / not married,Rented apartment,-15519,-3234,1,0,0,0,Laborers,1.0,-13,0
1871,5008920,F,N,Y,0,297000.0,Commercial associate,Secondary / secondary special,Single / not married,Rented apartment,-15519,-3234,1,0,0,0,Laborers,1.0,-14,0
1872,5008920,F,N,Y,0,297000.0,Commercial associate,Secondary / secondary special,Single / not married,Rented apartment,-15519,-3234,1,0,0,0,Laborers,1.0,-15,X
1873,5008921,F,N,Y,0,297000.0,Commercial associate,Secondary / secondary special,Single / not married,Rented apartment,-15519,-3234,1,0,0,0,Laborers,1.0,0,C
1874,5008921,F,N,Y,0,297000.0,Commercial associate,Secondary / secondary special,Single / not married,Rented apartment,-15519,-3234,1,0,0,0,Laborers,1.0,-1,C
1875,5008921,F,N,Y,0,297000.0,Commercial associate,Secondary / secondary special,Single / not married,Rented apartment,-15519,-3234,1,0,0,0,Laborers,1.0,-2,C
1876,5008921,F,N,Y,0,297000.0,Commercial associate,Secondary / secondary special,Single / not married,Rented apartment,-15519,-3234,1,0,0,0,Laborers,1.0,-3,C
1877,5008921,F,N,Y,0,297000.0,Commercial associate,Secondary / secondary special,Single / not married,Rented apartment,-15519,-3234,1,0,0,0,Laborers,1.0,-4,C
1878,5008921,F,N,Y,0,297000.0,Commercial associate,Secondary / secondary special,Single / not married,Rented apartment,-15519,-3234,1,0,0,0,Laborers,1.0,-5,C
1879,5008921,F,N,Y,0,297000.0,Commercial associate,Secondary / secondary special,Single / not married,Rented apartment,-15519,-3234,1,0,0,0,Laborers,1.0,-6,C
1880,5008921,F,N,Y,0,297000.0,Commercial associate,Secondary / secondary special,Single / not married,Rented apartment,-15519,-3234,1,0,0,0,Laborers,1.0,-7,C
1881,5008921,F,N,Y,0,297000.0,Commercial associate,Secondary / secondary special,Single / not married,Rented apartment,-15519,-3234,1,0,0,0,Laborers,1.0,-8,C
1882,5008921,F,N,Y,0,297000.0,Commercial associate,Secondary / secondary special,Single / not married,Rented apartment,-15519,-3234,1,0,0,0,Laborers,1.0,-9,C
1883,5008921,F,N,Y,0,297000.0,Commercial associate,Secondary / secondary special,Single / not married,Rented apartment,-15519,-3234,1,0,0,0,Laborers,1.0,-10,C
1884,5008921,F,N,Y,0,297000.0,Commercial associate,Secondary / secondary special,Single / not married,Rented apartment,-15519,-3234,1,0,0,0,Laborers,1.0,-11,C
1885,5008921,F,N,Y,0,297000.0,Commercial associate,Secondary / secondary special,Single / not married,Rented apartment,-15519,-3234,1,0,0,0,Laborers,1.0,-12,C
1886,5008921,F,N,Y,0,297000.0,Commercial associate,Secondary / secondary special,Single / not married,Rented apartment,-15519,-3234,1,0,0,0,Laborers,1.0,-13,0
1887,5008922,F,N,Y,0,297000.0,Commercial associate,Secondary / secondary special,Single / not married,Rented apartment,-15519,-3234,1,0,0,0,Laborers,1.0,0,C
1888,5008922,F,N,Y,0,297000.0,Commercial associate,Secondary / secondary special,Single / not married,Rented apartment,-15519,-3234,1,0,0,0,Laborers,1.0,-1,C
1889,5008922,F,N,Y,0,297000.0,Commercial associate,Secondary / secondary special,Single / not married,Rented apartment,-15519,-3234,1,0,0,0,Laborers,1.0,-2,0
1890,5008922,F,N,Y,0,297000.0,Commercial associate,Secondary / secondary special,Single / not married,Rented apartment,-15519,-3234,1,0,0,0,Laborers,1.0,-3,0
1891,5008922,F,N,Y,0,297000.0,Commercial associate,Secondary / secondary special,Single / not married,Rented apartment,-15519,-3234,1,0,0,0,Laborers,1.0,-4,1
1892,5008922,F,N,Y,0,297000.0,Commercial associate,Secondary / secondary special,Single / not married,Rented apartment,-15519,-3234,1,0,0,0,Laborers,1.0,-5,0
1893,5008922,F,N,Y,0,297000.0,Commercial associate,Secondary / secondary special,Single / not married,Rented apartment,-15519,-3234,1,0,0,0,Laborers,1.0,-6,0
1894,5008922,F,N,Y,0,297000.0,Commercial associate,Secondary / secondary special,Single / not married,Rented apartment,-15519,-3234,1,0,0,0,Laborers,1.0,-7,0
1895,5008922,F,N,Y,0,297000.0,Commercial associate,Secondary / secondary special,Single / not married,Rented apartment,-15519,-3234,1,0,0,0,Laborers,1.0,-8,0
1896,5008922,F,N,Y,0,297000.0,Commercial associate,Secondary / secondary special,Single / not married,Rented apartment,-15519,-3234,1,0,0,0,Laborers,1.0,-9,0
1897,5008922,F,N,Y,0,297000.0,Commercial associate,Secondary / secondary special,Single / not married,Rented apartment,-15519,-3234,1,0,0,0,Laborers,1.0,-10,0
1898,5008922,F,N,Y,0,297000.0,Commercial associate,Secondary / secondary special,Single / not married,Rented apartment,-15519,-3234,1,0,0,0,Laborers,1.0,-11,0
1899,5008922,F,N,Y,0,297000.0,Commercial associate,Secondary / secondary special,Single / not married,Rented apartment,-15519,-3234,1,0,0,0,Laborers,1.0,-12,0
1900,5008922,F,N,Y,0,297000.0,Commercial associate,Secondary / secondary special,Single / not married,Rented apartment,-15519,-3234,1,0,0,0,Laborers,1.0,-13,X
1901,5008923,F,N,Y,0,297000.0,Commercial associate,Secondary / secondary special,Single / not married,Rented apartment,-15519,-3234,1,0,0,0,Laborers,1.0,0,C
1902,5008923,F,N,Y,0,297000.0,Commercial associate,Secondary / secondary special,Single / not married,Rented apartment,-15519,-3234,1,0,0,0,Laborers,1.0,-1,C
1903,5008923,F,N,Y,0,297000.0,Commercial associate,Secondary / secondary special,Single / not married,Rented apartment,-15519,-3234,1,0,0,0,Laborers,1.0,-2,C
1904,5008923,F,N,Y,0,297000.0,Commercial associate,Secondary / secondary special,Single / not married,Rented apartment,-15519,-3234,1,0,0,0,Laborers,1.0,-3,C
1905,5008923,F,N,Y,0,297000.0,Commercial associate,Secondary / secondary special,Single / not married,Rented apartment,-15519,-3234,1,0,0,0,Laborers,1.0,-4,C
1906,5008923,F,N,Y,0,297000.0,Commercial associate,Secondary / secondary special,Single / not married,Rented apartment,-15519,-3234,1,0,0,0,Laborers,1.0,-5,C
1907,5008923,F,N,Y,0,297000.0,Commercial associate,Secondary / secondary special,Single / not married,Rented apartment,-15519,-3234,1,0,0,0,Laborers,1.0,-6,C
1908,5008923,F,N,Y,0,297000.0,Commercial associate,Secondary / secondary special,Single / not married,Rented apartment,-15519,-3234,1,0,0,0,Laborers,1.0,-7,C
1909,5008923,F,N,Y,0,297000.0,Commercial associate,Secondary / secondary special,Single / not married,Rented apartment,-15519,-3234,1,0,0,0,Laborers,1.0,-8,C
1910,5008923,F,N,Y,0,297000.0,Commercial associate,Secondary / secondary special,Single / not married,Rented apartment,-15519,-3234,1,0,0,0,Laborers,1.0,-9,C
1911,5008923,F,N,Y,0,297000.0,Commercial associate,Secondary / secondary special,Single / not married,Rented apartment,-15519,-3234,1,0,0,0,Laborers,1.0,-10,C
1912,5008923,F,N,Y,0,297000.0,Commercial associate,Secondary / secondary special,Single / not married,Rented apartment,-15519,-3234,1,0,0,0,Laborers,1.0,-11,C
1913,5008923,F,N,Y,0,297000.0,Commercial associate,Secondary / secondary special,Single / not married,Rented apartment,-15519,-3234,1,0,0,0,Laborers,1.0,-12,0
1914,5008924,F,N,Y,0,297000.0,Commercial associate,Secondary / secondary special,Single / not married,Rented apartment,-15519,-3234,1,0,0,0,Laborers,1.0,0,C
1915,5008924,F,N,Y,0,297000.0,Commercial associate,Secondary / secondary special,Single / not married,Rented apartment,-15519,-3234,1,0,0,0,Laborers,1.0,-1,C
1916,5008924,F,N,Y,0,297000.0,Commercial associate,Secondary / secondary special,Single / not married,Rented apartment,-15519,-3234,1,0,0,0,Laborers,1.0,-2,C
1917,5008924,F,N,Y,0,297000.0,Commercial associate,Secondary / secondary special,Single / not married,Rented apartment,-15519,-3234,1,0,0,0,Laborers,1.0,-3,C
1918,5008924,F,N,Y,0,297000.0,Commercial associate,Secondary / secondary special,Single / not married,Rented apartment,-15519,-3234,1,0,0,0,Laborers,1.0,-4,C
1919,5008924,F,N,Y,0,297000.0,Commercial associate,Secondary / secondary special,Single / not married,Rented apartment,-15519,-3234,1,0,0,0,Laborers,1.0,-5,C
1920,5008924,F,N,Y,0,297000.0,Commercial associate,Secondary / secondary special,Single / not married,Rented apartment,-15519,-3234,1,0,0,0,Laborers,1.0,-6,C
1921,5008924,F,N,Y,0,297000.0,Commercial associate,Secondary / secondary special,Single / not married,Rented apartment,-15519,-3234,1,0,0,0,Laborers,1.0,-7,C
1922,5008924,F,N,Y,0,297000.0,Commercial associate,Secondary / secondary special,Single / not married,Rented apartment,-15519,-3234,1,0,0,0,Laborers,1.0,-8,C
1923,5008924,F,N,Y,0,297000.0,Commercial associate,Secondary / secondary special,Single / not married,Rented apartment,-15519,-3234,1,0,0,0,Laborers,1.0,-9,C
1924,5008924,F,N,Y,0,297000.0,Commercial associate,Secondary / secondary special,Single / not married,Rented apartment,-15519,-3234,1,0,0,0,Laborers,1.0,-10,C
1925,5008924,F,N,Y,0,297000.0,Commercial associate,Secondary / secondary special,Single / not married,Rented apartment,-15519,-3234,1,0,0,0,Laborers,1.0,-11,C
1926,5008924,F,N,Y,0,297000.0,Commercial associate,Secondary / secondary special,Single / not married,Rented apartment,-15519,-3234,1,0,0,0,Laborers,1.0,-12,X
1927,5008925,F,N,Y,0,297000.0,Commercial associate,Secondary / secondary special,Single / not married,Rented apartment,-15519,-3234,1,0,0,0,Laborers,1.0,0,C
1928,5008925,F,N,Y,0,297000.0,Commercial associate,Secondary / secondary special,Single / not married,Rented apartment,-15519,-3234,1,0,0,0,Laborers,1.0,-1,C
1929,5008925,F,N,Y,0,297000.0,Commercial associate,Secondary / secondary special,Single / not married,Rented apartment,-15519,-3234,1,0,0,0,Laborers,1.0,-2,C
1930,5008925,F,N,Y,0,297000.0,Commercial associate,Secondary / secondary special,Single / not married,Rented apartment,-15519,-3234,1,0,0,0,Laborers,1.0,-3,C
1931,5008925,F,N,Y,0,297000.0,Commercial associate,Secondary / secondary special,Single / not married,Rented apartment,-15519,-3234,1,0,0,0,Laborers,1.0,-4,C
1932,5008925,F,N,Y,0,297000.0,Commercial associate,Secondary / secondary special,Single / not married,Rented apartment,-15519,-3234,1,0,0,0,Laborers,1.0,-5,C
1933,5008925,F,N,Y,0,297000.0,Commercial associate,Secondary / secondary special,Single / not married,Rented apartment,-15519,-3234,1,0,0,0,Laborers,1.0,-6,C
1934,5008925,F,N,Y,0,297000.0,Commercial associate,Secondary / secondary special,Single / not married,Rented apartment,-15519,-3234,1,0,0,0,Laborers,1.0,-7,C
1935,5008925,F,N,Y,0,297000.0,Commercial associate,Secondary / secondary special,Single / not married,Rented apartment,-15519,-3234,1,0,0,0,Laborers,1.0,-8,C
1936,5008925,F,N,Y,0,297000.0,Commercial associate,Secondary / secondary special,Single / not married,Rented apartment,-15519,-3234,1,0,0,0,Laborers,1.0,-9,C
1937,5008925,F,N,Y,0,297000.0,Commercial associate,Secondary / secondary special,Single / not married,Rented apartment,-15519,-3234,1,0,0,0,Laborers,1.0,-10,C
1938,5008925,F,N,Y,0,297000.0,Commercial associate,Secondary / secondary special,Single / not married,Rented apartment,-15519,-3234,1,0,0,0,Laborers,1.0,-11,C
1939,5008925,F,N,Y,0,297000.0,Commercial associate,Secondary / secondary special,Single / not married,Rented apartment,-15519,-3234,1,0,0,0,Laborers,1.0,-12,0
1940,5008926,F,N,Y,0,297000.0,Commercial associate,Secondary / secondary special,Single / not married,Rented apartment,-15519,-3234,1,0,0,0,Laborers,1.0,0,0
1941,5008926,F,N,Y,0,297000.0,Commercial associate,Secondary / secondary special,Single / not married,Rented apartment,-15519,-3234,1,0,0,0,Laborers,1.0,-1,0
1942,5008926,F,N,Y,0,297000.0,Commercial associate,Secondary / secondary special,Single / not married,Rented apartment,-15519,-3234,1,0,0,0,Laborers,1.0,-2,1
1943,5008926,F,N,Y,0,297000.0,Commercial associate,Secondary / secondary special,Single / not married,Rented apartment,-15519,-3234,1,0,0,0,Laborers,1.0,-3,0
1944,5008926,F,N,Y,0,297000.0,Commercial associate,Secondary / secondary special,Single / not married,Rented apartment,-15519,-3234,1,0,0,0,Laborers,1.0,-4,0
1945,5008926,F,N,Y,0,297000.0,Commercial associate,Secondary / secondary special,Single / not married,Rented apartment,-15519,-3234,1,0,0,0,Laborers,1.0,-5,0
1946,5008926,F,N,Y,0,297000.0,Commercial associate,Secondary / secondary special,Single / not married,Rented apartment,-15519,-3234,1,0,0,0,Laborers,1.0,-6,0
1947,5008926,F,N,Y,0,297000.0,Commercial associate,Secondary / secondary special,Single / not married,Rented apartment,-15519,-3234,1,0,0,0,Laborers,1.0,-7,0
1948,5008926,F,N,Y,0,297000.0,Commercial associate,Secondary / secondary special,Single / not married,Rented apartment,-15519,-3234,1,0,0,0,Laborers,1.0,-8,0
1949,5008926,F,N,Y,0,297000.0,Commercial associate,Secondary / secondary special,Single / not married,Rented apartment,-15519,-3234,1,0,0,0,Laborers,1.0,-9,0
1950,5008926,F,N,Y,0,297000.0,Commercial associate,Secondary / secondary special,Single / not married,Rented apartment,-15519,-3234,1,0,0,0,Laborers,1.0,-10,0
1951,5008926,F,N,Y,0,297000.0,Commercial associate,Secondary / secondary special,Single / not married,Rented apartment,-15519,-3234,1,0,0,0,Laborers,1.0,-11,X
1952,5008927,F,N,Y,0,297000.0,Commercial associate,Secondary / secondary special,Single / not married,Rented apartment,-15519,-3234,1,0,0,0,Laborers,1.0,0,C
1953,5008927,F,N,Y,0,297000.0,Commercial associate,Secondary / secondary special,Single / not married,Rented apartment,-15519,-3234,1,0,0,0,Laborers,1.0,-1,C
1954,5008927,F,N,Y,0,297000.0,Commercial associate,Secondary / secondary special,Single / not married,Rented apartment,-15519,-3234,1,0,0,0,Laborers,1.0,-2,C
1955,5008927,F,N,Y,0,297000.0,Commercial associate,Secondary / secondary special,Single / not married,Rented apartment,-15519,-3234,1,0,0,0,Laborers,1.0,-3,C
1956,5008927,F,N,Y,0,297000.0,Commercial associate,Secondary / secondary special,Single / not married,Rented apartment,-15519,-3234,1,0,0,0,Laborers,1.0,-4,C
1957,5008927,F,N,Y,0,297000.0,Commercial associate,Secondary / secondary special,Single / not married,Rented apartment,-15519,-3234,1,0,0,0,Laborers,1.0,-5,C
1958,5008927,F,N,Y,0,297000.0,Commercial associate,Secondary / secondary special,Single / not married,Rented apartment,-15519,-3234,1,0,0,0,Laborers,1.0,-6,C
1959,5008927,F,N,Y,0,297000.0,Commercial associate,Secondary / secondary special,Single / not married,Rented apartment,-15519,-3234,1,0,0,0,Laborers,1.0,-7,C
1960,5008927,F,N,Y,0,297000.0,Commercial associate,Secondary / secondary special,Single / not married,Rented apartment,-15519,-3234,1,0,0,0,Laborers,1.0,-8,C
1961,5008927,F,N,Y,0,297000.0,Commercial associate,Secondary / secondary special,Single / not married,Rented apartment,-15519,-3234,1,0,0,0,Laborers,1.0,-9,0
1962,5008928,F,N,Y,0,297000.0,Commercial associate,Secondary / secondary special,Single / not married,Rented apartment,-15519,-3234,1,0,0,0,Laborers,1.0,0,1
1963,5008928,F,N,Y,0,297000.0,Commercial associate,Secondary / secondary special,Single / not married,Rented apartment,-15519,-3234,1,0,0,0,Laborers,1.0,-1,0
1964,5008928,F,N,Y,0,297000.0,Commercial associate,Secondary / secondary special,Single / not married,Rented apartment,-15519,-3234,1,0,0,0,Laborers,1.0,-2,0
1965,5008928,F,N,Y,0,297000.0,Commercial associate,Secondary / secondary special,Single / not married,Rented apartment,-15519,-3234,1,0,0,0,Laborers,1.0,-3,0
1966,5008928,F,N,Y,0,297000.0,Commercial associate,Secondary / secondary special,Single / not married,Rented apartment,-15519,-3234,1,0,0,0,Laborers,1.0,-4,0
1967,5008928,F,N,Y,0,297000.0,Commercial associate,Secondary / secondary special,Single / not married,Rented apartment,-15519,-3234,1,0,0,0,Laborers,1.0,-5,0
1968,5008928,F,N,Y,0,297000.0,Commercial associate,Secondary / secondary special,Single / not married,Rented apartment,-15519,-3234,1,0,0,0,Laborers,1.0,-6,0
1969,5008928,F,N,Y,0,297000.0,Commercial associate,Secondary / secondary special,Single / not married,Rented apartment,-15519,-3234,1,0,0,0,Laborers,1.0,-7,0
1970,5008928,F,N,Y,0,297000.0,Commercial associate,Secondary / secondary special,Single / not married,Rented apartment,-15519,-3234,1,0,0,0,Laborers,1.0,-8,0
1971,5008928,F,N,Y,0,297000.0,Commercial associate,Secondary / secondary special,Single / not married,Rented apartment,-15519,-3234,1,0,0,0,Laborers,1.0,-9,X
1972,5008929,F,N,Y,0,297000.0,Commercial associate,Secondary / secondary special,Single / not married,Rented apartment,-15519,-3234,1,0,0,0,Laborers,1.0,0,C
1973,5008929,F,N,Y,0,297000.0,Commercial associate,Secondary / secondary special,Single / not married,Rented apartment,-15519,-3234,1,0,0,0,Laborers,1.0,-1,C
1974,5008929,F,N,Y,0,297000.0,Commercial associate,Secondary / secondary special,Single / not married,Rented apartment,-15519,-3234,1,0,0,0,Laborers,1.0,-2,C
1975,5008929,F,N,Y,0,297000.0,Commercial associate,Secondary / secondary special,Single / not married,Rented apartment,-15519,-3234,1,0,0,0,Laborers,1.0,-3,C
1976,5008929,F,N,Y,0,297000.0,Commercial associate,Secondary / secondary special,Single / not married,Rented apartment,-15519,-3234,1,0,0,0,Laborers,1.0,-4,C
1977,5008929,F,N,Y,0,297000.0,Commercial associate,Secondary / secondary special,Single / not married,Rented apartment,-15519,-3234,1,0,0,0,Laborers,1.0,-5,C
1978,5008929,F,N,Y,0,297000.0,Commercial associate,Secondary / secondary special,Single / not married,Rented apartment,-15519,-3234,1,0,0,0,Laborers,1.0,-6,C
1979,5008929,F,N,Y,0,297000.0,Commercial associate,Secondary / secondary special,Single / not married,Rented apartment,-15519,-3234,1,0,0,0,Laborers,1.0,-7,0
1980,5008930,F,N,Y,0,297000.0,Commercial associate,Secondary / secondary special,Single / not married,Rented apartment,-15519,-3234,1,0,0,0,Laborers,1.0,0,0
1981,5008930,F,N,Y,0,297000.0,Commercial associate,Secondary / secondary special,Single / not married,Rented apartment,-15519,-3234,1,0,0,0,Laborers,1.0,-1,0
1982,5008930,F,N,Y,0,297000.0,Commercial associate,Secondary / secondary special,Single / not married,Rented apartment,-15519,-3234,1,0,0,0,Laborers,1.0,-2,0
1983,5008930,F,N,Y,0,297000.0,Commercial associate,Secondary / secondary special,Single / not married,Rented apartment,-15519,-3234,1,0,0,0,Laborers,1.0,-3,0
1984,5008930,F,N,Y,0,297000.0,Commercial associate,Secondary / secondary special,Single / not married,Rented apartment,-15519,-3234,1,0,0,0,Laborers,1.0,-4,0
1985,5008930,F,N,Y,0,297000.0,Commercial associate,Secondary / secondary special,Single / not married,Rented apartment,-15519,-3234,1,0,0,0,Laborers,1.0,-5,0
1986,5008930,F,N,Y,0,297000.0,Commercial associate,Secondary / secondary special,Single / not married,Rented apartment,-15519,-3234,1,0,0,0,Laborers,1.0,-6,X
1987,5008931,F,N,Y,0,297000.0,Commercial associate,Secondary / secondary special,Single / not married,Rented apartment,-15519,-3234,1,0,0,0,Laborers,1.0,0,C
1988,5008931,F,N,Y,0,297000.0,Commercial associate,Secondary / secondary special,Single / not married,Rented apartment,-15519,-3234,1,0,0,0,Laborers,1.0,-1,C
1989,5008931,F,N,Y,0,297000.0,Commercial associate,Secondary / secondary special,Single / not married,Rented apartment,-15519,-3234,1,0,0,0,Laborers,1.0,-2,C
1990,5008931,F,N,Y,0,297000.0,Commercial associate,Secondary / secondary special,Single / not married,Rented apartment,-15519,-3234,1,0,0,0,Laborers,1.0,-3,C
1991,5008931,F,N,Y,0,297000.0,Commercial associate,Secondary / secondary special,Single / not married,Rented apartment,-15519,-3234,1,0,0,0,Laborers,1.0,-4,C
1992,5008931,F,N,Y,0,297000.0,Commercial associate,Secondary / secondary special,Single / not married,Rented apartment,-15519,-3234,1,0,0,0,Laborers,1.0,-5,0
1993,5008932,F,N,Y,0,297000.0,Commercial associate,Secondary / secondary special,Single / not married,Rented apartment,-15519,-3234,1,0,0,0,Laborers,1.0,0,0
1994,5008932,F,N,Y,0,297000.0,Commercial associate,Secondary / secondary special,Single / not married,Rented apartment,-15519,-3234,1,0,0,0,Laborers,1.0,-1,0
1995,5008932,F,N,Y,0,297000.0,Commercial associate,Secondary / secondary special,Single / not married,Rented apartment,-15519,-3234,1,0,0,0,Laborers,1.0,-2,0
1996,5008932,F,N,Y,0,297000.0,Commercial associate,Secondary / secondary special,Single / not married,Rented apartment,-15519,-3234,1,0,0,0,Laborers,1.0,-3,0
1997,5008932,F,N,Y,0,297000.0,Commercial associate,Secondary / secondary special,Single / not married,Rented apartment,-15519,-3234,1,0,0,0,Laborers,1.0,-4,0
1998,5008932,F,N,Y,0,297000.0,Commercial associate,Secondary / secondary special,Single / not married,Rented apartment,-15519,-3234,1,0,0,0,Laborers,1.0,-5,X
1999,5008933,F,N,Y,0,297000.0,Commercial associate,Secondary / secondary special,Single / not married,Rented apartment,-15519,-3234,1,0,0,0,Laborers,1.0,0,C
2000,5008933,F,N,Y,0,297000.0,Commercial associate,Secondary / secondary special,Single / not married,Rented apartment,-15519,-3234,1,0,0,0,Laborers,1.0,-1,C
2001,5008933,F,N,Y,0,297000.0,Commercial associate,Secondary / secondary special,Single / not married,Rented apartment,-15519,-3234,1,0,0,0,Laborers,1.0,-2,C
2002,5008933,F,N,Y,0,297000.0,Commercial associate,Secondary / secondary special,Single / not married,Rented apartment,-15519,-3234,1,0,0,0,Laborers,1.0,-3,C
2003,5008933,F,N,Y,0,297000.0,Commercial associate,Secondary / secondary special,Single / not married,Rented apartment,-15519,-3234,1,0,0,0,Laborers,1.0,-4,C
2004,5008933,F,N,Y,0,297000.0,Commercial associate,Secondary / secondary special,Single / not married,Rented apartment,-15519,-3234,1,0,0,0,Laborers,1.0,-5,0
2005,5008934,F,N,Y,0,297000.0,Commercial associate,Secondary / secondary special,Single / not married,Rented apartment,-15519,-3234,1,0,0,0,Laborers,1.0,0,C
2006,5008934,F,N,Y,0,297000.0,Commercial associate,Secondary / secondary special,Single / not married,Rented apartment,-15519,-3234,1,0,0,0,Laborers,1.0,-1,C
2007,5008934,F,N,Y,0,297000.0,Commercial associate,Secondary / secondary special,Single / not married,Rented apartment,-15519,-3234,1,0,0,0,Laborers,1.0,-2,C
2008,5008934,F,N,Y,0,297000.0,Commercial associate,Secondary / secondary special,Single / not married,Rented apartment,-15519,-3234,1,0,0,0,Laborers,1.0,-3,C
2009,5008934,F,N,Y,0,297000.0,Commercial associate,Secondary / secondary special,Single / not married,Rented apartment,-15519,-3234,1,0,0,0,Laborers,1.0,-4,C
2010,5008935,F,N,Y,0,297000.0,Commercial associate,Secondary / secondary special,Single / not married,Rented apartment,-15519,-3234,1,0,0,0,Laborers,1.0,0,C
2011,5008935,F,N,Y,0,297000.0,Commercial associate,Secondary / secondary special,Single / not married,Rented apartment,-15519,-3234,1,0,0,0,Laborers,1.0,-1,C
2012,5008935,F,N,Y,0,297000.0,Commercial associate,Secondary / secondary special,Single / not married,Rented apartment,-15519,-3234,1,0,0,0,Laborers,1.0,-2,C
2013,5008935,F,N,Y,0,297000.0,Commercial associate,Secondary / secondary special,Single / not married,Rented apartment,-15519,-3234,1,0,0,0,Laborers,1.0,-3,C
2014,5008935,F,N,Y,0,297000.0,Commercial associate,Secondary / secondary special,Single / not married,Rented apartment,-15519,-3234,1,0,0,0,Laborers,1.0,-4,0
2015,5008936,F,N,Y,0,297000.0,Commercial associate,Secondary / secondary special,Single / not married,Rented apartment,-15519,-3234,1,0,0,0,Laborers,1.0,0,C
2016,5008936,F,N,Y,0,297000.0,Commercial associate,Secondary / secondary special,Single / not married,Rented apartment,-15519,-3234,1,0,0,0,Laborers,1.0,-1,C
2017,5008936,F,N,Y,0,297000.0,Commercial associate,Secondary / secondary special,Single / not married,Rented apartment,-15519,-3234,1,0,0,0,Laborers,1.0,-2,C
2018,5008936,F,N,Y,0,297000.0,Commercial associate,Secondary / secondary special,Single / not married,Rented apartment,-15519,-3234,1,0,0,0,Laborers,1.0,-3,C
2019,5008937,F,N,Y,0,297000.0,Commercial associate,Secondary / secondary special,Single / not married,Rented apartment,-15519,-3234,1,0,0,0,Laborers,1.0,0,C
2020,5008937,F,N,Y,0,297000.0,Commercial associate,Secondary / secondary special,Single / not married,Rented apartment,-15519,-3234,1,0,0,0,Laborers,1.0,-1,0
2021,5008938,F,N,Y,0,297000.0,Commercial associate,Secondary / secondary special,Single / not married,Rented apartment,-15519,-3234,1,0,0,0,Laborers,1.0,0,C
2022,5008938,F,N,Y,0,297000.0,Commercial associate,Secondary / secondary special,Single / not married,Rented apartment,-15519,-3234,1,0,0,0,Laborers,1.0,-1,C
2023,5008939,F,N,Y,0,297000.0,Commercial associate,Secondary / secondary special,Single / not married,Rented apartment,-15519,-3234,1,0,0,0,Laborers,1.0,0,C
2024,5008940,F,N,Y,0,297000.0,Commercial associate,Secondary / secondary special,Single / not married,Rented apartment,-15519,-3234,1,0,0,0,Laborers,1.0,0,C
2025,5008940,F,N,Y,0,297000.0,Commercial associate,Secondary / secondary special,Single / not married,Rented apartment,-15519,-3234,1,0,0,0,Laborers,1.0,-1,0
2026,5008941,F,N,Y,0,297000.0,Commercial associate,Secondary / secondary special,Single / not married,Rented apartment,-15519,-3234,1,0,0,0,Laborers,1.0,0,C
2027,5008941,F,N,Y,0,297000.0,Commercial associate,Secondary / secondary special,Single / not married,Rented apartment,-15519,-3234,1,0,0,0,Laborers,1.0,-1,C
2028,5008941,F,N,Y,0,297000.0,Commercial associate,Secondary / secondary special,Single / not married,Rented apartment,-15519,-3234,1,0,0,0,Laborers,1.0,-2,C
2029,5008941,F,N,Y,0,297000.0,Commercial associate,Secondary / secondary special,Single / not married,Rented apartment,-15519,-3234,1,0,0,0,Laborers,1.0,-3,C
2030,5008941,F,N,Y,0,297000.0,Commercial associate,Secondary / secondary special,Single / not married,Rented apartment,-15519,-3234,1,0,0,0,Laborers,1.0,-4,C
2031,5008941,F,N,Y,0,297000.0,Commercial associate,Secondary / secondary special,Single / not married,Rented apartment,-15519,-3234,1,0,0,0,Laborers,1.0,-5,C
2032,5008941,F,N,Y,0,297000.0,Commercial associate,Secondary / secondary special,Single / not married,Rented apartment,-15519,-3234,1,0,0,0,Laborers,1.0,-6,C
2033,5008941,F,N,Y,0,297000.0,Commercial associate,Secondary / secondary special,Single / not married,Rented apartment,-15519,-3234,1,0,0,0,Laborers,1.0,-7,C
2034,5008942,F,N,N,0,157500.0,Commercial associate,Higher education,Married,House / apartment,-13642,-4846,1,0,1,0,High skill tech staff,2.0,-28,X
2035,5008942,F,N,N,0,157500.0,Commercial associate,Higher education,Married,House / apartment,-13642,-4846,1,0,1,0,High skill tech staff,2.0,-29,0
2036,5008942,F,N,N,0,157500.0,Commercial associate,Higher education,Married,House / apartment,-13642,-4846,1,0,1,0,High skill tech staff,2.0,-30,1
2037,5008942,F,N,N,0,157500.0,Commercial associate,Higher education,Married,House / apartment,-13642,-4846,1,0,1,0,High skill tech staff,2.0,-31,1
2038,5008942,F,N,N,0,157500.0,Commercial associate,Higher education,Married,House / apartment,-13642,-4846,1,0,1,0,High skill tech staff,2.0,-32,0
2039,5008942,F,N,N,0,157500.0,Commercial associate,Higher education,Married,House / apartment,-13642,-4846,1,0,1,0,High skill tech staff,2.0,-33,0
2040,5008942,F,N,N,0,157500.0,Commercial associate,Higher education,Married,House / apartment,-13642,-4846,1,0,1,0,High skill tech staff,2.0,-34,1
2041,5008942,F,N,N,0,157500.0,Commercial associate,Higher education,Married,House / apartment,-13642,-4846,1,0,1,0,High skill tech staff,2.0,-35,0
2042,5008942,F,N,N,0,157500.0,Commercial associate,Higher education,Married,House / apartment,-13642,-4846,1,0,1,0,High skill tech staff,2.0,-36,0
2043,5008942,F,N,N,0,157500.0,Commercial associate,Higher education,Married,House / apartment,-13642,-4846,1,0,1,0,High skill tech staff,2.0,-37,0
2044,5008942,F,N,N,0,157500.0,Commercial associate,Higher education,Married,House / apartment,-13642,-4846,1,0,1,0,High skill tech staff,2.0,-38,0
2045,5008942,F,N,N,0,157500.0,Commercial associate,Higher education,Married,House / apartment,-13642,-4846,1,0,1,0,High skill tech staff,2.0,-39,0
2046,5008942,F,N,N,0,157500.0,Commercial associate,Higher education,Married,House / apartment,-13642,-4846,1,0,1,0,High skill tech staff,2.0,-40,0
2047,5008942,F,N,N,0,157500.0,Commercial associate,Higher education,Married,House / apartment,-13642,-4846,1,0,1,0,High skill tech staff,2.0,-41,0
2048,5008942,F,N,N,0,157500.0,Commercial associate,Higher education,Married,House / apartment,-13642,-4846,1,0,1,0,High skill tech staff,2.0,-42,0
2049,5008942,F,N,N,0,157500.0,Commercial associate,Higher education,Married,House / apartment,-13642,-4846,1,0,1,0,High skill tech staff,2.0,-43,0
2050,5008943,F,N,N,0,157500.0,Commercial associate,Higher education,Married,House / apartment,-13642,-4846,1,0,1,0,High skill tech staff,2.0,0,X
2051,5008943,F,N,N,0,157500.0,Commercial associate,Higher education,Married,House / apartment,-13642,-4846,1,0,1,0,High skill tech staff,2.0,-1,X
2052,5008943,F,N,N,0,157500.0,Commercial associate,Higher education,Married,House / apartment,-13642,-4846,1,0,1,0,High skill tech staff,2.0,-2,X
2053,5008943,F,N,N,0,157500.0,Commercial associate,Higher education,Married,House / apartment,-13642,-4846,1,0,1,0,High skill tech staff,2.0,-3,X
2054,5008943,F,N,N,0,157500.0,Commercial associate,Higher education,Married,House / apartment,-13642,-4846,1,0,1,0,High skill tech staff,2.0,-4,X
2055,5008943,F,N,N,0,157500.0,Commercial associate,Higher education,Married,House / apartment,-13642,-4846,1,0,1,0,High skill tech staff,2.0,-5,X
2056,5008943,F,N,N,0,157500.0,Commercial associate,Higher education,Married,House / apartment,-13642,-4846,1,0,1,0,High skill tech staff,2.0,-6,X
2057,5008943,F,N,N,0,157500.0,Commercial associate,Higher education,Married,House / apartment,-13642,-4846,1,0,1,0,High skill tech staff,2.0,-7,X
2058,5008943,F,N,N,0,157500.0,Commercial associate,Higher education,Married,House / apartment,-13642,-4846,1,0,1,0,High skill tech staff,2.0,-8,X
2059,5008943,F,N,N,0,157500.0,Commercial associate,Higher education,Married,House / apartment,-13642,-4846,1,0,1,0,High skill tech staff,2.0,-9,X
2060,5008943,F,N,N,0,157500.0,Commercial associate,Higher education,Married,House / apartment,-13642,-4846,1,0,1,0,High skill tech staff,2.0,-10,X
2061,5008943,F,N,N,0,157500.0,Commercial associate,Higher education,Married,House / apartment,-13642,-4846,1,0,1,0,High skill tech staff,2.0,-11,X
2062,5008943,F,N,N,0,157500.0,Commercial associate,Higher education,Married,House / apartment,-13642,-4846,1,0,1,0,High skill tech staff,2.0,-12,X
2063,5008943,F,N,N,0,157500.0,Commercial associate,Higher education,Married,House / apartment,-13642,-4846,1,0,1,0,High skill tech staff,2.0,-13,X
2064,5008943,F,N,N,0,157500.0,Commercial associate,Higher education,Married,House / apartment,-13642,-4846,1,0,1,0,High skill tech staff,2.0,-14,X
2065,5008944,F,N,N,0,157500.0,Commercial associate,Higher education,Married,House / apartment,-13642,-4846,1,0,1,0,High skill tech staff,2.0,-8,X
2066,5008944,F,N,N,0,157500.0,Commercial associate,Higher education,Married,House / apartment,-13642,-4846,1,0,1,0,High skill tech staff,2.0,-9,0
2067,5008944,F,N,N,0,157500.0,Commercial associate,Higher education,Married,House / apartment,-13642,-4846,1,0,1,0,High skill tech staff,2.0,-10,1
2068,5008944,F,N,N,0,157500.0,Commercial associate,Higher education,Married,House / apartment,-13642,-4846,1,0,1,0,High skill tech staff,2.0,-11,1
2069,5008944,F,N,N,0,157500.0,Commercial associate,Higher education,Married,House / apartment,-13642,-4846,1,0,1,0,High skill tech staff,2.0,-12,0
2070,5008944,F,N,N,0,157500.0,Commercial associate,Higher education,Married,House / apartment,-13642,-4846,1,0,1,0,High skill tech staff,2.0,-13,0
2071,5008944,F,N,N,0,157500.0,Commercial associate,Higher education,Married,House / apartment,-13642,-4846,1,0,1,0,High skill tech staff,2.0,-14,1
2072,5008944,F,N,N,0,157500.0,Commercial associate,Higher education,Married,House / apartment,-13642,-4846,1,0,1,0,High skill tech staff,2.0,-15,0
2073,5008944,F,N,N,0,157500.0,Commercial associate,Higher education,Married,House / apartment,-13642,-4846,1,0,1,0,High skill tech staff,2.0,-16,0
2074,5008944,F,N,N,0,157500.0,Commercial associate,Higher education,Married,House / apartment,-13642,-4846,1,0,1,0,High skill tech staff,2.0,-17,0
2075,5008944,F,N,N,0,157500.0,Commercial associate,Higher education,Married,House / apartment,-13642,-4846,1,0,1,0,High skill tech staff,2.0,-18,0
2076,5008944,F,N,N,0,157500.0,Commercial associate,Higher education,Married,House / apartment,-13642,-4846,1,0,1,0,High skill tech staff,2.0,-19,0
2077,5008944,F,N,N,0,157500.0,Commercial associate,Higher education,Married,House / apartment,-13642,-4846,1,0,1,0,High skill tech staff,2.0,-20,0
2078,5008944,F,N,N,0,157500.0,Commercial associate,Higher education,Married,House / apartment,-13642,-4846,1,0,1,0,High skill tech staff,2.0,-21,0
2079,5008944,F,N,N,0,157500.0,Commercial associate,Higher education,Married,House / apartment,-13642,-4846,1,0,1,0,High skill tech staff,2.0,-22,0
2080,5008944,F,N,N,0,157500.0,Commercial associate,Higher education,Married,House / apartment,-13642,-4846,1,0,1,0,High skill tech staff,2.0,-23,0
2081,5008945,F,N,N,0,157500.0,Commercial associate,Higher education,Married,House / apartment,-13642,-4846,1,0,1,0,High skill tech staff,2.0,-15,X
2082,5008945,F,N,N,0,157500.0,Commercial associate,Higher education,Married,House / apartment,-13642,-4846,1,0,1,0,High skill tech staff,2.0,-16,0
2083,5008945,F,N,N,0,157500.0,Commercial associate,Higher education,Married,House / apartment,-13642,-4846,1,0,1,0,High skill tech staff,2.0,-17,1
2084,5008945,F,N,N,0,157500.0,Commercial associate,Higher education,Married,House / apartment,-13642,-4846,1,0,1,0,High skill tech staff,2.0,-18,1
2085,5008945,F,N,N,0,157500.0,Commercial associate,Higher education,Married,House / apartment,-13642,-4846,1,0,1,0,High skill tech staff,2.0,-19,0
2086,5008945,F,N,N,0,157500.0,Commercial associate,Higher education,Married,House / apartment,-13642,-4846,1,0,1,0,High skill tech staff,2.0,-20,0
2087,5008945,F,N,N,0,157500.0,Commercial associate,Higher education,Married,House / apartment,-13642,-4846,1,0,1,0,High skill tech staff,2.0,-21,1
2088,5008945,F,N,N,0,157500.0,Commercial associate,Higher education,Married,House / apartment,-13642,-4846,1,0,1,0,High skill tech staff,2.0,-22,0
2089,5008945,F,N,N,0,157500.0,Commercial associate,Higher education,Married,House / apartment,-13642,-4846,1,0,1,0,High skill tech staff,2.0,-23,0
2090,5008945,F,N,N,0,157500.0,Commercial associate,Higher education,Married,House / apartment,-13642,-4846,1,0,1,0,High skill tech staff,2.0,-24,0
2091,5008945,F,N,N,0,157500.0,Commercial associate,Higher education,Married,House / apartment,-13642,-4846,1,0,1,0,High skill tech staff,2.0,-25,0
2092,5008945,F,N,N,0,157500.0,Commercial associate,Higher education,Married,House / apartment,-13642,-4846,1,0,1,0,High skill tech staff,2.0,-26,0
2093,5008945,F,N,N,0,157500.0,Commercial associate,Higher education,Married,House / apartment,-13642,-4846,1,0,1,0,High skill tech staff,2.0,-27,0
2094,5008945,F,N,N,0,157500.0,Commercial associate,Higher education,Married,House / apartment,-13642,-4846,1,0,1,0,High skill tech staff,2.0,-28,0
2095,5008945,F,N,N,0,157500.0,Commercial associate,Higher education,Married,House / apartment,-13642,-4846,1,0,1,0,High skill tech staff,2.0,-29,0
2096,5008945,F,N,N,0,157500.0,Commercial associate,Higher education,Married,House / apartment,-13642,-4846,1,0,1,0,High skill tech staff,2.0,-30,0
2097,5008946,F,N,N,0,157500.0,Commercial associate,Higher education,Married,House / apartment,-13642,-4846,1,0,1,0,High skill tech staff,2.0,-33,X
2098,5008946,F,N,N,0,157500.0,Commercial associate,Higher education,Married,House / apartment,-13642,-4846,1,0,1,0,High skill tech staff,2.0,-34,0
2099,5008946,F,N,N,0,157500.0,Commercial associate,Higher education,Married,House / apartment,-13642,-4846,1,0,1,0,High skill tech staff,2.0,-35,1
2100,5008946,F,N,N,0,157500.0,Commercial associate,Higher education,Married,House / apartment,-13642,-4846,1,0,1,0,High skill tech staff,2.0,-36,1
2101,5008946,F,N,N,0,157500.0,Commercial associate,Higher education,Married,House / apartment,-13642,-4846,1,0,1,0,High skill tech staff,2.0,-37,0
2102,5008946,F,N,N,0,157500.0,Commercial associate,Higher education,Married,House / apartment,-13642,-4846,1,0,1,0,High skill tech staff,2.0,-38,0
2103,5008946,F,N,N,0,157500.0,Commercial associate,Higher education,Married,House / apartment,-13642,-4846,1,0,1,0,High skill tech staff,2.0,-39,1
2104,5008946,F,N,N,0,157500.0,Commercial associate,Higher education,Married,House / apartment,-13642,-4846,1,0,1,0,High skill tech staff,2.0,-40,0
2105,5008946,F,N,N,0,157500.0,Commercial associate,Higher education,Married,House / apartment,-13642,-4846,1,0,1,0,High skill tech staff,2.0,-41,0
2106,5008946,F,N,N,0,157500.0,Commercial associate,Higher education,Married,House / apartment,-13642,-4846,1,0,1,0,High skill tech staff,2.0,-42,0
2107,5008946,F,N,N,0,157500.0,Commercial associate,Higher education,Married,House / apartment,-13642,-4846,1,0,1,0,High skill tech staff,2.0,-43,0
2108,5008946,F,N,N,0,157500.0,Commercial associate,Higher education,Married,House / apartment,-13642,-4846,1,0,1,0,High skill tech staff,2.0,-44,0
2109,5008946,F,N,N,0,157500.0,Commercial associate,Higher education,Married,House / apartment,-13642,-4846,1,0,1,0,High skill tech staff,2.0,-45,0
2110,5008946,F,N,N,0,157500.0,Commercial associate,Higher education,Married,House / apartment,-13642,-4846,1,0,1,0,High skill tech staff,2.0,-46,0
2111,5008946,F,N,N,0,157500.0,Commercial associate,Higher education,Married,House / apartment,-13642,-4846,1,0,1,0,High skill tech staff,2.0,-47,0
2112,5008946,F,N,N,0,157500.0,Commercial associate,Higher education,Married,House / apartment,-13642,-4846,1,0,1,0,High skill tech staff,2.0,-48,0
2113,5008947,M,N,Y,0,135000.0,Working,Secondary / secondary special,Married,House / apartment,-15484,-1408,1,1,1,0,Drivers,2.0,0,X
2114,5008947,M,N,Y,0,135000.0,Working,Secondary / secondary special,Married,House / apartment,-15484,-1408,1,1,1,0,Drivers,2.0,-1,X
2115,5008947,M,N,Y,0,135000.0,Working,Secondary / secondary special,Married,House / apartment,-15484,-1408,1,1,1,0,Drivers,2.0,-2,X
2116,5008947,M,N,Y,0,135000.0,Working,Secondary / secondary special,Married,House / apartment,-15484,-1408,1,1,1,0,Drivers,2.0,-3,X
2117,5008947,M,N,Y,0,135000.0,Working,Secondary / secondary special,Married,House / apartment,-15484,-1408,1,1,1,0,Drivers,2.0,-4,X
2118,5008947,M,N,Y,0,135000.0,Working,Secondary / secondary special,Married,House / apartment,-15484,-1408,1,1,1,0,Drivers,2.0,-5,X
2119,5008947,M,N,Y,0,135000.0,Working,Secondary / secondary special,Married,House / apartment,-15484,-1408,1,1,1,0,Drivers,2.0,-6,X
2120,5008947,M,N,Y,0,135000.0,Working,Secondary / secondary special,Married,House / apartment,-15484,-1408,1,1,1,0,Drivers,2.0,-7,X
2121,5008947,M,N,Y,0,135000.0,Working,Secondary / secondary special,Married,House / apartment,-15484,-1408,1,1,1,0,Drivers,2.0,-8,X
2122,5008947,M,N,Y,0,135000.0,Working,Secondary / secondary special,Married,House / apartment,-15484,-1408,1,1,1,0,Drivers,2.0,-9,X
2123,5008947,M,N,Y,0,135000.0,Working,Secondary / secondary special,Married,House / apartment,-15484,-1408,1,1,1,0,Drivers,2.0,-10,X
2124,5008947,M,N,Y,0,135000.0,Working,Secondary / secondary special,Married,House / apartment,-15484,-1408,1,1,1,0,Drivers,2.0,-11,X
2125,5008947,M,N,Y,0,135000.0,Working,Secondary / secondary special,Married,House / apartment,-15484,-1408,1,1,1,0,Drivers,2.0,-12,X
2126,5008948,M,N,Y,0,135000.0,Working,Secondary / secondary special,Married,House / apartment,-15484,-1408,1,1,1,0,Drivers,2.0,-5,X
2127,5008948,M,N,Y,0,135000.0,Working,Secondary / secondary special,Married,House / apartment,-15484,-1408,1,1,1,0,Drivers,2.0,-6,X
2128,5008948,M,N,Y,0,135000.0,Working,Secondary / secondary special,Married,House / apartment,-15484,-1408,1,1,1,0,Drivers,2.0,-7,X
2129,5008948,M,N,Y,0,135000.0,Working,Secondary / secondary special,Married,House / apartment,-15484,-1408,1,1,1,0,Drivers,2.0,-8,X
2130,5008948,M,N,Y,0,135000.0,Working,Secondary / secondary special,Married,House / apartment,-15484,-1408,1,1,1,0,Drivers,2.0,-9,X
2131,5008948,M,N,Y,0,135000.0,Working,Secondary / secondary special,Married,House / apartment,-15484,-1408,1,1,1,0,Drivers,2.0,-10,X
2132,5008948,M,N,Y,0,135000.0,Working,Secondary / secondary special,Married,House / apartment,-15484,-1408,1,1,1,0,Drivers,2.0,-11,X
2133,5008948,M,N,Y,0,135000.0,Working,Secondary / secondary special,Married,House / apartment,-15484,-1408,1,1,1,0,Drivers,2.0,-12,X
2134,5008948,M,N,Y,0,135000.0,Working,Secondary / secondary special,Married,House / apartment,-15484,-1408,1,1,1,0,Drivers,2.0,-13,X
2135,5008948,M,N,Y,0,135000.0,Working,Secondary / secondary special,Married,House / apartment,-15484,-1408,1,1,1,0,Drivers,2.0,-14,X
2136,5008948,M,N,Y,0,135000.0,Working,Secondary / secondary special,Married,House / apartment,-15484,-1408,1,1,1,0,Drivers,2.0,-15,X
2137,5008948,M,N,Y,0,135000.0,Working,Secondary / secondary special,Married,House / apartment,-15484,-1408,1,1,1,0,Drivers,2.0,-16,X
2138,5008948,M,N,Y,0,135000.0,Working,Secondary / secondary special,Married,House / apartment,-15484,-1408,1,1,1,0,Drivers,2.0,-17,X
2139,5008949,M,N,Y,0,135000.0,Working,Secondary / secondary special,Married,House / apartment,-15484,-1408,1,1,1,0,Drivers,2.0,0,X
2140,5008950,M,N,Y,0,135000.0,Working,Secondary / secondary special,Married,House / apartment,-15484,-1408,1,1,1,0,Drivers,2.0,0,X
2141,5008950,M,N,Y,0,135000.0,Working,Secondary / secondary special,Married,House / apartment,-15484,-1408,1,1,1,0,Drivers,2.0,-1,X
2142,5008950,M,N,Y,0,135000.0,Working,Secondary / secondary special,Married,House / apartment,-15484,-1408,1,1,1,0,Drivers,2.0,-2,X
2143,5008950,M,N,Y,0,135000.0,Working,Secondary / secondary special,Married,House / apartment,-15484,-1408,1,1,1,0,Drivers,2.0,-3,X
2144,5008950,M,N,Y,0,135000.0,Working,Secondary / secondary special,Married,House / apartment,-15484,-1408,1,1,1,0,Drivers,2.0,-4,X
2145,5008950,M,N,Y,0,135000.0,Working,Secondary / secondary special,Married,House / apartment,-15484,-1408,1,1,1,0,Drivers,2.0,-5,X
2146,5008950,M,N,Y,0,135000.0,Working,Secondary / secondary special,Married,House / apartment,-15484,-1408,1,1,1,0,Drivers,2.0,-6,X
2147,5008950,M,N,Y,0,135000.0,Working,Secondary / secondary special,Married,House / apartment,-15484,-1408,1,1,1,0,Drivers,2.0,-7,X
2148,5008950,M,N,Y,0,135000.0,Working,Secondary / secondary special,Married,House / apartment,-15484,-1408,1,1,1,0,Drivers,2.0,-8,X
2149,5008950,M,N,Y,0,135000.0,Working,Secondary / secondary special,Married,House / apartment,-15484,-1408,1,1,1,0,Drivers,2.0,-9,X
2150,5008950,M,N,Y,0,135000.0,Working,Secondary / secondary special,Married,House / apartment,-15484,-1408,1,1,1,0,Drivers,2.0,-10,X
2151,5008950,M,N,Y,0,135000.0,Working,Secondary / secondary special,Married,House / apartment,-15484,-1408,1,1,1,0,Drivers,2.0,-11,X
2152,5008950,M,N,Y,0,135000.0,Working,Secondary / secondary special,Married,House / apartment,-15484,-1408,1,1,1,0,Drivers,2.0,-12,X
2153,5008951,M,N,Y,1,225000.0,Working,Secondary / secondary special,Married,House / apartment,-10321,-2808,1,0,0,0,,3.0,0,C
2154,5008951,M,N,Y,1,225000.0,Working,Secondary / secondary special,Married,House / apartment,-10321,-2808,1,0,0,0,,3.0,-1,C
2155,5008951,M,N,Y,1,225000.0,Working,Secondary / secondary special,Married,House / apartment,-10321,-2808,1,0,0,0,,3.0,-2,C
2156,5008951,M,N,Y,1,225000.0,Working,Secondary / secondary special,Married,House / apartment,-10321,-2808,1,0,0,0,,3.0,-3,C
2157,5008951,M,N,Y,1,225000.0,Working,Secondary / secondary special,Married,House / apartment,-10321,-2808,1,0,0,0,,3.0,-4,C
2158,5008951,M,N,Y,1,225000.0,Working,Secondary / secondary special,Married,House / apartment,-10321,-2808,1,0,0,0,,3.0,-5,C
2159,5008951,M,N,Y,1,225000.0,Working,Secondary / secondary special,Married,House / apartment,-10321,-2808,1,0,0,0,,3.0,-6,C
2160,5008951,M,N,Y,1,225000.0,Working,Secondary / secondary special,Married,House / apartment,-10321,-2808,1,0,0,0,,3.0,-7,C
2161,5008951,M,N,Y,1,225000.0,Working,Secondary / secondary special,Married,House / apartment,-10321,-2808,1,0,0,0,,3.0,-8,C
2162,5008951,M,N,Y,1,225000.0,Working,Secondary / secondary special,Married,House / apartment,-10321,-2808,1,0,0,0,,3.0,-9,C
2163,5008951,M,N,Y,1,225000.0,Working,Secondary / secondary special,Married,House / apartment,-10321,-2808,1,0,0,0,,3.0,-10,C
2164,5008951,M,N,Y,1,225000.0,Working,Secondary / secondary special,Married,House / apartment,-10321,-2808,1,0,0,0,,3.0,-11,C
2165,5008951,M,N,Y,1,225000.0,Working,Secondary / secondary special,Married,House / apartment,-10321,-2808,1,0,0,0,,3.0,-12,C
2166,5008951,M,N,Y,1,225000.0,Working,Secondary / secondary special,Married,House / apartment,-10321,-2808,1,0,0,0,,3.0,-13,C
2167,5008951,M,N,Y,1,225000.0,Working,Secondary / secondary special,Married,House / apartment,-10321,-2808,1,0,0,0,,3.0,-14,C
2168,5008951,M,N,Y,1,225000.0,Working,Secondary / secondary special,Married,House / apartment,-10321,-2808,1,0,0,0,,3.0,-15,C
2169,5008951,M,N,Y,1,225000.0,Working,Secondary / secondary special,Married,House / apartment,-10321,-2808,1,0,0,0,,3.0,-16,C
2170,5008951,M,N,Y,1,225000.0,Working,Secondary / secondary special,Married,House / apartment,-10321,-2808,1,0,0,0,,3.0,-17,C
2171,5008951,M,N,Y,1,225000.0,Working,Secondary / secondary special,Married,House / apartment,-10321,-2808,1,0,0,0,,3.0,-18,C
2172,5008951,M,N,Y,1,225000.0,Working,Secondary / secondary special,Married,House / apartment,-10321,-2808,1,0,0,0,,3.0,-19,C
2173,5008951,M,N,Y,1,225000.0,Working,Secondary / secondary special,Married,House / apartment,-10321,-2808,1,0,0,0,,3.0,-20,C
2174,5008951,M,N,Y,1,225000.0,Working,Secondary / secondary special,Married,House / apartment,-10321,-2808,1,0,0,0,,3.0,-21,C
2175,5008951,M,N,Y,1,225000.0,Working,Secondary / secondary special,Married,House / apartment,-10321,-2808,1,0,0,0,,3.0,-22,C
2176,5008951,M,N,Y,1,225000.0,Working,Secondary / secondary special,Married,House / apartment,-10321,-2808,1,0,0,0,,3.0,-23,C
2177,5008951,M,N,Y,1,225000.0,Working,Secondary / secondary special,Married,House / apartment,-10321,-2808,1,0,0,0,,3.0,-24,C
2178,5008951,M,N,Y,1,225000.0,Working,Secondary / secondary special,Married,House / apartment,-10321,-2808,1,0,0,0,,3.0,-25,C
2179,5008951,M,N,Y,1,225000.0,Working,Secondary / secondary special,Married,House / apartment,-10321,-2808,1,0,0,0,,3.0,-26,C
2180,5008951,M,N,Y,1,225000.0,Working,Secondary / secondary special,Married,House / apartment,-10321,-2808,1,0,0,0,,3.0,-27,C
2181,5008951,M,N,Y,1,225000.0,Working,Secondary / secondary special,Married,House / apartment,-10321,-2808,1,0,0,0,,3.0,-28,C
2182,5008951,M,N,Y,1,225000.0,Working,Secondary / secondary special,Married,House / apartment,-10321,-2808,1,0,0,0,,3.0,-29,C
2183,5008951,M,N,Y,1,225000.0,Working,Secondary / secondary special,Married,House / apartment,-10321,-2808,1,0,0,0,,3.0,-30,C
2184,5008951,M,N,Y,1,225000.0,Working,Secondary / secondary special,Married,House / apartment,-10321,-2808,1,0,0,0,,3.0,-31,C
2185,5008951,M,N,Y,1,225000.0,Working,Secondary / secondary special,Married,House / apartment,-10321,-2808,1,0,0,0,,3.0,-32,C
2186,5008951,M,N,Y,1,225000.0,Working,Secondary / secondary special,Married,House / apartment,-10321,-2808,1,0,0,0,,3.0,-33,C
2187,5008951,M,N,Y,1,225000.0,Working,Secondary / secondary special,Married,House / apartment,-10321,-2808,1,0,0,0,,3.0,-34,C
2188,5008951,M,N,Y,1,225000.0,Working,Secondary / secondary special,Married,House / apartment,-10321,-2808,1,0,0,0,,3.0,-35,C
2189,5008951,M,N,Y,1,225000.0,Working,Secondary / secondary special,Married,House / apartment,-10321,-2808,1,0,0,0,,3.0,-36,C
2190,5008951,M,N,Y,1,225000.0,Working,Secondary / secondary special,Married,House / apartment,-10321,-2808,1,0,0,0,,3.0,-37,C
2191,5008951,M,N,Y,1,225000.0,Working,Secondary / secondary special,Married,House / apartment,-10321,-2808,1,0,0,0,,3.0,-38,C
2192,5008951,M,N,Y,1,225000.0,Working,Secondary / secondary special,Married,House / apartment,-10321,-2808,1,0,0,0,,3.0,-39,C
2193,5008951,M,N,Y,1,225000.0,Working,Secondary / secondary special,Married,House / apartment,-10321,-2808,1,0,0,0,,3.0,-40,0
2194,5008951,M,N,Y,1,225000.0,Working,Secondary / secondary special,Married,House / apartment,-10321,-2808,1,0,0,0,,3.0,-41,0
2195,5008951,M,N,Y,1,225000.0,Working,Secondary / secondary special,Married,House / apartment,-10321,-2808,1,0,0,0,,3.0,-42,0
2196,5008951,M,N,Y,1,225000.0,Working,Secondary / secondary special,Married,House / apartment,-10321,-2808,1,0,0,0,,3.0,-43,0
2197,5008951,M,N,Y,1,225000.0,Working,Secondary / secondary special,Married,House / apartment,-10321,-2808,1,0,0,0,,3.0,-44,0
2198,5008951,M,N,Y,1,225000.0,Working,Secondary / secondary special,Married,House / apartment,-10321,-2808,1,0,0,0,,3.0,-45,0
2199,5008952,M,N,Y,1,225000.0,Working,Secondary / secondary special,Married,House / apartment,-10321,-2808,1,0,0,0,,3.0,-9,X
2200,5008952,M,N,Y,1,225000.0,Working,Secondary / secondary special,Married,House / apartment,-10321,-2808,1,0,0,0,,3.0,-10,X
2201,5008952,M,N,Y,1,225000.0,Working,Secondary / secondary special,Married,House / apartment,-10321,-2808,1,0,0,0,,3.0,-11,X
2202,5008952,M,N,Y,1,225000.0,Working,Secondary / secondary special,Married,House / apartment,-10321,-2808,1,0,0,0,,3.0,-12,X
2203,5008952,M,N,Y,1,225000.0,Working,Secondary / secondary special,Married,House / apartment,-10321,-2808,1,0,0,0,,3.0,-13,X
2204,5008952,M,N,Y,1,225000.0,Working,Secondary / secondary special,Married,House / apartment,-10321,-2808,1,0,0,0,,3.0,-14,X
2205,5008952,M,N,Y,1,225000.0,Working,Secondary / secondary special,Married,House / apartment,-10321,-2808,1,0,0,0,,3.0,-15,X
2206,5008952,M,N,Y,1,225000.0,Working,Secondary / secondary special,Married,House / apartment,-10321,-2808,1,0,0,0,,3.0,-16,X
2207,5008952,M,N,Y,1,225000.0,Working,Secondary / secondary special,Married,House / apartment,-10321,-2808,1,0,0,0,,3.0,-17,X
2208,5008952,M,N,Y,1,225000.0,Working,Secondary / secondary special,Married,House / apartment,-10321,-2808,1,0,0,0,,3.0,-18,X
2209,5008952,M,N,Y,1,225000.0,Working,Secondary / secondary special,Married,House / apartment,-10321,-2808,1,0,0,0,,3.0,-19,X
2210,5008952,M,N,Y,1,225000.0,Working,Secondary / secondary special,Married,House / apartment,-10321,-2808,1,0,0,0,,3.0,-20,X
2211,5008952,M,N,Y,1,225000.0,Working,Secondary / secondary special,Married,House / apartment,-10321,-2808,1,0,0,0,,3.0,-21,X
2212,5008952,M,N,Y,1,225000.0,Working,Secondary / secondary special,Married,House / apartment,-10321,-2808,1,0,0,0,,3.0,-22,X
2213,5008952,M,N,Y,1,225000.0,Working,Secondary / secondary special,Married,House / apartment,-10321,-2808,1,0,0,0,,3.0,-23,X
2214,5008952,M,N,Y,1,225000.0,Working,Secondary / secondary special,Married,House / apartment,-10321,-2808,1,0,0,0,,3.0,-24,X
2215,5008952,M,N,Y,1,225000.0,Working,Secondary / secondary special,Married,House / apartment,-10321,-2808,1,0,0,0,,3.0,-25,X
2216,5008952,M,N,Y,1,225000.0,Working,Secondary / secondary special,Married,House / apartment,-10321,-2808,1,0,0,0,,3.0,-26,X
2217,5008952,M,N,Y,1,225000.0,Working,Secondary / secondary special,Married,House / apartment,-10321,-2808,1,0,0,0,,3.0,-27,X
2218,5008952,M,N,Y,1,225000.0,Working,Secondary / secondary special,Married,House / apartment,-10321,-2808,1,0,0,0,,3.0,-28,X
2219,5008952,M,N,Y,1,225000.0,Working,Secondary / secondary special,Married,House / apartment,-10321,-2808,1,0,0,0,,3.0,-29,X
2220,5008952,M,N,Y,1,225000.0,Working,Secondary / secondary special,Married,House / apartment,-10321,-2808,1,0,0,0,,3.0,-30,X
2221,5008952,M,N,Y,1,225000.0,Working,Secondary / secondary special,Married,House / apartment,-10321,-2808,1,0,0,0,,3.0,-31,X
2222,5008952,M,N,Y,1,225000.0,Working,Secondary / secondary special,Married,House / apartment,-10321,-2808,1,0,0,0,,3.0,-32,X
2223,5008952,M,N,Y,1,225000.0,Working,Secondary / secondary special,Married,House / apartment,-10321,-2808,1,0,0,0,,3.0,-33,X
2224,5008952,M,N,Y,1,225000.0,Working,Secondary / secondary special,Married,House / apartment,-10321,-2808,1,0,0,0,,3.0,-34,X
2225,5008952,M,N,Y,1,225000.0,Working,Secondary / secondary special,Married,House / apartment,-10321,-2808,1,0,0,0,,3.0,-35,X
2226,5008952,M,N,Y,1,225000.0,Working,Secondary / secondary special,Married,House / apartment,-10321,-2808,1,0,0,0,,3.0,-36,X
2227,5008952,M,N,Y,1,225000.0,Working,Secondary / secondary special,Married,House / apartment,-10321,-2808,1,0,0,0,,3.0,-37,X
2228,5008952,M,N,Y,1,225000.0,Working,Secondary / secondary special,Married,House / apartment,-10321,-2808,1,0,0,0,,3.0,-38,X
2229,5008952,M,N,Y,1,225000.0,Working,Secondary / secondary special,Married,House / apartment,-10321,-2808,1,0,0,0,,3.0,-39,X
2230,5008952,M,N,Y,1,225000.0,Working,Secondary / secondary special,Married,House / apartment,-10321,-2808,1,0,0,0,,3.0,-40,X
2231,5008952,M,N,Y,1,225000.0,Working,Secondary / secondary special,Married,House / apartment,-10321,-2808,1,0,0,0,,3.0,-41,X
2232,5008952,M,N,Y,1,225000.0,Working,Secondary / secondary special,Married,House / apartment,-10321,-2808,1,0,0,0,,3.0,-42,X
2233,5008952,M,N,Y,1,225000.0,Working,Secondary / secondary special,Married,House / apartment,-10321,-2808,1,0,0,0,,3.0,-43,X
2234,5008952,M,N,Y,1,225000.0,Working,Secondary / secondary special,Married,House / apartment,-10321,-2808,1,0,0,0,,3.0,-44,X
2235,5008952,M,N,Y,1,225000.0,Working,Secondary / secondary special,Married,House / apartment,-10321,-2808,1,0,0,0,,3.0,-45,X
2236,5008952,M,N,Y,1,225000.0,Working,Secondary / secondary special,Married,House / apartment,-10321,-2808,1,0,0,0,,3.0,-46,X
2237,5008952,M,N,Y,1,225000.0,Working,Secondary / secondary special,Married,House / apartment,-10321,-2808,1,0,0,0,,3.0,-47,X
2238,5008952,M,N,Y,1,225000.0,Working,Secondary / secondary special,Married,House / apartment,-10321,-2808,1,0,0,0,,3.0,-48,X
2239,5008952,M,N,Y,1,225000.0,Working,Secondary / secondary special,Married,House / apartment,-10321,-2808,1,0,0,0,,3.0,-49,X
2240,5008952,M,N,Y,1,225000.0,Working,Secondary / secondary special,Married,House / apartment,-10321,-2808,1,0,0,0,,3.0,-50,X
2241,5008952,M,N,Y,1,225000.0,Working,Secondary / secondary special,Married,House / apartment,-10321,-2808,1,0,0,0,,3.0,-51,X
2242,5008952,M,N,Y,1,225000.0,Working,Secondary / secondary special,Married,House / apartment,-10321,-2808,1,0,0,0,,3.0,-52,X
2243,5008952,M,N,Y,1,225000.0,Working,Secondary / secondary special,Married,House / apartment,-10321,-2808,1,0,0,0,,3.0,-53,X
2244,5008952,M,N,Y,1,225000.0,Working,Secondary / secondary special,Married,House / apartment,-10321,-2808,1,0,0,0,,3.0,-54,X
2245,5008953,M,N,Y,1,225000.0,Working,Secondary / secondary special,Married,House / apartment,-10321,-2808,1,0,0,0,,3.0,0,X
2246,5008953,M,N,Y,1,225000.0,Working,Secondary / secondary special,Married,House / apartment,-10321,-2808,1,0,0,0,,3.0,-1,X
2247,5008953,M,N,Y,1,225000.0,Working,Secondary / secondary special,Married,House / apartment,-10321,-2808,1,0,0,0,,3.0,-2,X
2248,5008953,M,N,Y,1,225000.0,Working,Secondary / secondary special,Married,House / apartment,-10321,-2808,1,0,0,0,,3.0,-3,X
2249,5008953,M,N,Y,1,225000.0,Working,Secondary / secondary special,Married,House / apartment,-10321,-2808,1,0,0,0,,3.0,-4,X
2250,5008953,M,N,Y,1,225000.0,Working,Secondary / secondary special,Married,House / apartment,-10321,-2808,1,0,0,0,,3.0,-5,X
2251,5008953,M,N,Y,1,225000.0,Working,Secondary / secondary special,Married,House / apartment,-10321,-2808,1,0,0,0,,3.0,-6,X
2252,5008953,M,N,Y,1,225000.0,Working,Secondary / secondary special,Married,House / apartment,-10321,-2808,1,0,0,0,,3.0,-7,X
2253,5008953,M,N,Y,1,225000.0,Working,Secondary / secondary special,Married,House / apartment,-10321,-2808,1,0,0,0,,3.0,-8,X
2254,5008953,M,N,Y,1,225000.0,Working,Secondary / secondary special,Married,House / apartment,-10321,-2808,1,0,0,0,,3.0,-9,X
2255,5008953,M,N,Y,1,225000.0,Working,Secondary / secondary special,Married,House / apartment,-10321,-2808,1,0,0,0,,3.0,-10,X
2256,5008953,M,N,Y,1,225000.0,Working,Secondary / secondary special,Married,House / apartment,-10321,-2808,1,0,0,0,,3.0,-11,X
2257,5008953,M,N,Y,1,225000.0,Working,Secondary / secondary special,Married,House / apartment,-10321,-2808,1,0,0,0,,3.0,-12,X
2258,5008953,M,N,Y,1,225000.0,Working,Secondary / secondary special,Married,House / apartment,-10321,-2808,1,0,0,0,,3.0,-13,X
2259,5008953,M,N,Y,1,225000.0,Working,Secondary / secondary special,Married,House / apartment,-10321,-2808,1,0,0,0,,3.0,-14,X
2260,5008953,M,N,Y,1,225000.0,Working,Secondary / secondary special,Married,House / apartment,-10321,-2808,1,0,0,0,,3.0,-15,X
2261,5008953,M,N,Y,1,225000.0,Working,Secondary / secondary special,Married,House / apartment,-10321,-2808,1,0,0,0,,3.0,-16,X
2262,5008953,M,N,Y,1,225000.0,Working,Secondary / secondary special,Married,House / apartment,-10321,-2808,1,0,0,0,,3.0,-17,X
2263,5008953,M,N,Y,1,225000.0,Working,Secondary / secondary special,Married,House / apartment,-10321,-2808,1,0,0,0,,3.0,-18,X
2264,5008953,M,N,Y,1,225000.0,Working,Secondary / secondary special,Married,House / apartment,-10321,-2808,1,0,0,0,,3.0,-19,X
2265,5008953,M,N,Y,1,225000.0,Working,Secondary / secondary special,Married,House / apartment,-10321,-2808,1,0,0,0,,3.0,-20,X
2266,5008953,M,N,Y,1,225000.0,Working,Secondary / secondary special,Married,House / apartment,-10321,-2808,1,0,0,0,,3.0,-21,X
2267,5008953,M,N,Y,1,225000.0,Working,Secondary / secondary special,Married,House / apartment,-10321,-2808,1,0,0,0,,3.0,-22,X
2268,5008953,M,N,Y,1,225000.0,Working,Secondary / secondary special,Married,House / apartment,-10321,-2808,1,0,0,0,,3.0,-23,X
2269,5008953,M,N,Y,1,225000.0,Working,Secondary / secondary special,Married,House / apartment,-10321,-2808,1,0,0,0,,3.0,-24,X
2270,5008953,M,N,Y,1,225000.0,Working,Secondary / secondary special,Married,House / apartment,-10321,-2808,1,0,0,0,,3.0,-25,X
2271,5008953,M,N,Y,1,225000.0,Working,Secondary / secondary special,Married,House / apartment,-10321,-2808,1,0,0,0,,3.0,-26,X
2272,5008953,M,N,Y,1,225000.0,Working,Secondary / secondary special,Married,House / apartment,-10321,-2808,1,0,0,0,,3.0,-27,X
2273,5008954,M,N,Y,1,225000.0,Working,Secondary / secondary special,Married,House / apartment,-10321,-2808,1,0,0,0,,3.0,0,0
2274,5008954,M,N,Y,1,225000.0,Working,Secondary / secondary special,Married,House / apartment,-10321,-2808,1,0,0,0,,3.0,-1,0
2275,5008954,M,N,Y,1,225000.0,Working,Secondary / secondary special,Married,House / apartment,-10321,-2808,1,0,0,0,,3.0,-2,0
2276,5008954,M,N,Y,1,225000.0,Working,Secondary / secondary special,Married,House / apartment,-10321,-2808,1,0,0,0,,3.0,-3,0
2277,5008954,M,N,Y,1,225000.0,Working,Secondary / secondary special,Married,House / apartment,-10321,-2808,1,0,0,0,,3.0,-4,0
2278,5008954,M,N,Y,1,225000.0,Working,Secondary / secondary special,Married,House / apartment,-10321,-2808,1,0,0,0,,3.0,-5,0
2279,5008955,F,Y,Y,0,135000.0,Working,Secondary / secondary special,Married,House / apartment,-17785,-1712,1,0,0,0,Laborers,2.0,0,0
2280,5008955,F,Y,Y,0,135000.0,Working,Secondary / secondary special,Married,House / apartment,-17785,-1712,1,0,0,0,Laborers,2.0,-1,0
2281,5008955,F,Y,Y,0,135000.0,Working,Secondary / secondary special,Married,House / apartment,-17785,-1712,1,0,0,0,Laborers,2.0,-2,0
2282,5008955,F,Y,Y,0,135000.0,Working,Secondary / secondary special,Married,House / apartment,-17785,-1712,1,0,0,0,Laborers,2.0,-3,0
2283,5008955,F,Y,Y,0,135000.0,Working,Secondary / secondary special,Married,House / apartment,-17785,-1712,1,0,0,0,Laborers,2.0,-4,0
2284,5008956,F,Y,Y,0,135000.0,Working,Secondary / secondary special,Married,House / apartment,-17785,-1712,1,0,0,0,Laborers,2.0,0,C
2285,5008956,F,Y,Y,0,135000.0,Working,Secondary / secondary special,Married,House / apartment,-17785,-1712,1,0,0,0,Laborers,2.0,-1,C
2286,5008956,F,Y,Y,0,135000.0,Working,Secondary / secondary special,Married,House / apartment,-17785,-1712,1,0,0,0,Laborers,2.0,-2,C
2287,5008956,F,Y,Y,0,135000.0,Working,Secondary / secondary special,Married,House / apartment,-17785,-1712,1,0,0,0,Laborers,2.0,-3,C
2288,5008956,F,Y,Y,0,135000.0,Working,Secondary / secondary special,Married,House / apartment,-17785,-1712,1,0,0,0,Laborers,2.0,-4,C
2289,5008956,F,Y,Y,0,135000.0,Working,Secondary / secondary special,Married,House / apartment,-17785,-1712,1,0,0,0,Laborers,2.0,-5,C
2290,5008956,F,Y,Y,0,135000.0,Working,Secondary / secondary special,Married,House / apartment,-17785,-1712,1,0,0,0,Laborers,2.0,-6,C
2291,5008956,F,Y,Y,0,135000.0,Working,Secondary / secondary special,Married,House / apartment,-17785,-1712,1,0,0,0,Laborers,2.0,-7,C
2292,5008956,F,Y,Y,0,135000.0,Working,Secondary / secondary special,Married,House / apartment,-17785,-1712,1,0,0,0,Laborers,2.0,-8,C
2293,5008956,F,Y,Y,0,135000.0,Working,Secondary / secondary special,Married,House / apartment,-17785,-1712,1,0,0,0,Laborers,2.0,-9,C
2294,5008956,F,Y,Y,0,135000.0,Working,Secondary / secondary special,Married,House / apartment,-17785,-1712,1,0,0,0,Laborers,2.0,-10,C
2295,5008956,F,Y,Y,0,135000.0,Working,Secondary / secondary special,Married,House / apartment,-17785,-1712,1,0,0,0,Laborers,2.0,-11,C
2296,5008956,F,Y,Y,0,135000.0,Working,Secondary / secondary special,Married,House / apartment,-17785,-1712,1,0,0,0,Laborers,2.0,-12,C
2297,5008956,F,Y,Y,0,135000.0,Working,Secondary / secondary special,Married,House / apartment,-17785,-1712,1,0,0,0,Laborers,2.0,-13,C
2298,5008956,F,Y,Y,0,135000.0,Working,Secondary / secondary special,Married,House / apartment,-17785,-1712,1,0,0,0,Laborers,2.0,-14,C
2299,5008956,F,Y,Y,0,135000.0,Working,Secondary / secondary special,Married,House / apartment,-17785,-1712,1,0,0,0,Laborers,2.0,-15,C
2300,5008956,F,Y,Y,0,135000.0,Working,Secondary / secondary special,Married,House / apartment,-17785,-1712,1,0,0,0,Laborers,2.0,-16,C
2301,5008956,F,Y,Y,0,135000.0,Working,Secondary / secondary special,Married,House / apartment,-17785,-1712,1,0,0,0,Laborers,2.0,-17,C
2302,5008956,F,Y,Y,0,135000.0,Working,Secondary / secondary special,Married,House / apartment,-17785,-1712,1,0,0,0,Laborers,2.0,-18,C
2303,5008956,F,Y,Y,0,135000.0,Working,Secondary / secondary special,Married,House / apartment,-17785,-1712,1,0,0,0,Laborers,2.0,-19,C
2304,5008956,F,Y,Y,0,135000.0,Working,Secondary / secondary special,Married,House / apartment,-17785,-1712,1,0,0,0,Laborers,2.0,-20,C
2305,5008956,F,Y,Y,0,135000.0,Working,Secondary / secondary special,Married,House / apartment,-17785,-1712,1,0,0,0,Laborers,2.0,-21,C
2306,5008956,F,Y,Y,0,135000.0,Working,Secondary / secondary special,Married,House / apartment,-17785,-1712,1,0,0,0,Laborers,2.0,-22,C
2307,5008956,F,Y,Y,0,135000.0,Working,Secondary / secondary special,Married,House / apartment,-17785,-1712,1,0,0,0,Laborers,2.0,-23,C
2308,5008956,F,Y,Y,0,135000.0,Working,Secondary / secondary special,Married,House / apartment,-17785,-1712,1,0,0,0,Laborers,2.0,-24,C
2309,5008956,F,Y,Y,0,135000.0,Working,Secondary / secondary special,Married,House / apartment,-17785,-1712,1,0,0,0,Laborers,2.0,-25,C
2310,5008956,F,Y,Y,0,135000.0,Working,Secondary / secondary special,Married,House / apartment,-17785,-1712,1,0,0,0,Laborers,2.0,-26,C
2311,5008956,F,Y,Y,0,135000.0,Working,Secondary / secondary special,Married,House / apartment,-17785,-1712,1,0,0,0,Laborers,2.0,-27,C
2312,5008956,F,Y,Y,0,135000.0,Working,Secondary / secondary special,Married,House / apartment,-17785,-1712,1,0,0,0,Laborers,2.0,-28,C
2313,5008956,F,Y,Y,0,135000.0,Working,Secondary / secondary special,Married,House / apartment,-17785,-1712,1,0,0,0,Laborers,2.0,-29,C
2314,5008956,F,Y,Y,0,135000.0,Working,Secondary / secondary special,Married,House / apartment,-17785,-1712,1,0,0,0,Laborers,2.0,-30,C
2315,5008956,F,Y,Y,0,135000.0,Working,Secondary / secondary special,Married,House / apartment,-17785,-1712,1,0,0,0,Laborers,2.0,-31,C
2316,5008956,F,Y,Y,0,135000.0,Working,Secondary / secondary special,Married,House / apartment,-17785,-1712,1,0,0,0,Laborers,2.0,-32,C
2317,5008956,F,Y,Y,0,135000.0,Working,Secondary / secondary special,Married,House / apartment,-17785,-1712,1,0,0,0,Laborers,2.0,-33,C
2318,5008956,F,Y,Y,0,135000.0,Working,Secondary / secondary special,Married,House / apartment,-17785,-1712,1,0,0,0,Laborers,2.0,-34,C
2319,5008956,F,Y,Y,0,135000.0,Working,Secondary / secondary special,Married,House / apartment,-17785,-1712,1,0,0,0,Laborers,2.0,-35,0
2320,5008956,F,Y,Y,0,135000.0,Working,Secondary / secondary special,Married,House / apartment,-17785,-1712,1,0,0,0,Laborers,2.0,-36,0
2321,5008956,F,Y,Y,0,135000.0,Working,Secondary / secondary special,Married,House / apartment,-17785,-1712,1,0,0,0,Laborers,2.0,-37,0
2322,5008956,F,Y,Y,0,135000.0,Working,Secondary / secondary special,Married,House / apartment,-17785,-1712,1,0,0,0,Laborers,2.0,-38,0
2323,5008956,F,Y,Y,0,135000.0,Working,Secondary / secondary special,Married,House / apartment,-17785,-1712,1,0,0,0,Laborers,2.0,-39,0
2324,5008957,F,Y,Y,0,135000.0,Working,Secondary / secondary special,Married,House / apartment,-17785,-1712,1,0,0,0,Laborers,2.0,-12,C
2325,5008957,F,Y,Y,0,135000.0,Working,Secondary / secondary special,Married,House / apartment,-17785,-1712,1,0,0,0,Laborers,2.0,-13,C
2326,5008957,F,Y,Y,0,135000.0,Working,Secondary / secondary special,Married,House / apartment,-17785,-1712,1,0,0,0,Laborers,2.0,-14,C
2327,5008957,F,Y,Y,0,135000.0,Working,Secondary / secondary special,Married,House / apartment,-17785,-1712,1,0,0,0,Laborers,2.0,-15,C
2328,5008957,F,Y,Y,0,135000.0,Working,Secondary / secondary special,Married,House / apartment,-17785,-1712,1,0,0,0,Laborers,2.0,-16,C
2329,5008957,F,Y,Y,0,135000.0,Working,Secondary / secondary special,Married,House / apartment,-17785,-1712,1,0,0,0,Laborers,2.0,-17,C
2330,5008957,F,Y,Y,0,135000.0,Working,Secondary / secondary special,Married,House / apartment,-17785,-1712,1,0,0,0,Laborers,2.0,-18,C
2331,5008957,F,Y,Y,0,135000.0,Working,Secondary / secondary special,Married,House / apartment,-17785,-1712,1,0,0,0,Laborers,2.0,-19,C
2332,5008957,F,Y,Y,0,135000.0,Working,Secondary / secondary special,Married,House / apartment,-17785,-1712,1,0,0,0,Laborers,2.0,-20,C
2333,5008957,F,Y,Y,0,135000.0,Working,Secondary / secondary special,Married,House / apartment,-17785,-1712,1,0,0,0,Laborers,2.0,-21,C
2334,5008957,F,Y,Y,0,135000.0,Working,Secondary / secondary special,Married,House / apartment,-17785,-1712,1,0,0,0,Laborers,2.0,-22,C
2335,5008957,F,Y,Y,0,135000.0,Working,Secondary / secondary special,Married,House / apartment,-17785,-1712,1,0,0,0,Laborers,2.0,-23,C
2336,5008957,F,Y,Y,0,135000.0,Working,Secondary / secondary special,Married,House / apartment,-17785,-1712,1,0,0,0,Laborers,2.0,-24,C
2337,5008957,F,Y,Y,0,135000.0,Working,Secondary / secondary special,Married,House / apartment,-17785,-1712,1,0,0,0,Laborers,2.0,-25,C
2338,5008957,F,Y,Y,0,135000.0,Working,Secondary / secondary special,Married,House / apartment,-17785,-1712,1,0,0,0,Laborers,2.0,-26,C
2339,5008957,F,Y,Y,0,135000.0,Working,Secondary / secondary special,Married,House / apartment,-17785,-1712,1,0,0,0,Laborers,2.0,-27,C
2340,5008957,F,Y,Y,0,135000.0,Working,Secondary / secondary special,Married,House / apartment,-17785,-1712,1,0,0,0,Laborers,2.0,-28,C
2341,5008957,F,Y,Y,0,135000.0,Working,Secondary / secondary special,Married,House / apartment,-17785,-1712,1,0,0,0,Laborers,2.0,-29,C
2342,5008957,F,Y,Y,0,135000.0,Working,Secondary / secondary special,Married,House / apartment,-17785,-1712,1,0,0,0,Laborers,2.0,-30,C
2343,5008957,F,Y,Y,0,135000.0,Working,Secondary / secondary special,Married,House / apartment,-17785,-1712,1,0,0,0,Laborers,2.0,-31,C
2344,5008957,F,Y,Y,0,135000.0,Working,Secondary / secondary special,Married,House / apartment,-17785,-1712,1,0,0,0,Laborers,2.0,-32,C
2345,5008957,F,Y,Y,0,135000.0,Working,Secondary / secondary special,Married,House / apartment,-17785,-1712,1,0,0,0,Laborers,2.0,-33,C
2346,5008957,F,Y,Y,0,135000.0,Working,Secondary / secondary special,Married,House / apartment,-17785,-1712,1,0,0,0,Laborers,2.0,-34,C
2347,5008957,F,Y,Y,0,135000.0,Working,Secondary / secondary special,Married,House / apartment,-17785,-1712,1,0,0,0,Laborers,2.0,-35,C
2348,5008957,F,Y,Y,0,135000.0,Working,Secondary / secondary special,Married,House / apartment,-17785,-1712,1,0,0,0,Laborers,2.0,-36,C
2349,5008957,F,Y,Y,0,135000.0,Working,Secondary / secondary special,Married,House / apartment,-17785,-1712,1,0,0,0,Laborers,2.0,-37,C
2350,5008957,F,Y,Y,0,135000.0,Working,Secondary / secondary special,Married,House / apartment,-17785,-1712,1,0,0,0,Laborers,2.0,-38,C
2351,5008957,F,Y,Y,0,135000.0,Working,Secondary / secondary special,Married,House / apartment,-17785,-1712,1,0,0,0,Laborers,2.0,-39,C
2352,5008957,F,Y,Y,0,135000.0,Working,Secondary / secondary special,Married,House / apartment,-17785,-1712,1,0,0,0,Laborers,2.0,-40,C
2353,5008957,F,Y,Y,0,135000.0,Working,Secondary / secondary special,Married,House / apartment,-17785,-1712,1,0,0,0,Laborers,2.0,-41,C
2354,5008957,F,Y,Y,0,135000.0,Working,Secondary / secondary special,Married,House / apartment,-17785,-1712,1,0,0,0,Laborers,2.0,-42,C
2355,5008957,F,Y,Y,0,135000.0,Working,Secondary / secondary special,Married,House / apartment,-17785,-1712,1,0,0,0,Laborers,2.0,-43,C
2356,5008957,F,Y,Y,0,135000.0,Working,Secondary / secondary special,Married,House / apartment,-17785,-1712,1,0,0,0,Laborers,2.0,-44,C
2357,5008957,F,Y,Y,0,135000.0,Working,Secondary / secondary special,Married,House / apartment,-17785,-1712,1,0,0,0,Laborers,2.0,-45,C
2358,5008957,F,Y,Y,0,135000.0,Working,Secondary / secondary special,Married,House / apartment,-17785,-1712,1,0,0,0,Laborers,2.0,-46,C
2359,5008957,F,Y,Y,0,135000.0,Working,Secondary / secondary special,Married,House / apartment,-17785,-1712,1,0,0,0,Laborers,2.0,-47,0
2360,5008957,F,Y,Y,0,135000.0,Working,Secondary / secondary special,Married,House / apartment,-17785,-1712,1,0,0,0,Laborers,2.0,-48,0
2361,5008957,F,Y,Y,0,135000.0,Working,Secondary / secondary special,Married,House / apartment,-17785,-1712,1,0,0,0,Laborers,2.0,-49,0
2362,5008957,F,Y,Y,0,135000.0,Working,Secondary / secondary special,Married,House / apartment,-17785,-1712,1,0,0,0,Laborers,2.0,-50,0
2363,5008957,F,Y,Y,0,135000.0,Working,Secondary / secondary special,Married,House / apartment,-17785,-1712,1,0,0,0,Laborers,2.0,-51,0
2364,5008958,F,Y,Y,0,135000.0,Working,Secondary / secondary special,Married,House / apartment,-17785,-1712,1,0,0,0,Laborers,2.0,0,0
2365,5008958,F,Y,Y,0,135000.0,Working,Secondary / secondary special,Married,House / apartment,-17785,-1712,1,0,0,0,Laborers,2.0,-1,0
2366,5008958,F,Y,Y,0,135000.0,Working,Secondary / secondary special,Married,House / apartment,-17785,-1712,1,0,0,0,Laborers,2.0,-2,0
2367,5008958,F,Y,Y,0,135000.0,Working,Secondary / secondary special,Married,House / apartment,-17785,-1712,1,0,0,0,Laborers,2.0,-3,0
2368,5008959,F,Y,Y,0,135000.0,Working,Secondary / secondary special,Married,House / apartment,-17785,-1712,1,0,0,0,Laborers,2.0,0,C
2369,5008959,F,Y,Y,0,135000.0,Working,Secondary / secondary special,Married,House / apartment,-17785,-1712,1,0,0,0,Laborers,2.0,-1,C
2370,5008959,F,Y,Y,0,135000.0,Working,Secondary / secondary special,Married,House / apartment,-17785,-1712,1,0,0,0,Laborers,2.0,-2,C
2371,5008959,F,Y,Y,0,135000.0,Working,Secondary / secondary special,Married,House / apartment,-17785,-1712,1,0,0,0,Laborers,2.0,-3,C
2372,5008959,F,Y,Y,0,135000.0,Working,Secondary / secondary special,Married,House / apartment,-17785,-1712,1,0,0,0,Laborers,2.0,-4,0
2373,5008959,F,Y,Y,0,135000.0,Working,Secondary / secondary special,Married,House / apartment,-17785,-1712,1,0,0,0,Laborers,2.0,-5,0
2374,5008959,F,Y,Y,0,135000.0,Working,Secondary / secondary special,Married,House / apartment,-17785,-1712,1,0,0,0,Laborers,2.0,-6,0
2375,5008959,F,Y,Y,0,135000.0,Working,Secondary / secondary special,Married,House / apartment,-17785,-1712,1,0,0,0,Laborers,2.0,-7,0
2376,5008959,F,Y,Y,0,135000.0,Working,Secondary / secondary special,Married,House / apartment,-17785,-1712,1,0,0,0,Laborers,2.0,-8,0
2377,5008959,F,Y,Y,0,135000.0,Working,Secondary / secondary special,Married,House / apartment,-17785,-1712,1,0,0,0,Laborers,2.0,-9,0
2378,5008959,F,Y,Y,0,135000.0,Working,Secondary / secondary special,Married,House / apartment,-17785,-1712,1,0,0,0,Laborers,2.0,-10,0
2379,5008959,F,Y,Y,0,135000.0,Working,Secondary / secondary special,Married,House / apartment,-17785,-1712,1,0,0,0,Laborers,2.0,-11,0
2380,5008959,F,Y,Y,0,135000.0,Working,Secondary / secondary special,Married,House / apartment,-17785,-1712,1,0,0,0,Laborers,2.0,-12,0
2381,5008959,F,Y,Y,0,135000.0,Working,Secondary / secondary special,Married,House / apartment,-17785,-1712,1,0,0,0,Laborers,2.0,-13,0
2382,5008959,F,Y,Y,0,135000.0,Working,Secondary / secondary special,Married,House / apartment,-17785,-1712,1,0,0,0,Laborers,2.0,-14,0
2383,5008959,F,Y,Y,0,135000.0,Working,Secondary / secondary special,Married,House / apartment,-17785,-1712,1,0,0,0,Laborers,2.0,-15,0
2384,5008960,F,Y,Y,0,135000.0,Working,Secondary / secondary special,Married,House / apartment,-17785,-1712,1,0,0,0,Laborers,2.0,0,C
2385,5008960,F,Y,Y,0,135000.0,Working,Secondary / secondary special,Married,House / apartment,-17785,-1712,1,0,0,0,Laborers,2.0,-1,C
2386,5008960,F,Y,Y,0,135000.0,Working,Secondary / secondary special,Married,House / apartment,-17785,-1712,1,0,0,0,Laborers,2.0,-2,C
2387,5008960,F,Y,Y,0,135000.0,Working,Secondary / secondary special,Married,House / apartment,-17785,-1712,1,0,0,0,Laborers,2.0,-3,C
2388,5008960,F,Y,Y,0,135000.0,Working,Secondary / secondary special,Married,House / apartment,-17785,-1712,1,0,0,0,Laborers,2.0,-4,C
2389,5008960,F,Y,Y,0,135000.0,Working,Secondary / secondary special,Married,House / apartment,-17785,-1712,1,0,0,0,Laborers,2.0,-5,C
2390,5008960,F,Y,Y,0,135000.0,Working,Secondary / secondary special,Married,House / apartment,-17785,-1712,1,0,0,0,Laborers,2.0,-6,C
2391,5008960,F,Y,Y,0,135000.0,Working,Secondary / secondary special,Married,House / apartment,-17785,-1712,1,0,0,0,Laborers,2.0,-7,C
2392,5008960,F,Y,Y,0,135000.0,Working,Secondary / secondary special,Married,House / apartment,-17785,-1712,1,0,0,0,Laborers,2.0,-8,C
2393,5008960,F,Y,Y,0,135000.0,Working,Secondary / secondary special,Married,House / apartment,-17785,-1712,1,0,0,0,Laborers,2.0,-9,C
2394,5008960,F,Y,Y,0,135000.0,Working,Secondary / secondary special,Married,House / apartment,-17785,-1712,1,0,0,0,Laborers,2.0,-10,C
2395,5008960,F,Y,Y,0,135000.0,Working,Secondary / secondary special,Married,House / apartment,-17785,-1712,1,0,0,0,Laborers,2.0,-11,C
2396,5008960,F,Y,Y,0,135000.0,Working,Secondary / secondary special,Married,House / apartment,-17785,-1712,1,0,0,0,Laborers,2.0,-12,C
2397,5008960,F,Y,Y,0,135000.0,Working,Secondary / secondary special,Married,House / apartment,-17785,-1712,1,0,0,0,Laborers,2.0,-13,C
2398,5008960,F,Y,Y,0,135000.0,Working,Secondary / secondary special,Married,House / apartment,-17785,-1712,1,0,0,0,Laborers,2.0,-14,C
2399,5008960,F,Y,Y,0,135000.0,Working,Secondary / secondary special,Married,House / apartment,-17785,-1712,1,0,0,0,Laborers,2.0,-15,C
2400,5008960,F,Y,Y,0,135000.0,Working,Secondary / secondary special,Married,House / apartment,-17785,-1712,1,0,0,0,Laborers,2.0,-16,C
2401,5008960,F,Y,Y,0,135000.0,Working,Secondary / secondary special,Married,House / apartment,-17785,-1712,1,0,0,0,Laborers,2.0,-17,0
2402,5008960,F,Y,Y,0,135000.0,Working,Secondary / secondary special,Married,House / apartment,-17785,-1712,1,0,0,0,Laborers,2.0,-18,0
2403,5008960,F,Y,Y,0,135000.0,Working,Secondary / secondary special,Married,House / apartment,-17785,-1712,1,0,0,0,Laborers,2.0,-19,0
2404,5008960,F,Y,Y,0,135000.0,Working,Secondary / secondary special,Married,House / apartment,-17785,-1712,1,0,0,0,Laborers,2.0,-20,0
2405,5008960,F,Y,Y,0,135000.0,Working,Secondary / secondary special,Married,House / apartment,-17785,-1712,1,0,0,0,Laborers,2.0,-21,0
2406,5008960,F,Y,Y,0,135000.0,Working,Secondary / secondary special,Married,House / apartment,-17785,-1712,1,0,0,0,Laborers,2.0,-22,0
2407,5008960,F,Y,Y,0,135000.0,Working,Secondary / secondary special,Married,House / apartment,-17785,-1712,1,0,0,0,Laborers,2.0,-23,0
2408,5008960,F,Y,Y,0,135000.0,Working,Secondary / secondary special,Married,House / apartment,-17785,-1712,1,0,0,0,Laborers,2.0,-24,0
2409,5008960,F,Y,Y,0,135000.0,Working,Secondary / secondary special,Married,House / apartment,-17785,-1712,1,0,0,0,Laborers,2.0,-25,0
2410,5008960,F,Y,Y,0,135000.0,Working,Secondary / secondary special,Married,House / apartment,-17785,-1712,1,0,0,0,Laborers,2.0,-26,0
2411,5008960,F,Y,Y,0,135000.0,Working,Secondary / secondary special,Married,House / apartment,-17785,-1712,1,0,0,0,Laborers,2.0,-27,0
2412,5008960,F,Y,Y,0,135000.0,Working,Secondary / secondary special,Married,House / apartment,-17785,-1712,1,0,0,0,Laborers,2.0,-28,0
2413,5008962,F,Y,Y,0,135000.0,Working,Secondary / secondary special,Married,House / apartment,-17785,-1712,1,0,0,0,Laborers,2.0,0,C
2414,5008962,F,Y,Y,0,135000.0,Working,Secondary / secondary special,Married,House / apartment,-17785,-1712,1,0,0,0,Laborers,2.0,-1,C
2415,5008962,F,Y,Y,0,135000.0,Working,Secondary / secondary special,Married,House / apartment,-17785,-1712,1,0,0,0,Laborers,2.0,-2,C
2416,5008962,F,Y,Y,0,135000.0,Working,Secondary / secondary special,Married,House / apartment,-17785,-1712,1,0,0,0,Laborers,2.0,-3,C
2417,5008962,F,Y,Y,0,135000.0,Working,Secondary / secondary special,Married,House / apartment,-17785,-1712,1,0,0,0,Laborers,2.0,-4,C
2418,5008962,F,Y,Y,0,135000.0,Working,Secondary / secondary special,Married,House / apartment,-17785,-1712,1,0,0,0,Laborers,2.0,-5,C
2419,5008962,F,Y,Y,0,135000.0,Working,Secondary / secondary special,Married,House / apartment,-17785,-1712,1,0,0,0,Laborers,2.0,-6,C
2420,5008962,F,Y,Y,0,135000.0,Working,Secondary / secondary special,Married,House / apartment,-17785,-1712,1,0,0,0,Laborers,2.0,-7,C
2421,5008962,F,Y,Y,0,135000.0,Working,Secondary / secondary special,Married,House / apartment,-17785,-1712,1,0,0,0,Laborers,2.0,-8,C
2422,5008962,F,Y,Y,0,135000.0,Working,Secondary / secondary special,Married,House / apartment,-17785,-1712,1,0,0,0,Laborers,2.0,-9,C
2423,5008962,F,Y,Y,0,135000.0,Working,Secondary / secondary special,Married,House / apartment,-17785,-1712,1,0,0,0,Laborers,2.0,-10,C
2424,5008962,F,Y,Y,0,135000.0,Working,Secondary / secondary special,Married,House / apartment,-17785,-1712,1,0,0,0,Laborers,2.0,-11,C
2425,5008962,F,Y,Y,0,135000.0,Working,Secondary / secondary special,Married,House / apartment,-17785,-1712,1,0,0,0,Laborers,2.0,-12,C
2426,5008962,F,Y,Y,0,135000.0,Working,Secondary / secondary special,Married,House / apartment,-17785,-1712,1,0,0,0,Laborers,2.0,-13,C
2427,5008962,F,Y,Y,0,135000.0,Working,Secondary / secondary special,Married,House / apartment,-17785,-1712,1,0,0,0,Laborers,2.0,-14,C
2428,5008962,F,Y,Y,0,135000.0,Working,Secondary / secondary special,Married,House / apartment,-17785,-1712,1,0,0,0,Laborers,2.0,-15,C
2429,5008962,F,Y,Y,0,135000.0,Working,Secondary / secondary special,Married,House / apartment,-17785,-1712,1,0,0,0,Laborers,2.0,-16,C
2430,5008962,F,Y,Y,0,135000.0,Working,Secondary / secondary special,Married,House / apartment,-17785,-1712,1,0,0,0,Laborers,2.0,-17,0
2431,5008962,F,Y,Y,0,135000.0,Working,Secondary / secondary special,Married,House / apartment,-17785,-1712,1,0,0,0,Laborers,2.0,-18,0
2432,5008962,F,Y,Y,0,135000.0,Working,Secondary / secondary special,Married,House / apartment,-17785,-1712,1,0,0,0,Laborers,2.0,-19,0
2433,5008962,F,Y,Y,0,135000.0,Working,Secondary / secondary special,Married,House / apartment,-17785,-1712,1,0,0,0,Laborers,2.0,-20,0
2434,5008962,F,Y,Y,0,135000.0,Working,Secondary / secondary special,Married,House / apartment,-17785,-1712,1,0,0,0,Laborers,2.0,-21,0
2435,5008962,F,Y,Y,0,135000.0,Working,Secondary / secondary special,Married,House / apartment,-17785,-1712,1,0,0,0,Laborers,2.0,-22,0
2436,5008962,F,Y,Y,0,135000.0,Working,Secondary / secondary special,Married,House / apartment,-17785,-1712,1,0,0,0,Laborers,2.0,-23,0
2437,5008962,F,Y,Y,0,135000.0,Working,Secondary / secondary special,Married,House / apartment,-17785,-1712,1,0,0,0,Laborers,2.0,-24,0
2438,5008962,F,Y,Y,0,135000.0,Working,Secondary / secondary special,Married,House / apartment,-17785,-1712,1,0,0,0,Laborers,2.0,-25,0
2439,5008962,F,Y,Y,0,135000.0,Working,Secondary / secondary special,Married,House / apartment,-17785,-1712,1,0,0,0,Laborers,2.0,-26,X
2440,5008963,F,Y,Y,0,135000.0,Working,Secondary / secondary special,Married,House / apartment,-17785,-1712,1,0,0,0,Laborers,2.0,0,C
2441,5008963,F,Y,Y,0,135000.0,Working,Secondary / secondary special,Married,House / apartment,-17785,-1712,1,0,0,0,Laborers,2.0,-1,C
2442,5008963,F,Y,Y,0,135000.0,Working,Secondary / secondary special,Married,House / apartment,-17785,-1712,1,0,0,0,Laborers,2.0,-2,C
2443,5008963,F,Y,Y,0,135000.0,Working,Secondary / secondary special,Married,House / apartment,-17785,-1712,1,0,0,0,Laborers,2.0,-3,C
2444,5008963,F,Y,Y,0,135000.0,Working,Secondary / secondary special,Married,House / apartment,-17785,-1712,1,0,0,0,Laborers,2.0,-4,C
2445,5008963,F,Y,Y,0,135000.0,Working,Secondary / secondary special,Married,House / apartment,-17785,-1712,1,0,0,0,Laborers,2.0,-5,C
2446,5008963,F,Y,Y,0,135000.0,Working,Secondary / secondary special,Married,House / apartment,-17785,-1712,1,0,0,0,Laborers,2.0,-6,C
2447,5008963,F,Y,Y,0,135000.0,Working,Secondary / secondary special,Married,House / apartment,-17785,-1712,1,0,0,0,Laborers,2.0,-7,C
2448,5008963,F,Y,Y,0,135000.0,Working,Secondary / secondary special,Married,House / apartment,-17785,-1712,1,0,0,0,Laborers,2.0,-8,C
2449,5008963,F,Y,Y,0,135000.0,Working,Secondary / secondary special,Married,House / apartment,-17785,-1712,1,0,0,0,Laborers,2.0,-9,C
2450,5008963,F,Y,Y,0,135000.0,Working,Secondary / secondary special,Married,House / apartment,-17785,-1712,1,0,0,0,Laborers,2.0,-10,C
2451,5008963,F,Y,Y,0,135000.0,Working,Secondary / secondary special,Married,House / apartment,-17785,-1712,1,0,0,0,Laborers,2.0,-11,C
2452,5008963,F,Y,Y,0,135000.0,Working,Secondary / secondary special,Married,House / apartment,-17785,-1712,1,0,0,0,Laborers,2.0,-12,C
2453,5008963,F,Y,Y,0,135000.0,Working,Secondary / secondary special,Married,House / apartment,-17785,-1712,1,0,0,0,Laborers,2.0,-13,C
2454,5008963,F,Y,Y,0,135000.0,Working,Secondary / secondary special,Married,House / apartment,-17785,-1712,1,0,0,0,Laborers,2.0,-14,C
2455,5008963,F,Y,Y,0,135000.0,Working,Secondary / secondary special,Married,House / apartment,-17785,-1712,1,0,0,0,Laborers,2.0,-15,C
2456,5008963,F,Y,Y,0,135000.0,Working,Secondary / secondary special,Married,House / apartment,-17785,-1712,1,0,0,0,Laborers,2.0,-16,C
2457,5008963,F,Y,Y,0,135000.0,Working,Secondary / secondary special,Married,House / apartment,-17785,-1712,1,0,0,0,Laborers,2.0,-17,C
2458,5008963,F,Y,Y,0,135000.0,Working,Secondary / secondary special,Married,House / apartment,-17785,-1712,1,0,0,0,Laborers,2.0,-18,C
2459,5008963,F,Y,Y,0,135000.0,Working,Secondary / secondary special,Married,House / apartment,-17785,-1712,1,0,0,0,Laborers,2.0,-19,C
2460,5008963,F,Y,Y,0,135000.0,Working,Secondary / secondary special,Married,House / apartment,-17785,-1712,1,0,0,0,Laborers,2.0,-20,C
2461,5008963,F,Y,Y,0,135000.0,Working,Secondary / secondary special,Married,House / apartment,-17785,-1712,1,0,0,0,Laborers,2.0,-21,C
2462,5008963,F,Y,Y,0,135000.0,Working,Secondary / secondary special,Married,House / apartment,-17785,-1712,1,0,0,0,Laborers,2.0,-22,C
2463,5008963,F,Y,Y,0,135000.0,Working,Secondary / secondary special,Married,House / apartment,-17785,-1712,1,0,0,0,Laborers,2.0,-23,C
2464,5008963,F,Y,Y,0,135000.0,Working,Secondary / secondary special,Married,House / apartment,-17785,-1712,1,0,0,0,Laborers,2.0,-24,C
2465,5008963,F,Y,Y,0,135000.0,Working,Secondary / secondary special,Married,House / apartment,-17785,-1712,1,0,0,0,Laborers,2.0,-25,C
2466,5008963,F,Y,Y,0,135000.0,Working,Secondary / secondary special,Married,House / apartment,-17785,-1712,1,0,0,0,Laborers,2.0,-26,C
2467,5008963,F,Y,Y,0,135000.0,Working,Secondary / secondary special,Married,House / apartment,-17785,-1712,1,0,0,0,Laborers,2.0,-27,C
2468,5008963,F,Y,Y,0,135000.0,Working,Secondary / secondary special,Married,House / apartment,-17785,-1712,1,0,0,0,Laborers,2.0,-28,C
2469,5008963,F,Y,Y,0,135000.0,Working,Secondary / secondary special,Married,House / apartment,-17785,-1712,1,0,0,0,Laborers,2.0,-29,0
2470,5008963,F,Y,Y,0,135000.0,Working,Secondary / secondary special,Married,House / apartment,-17785,-1712,1,0,0,0,Laborers,2.0,-30,0
2471,5008963,F,Y,Y,0,135000.0,Working,Secondary / secondary special,Married,House / apartment,-17785,-1712,1,0,0,0,Laborers,2.0,-31,0
2472,5008963,F,Y,Y,0,135000.0,Working,Secondary / secondary special,Married,House / apartment,-17785,-1712,1,0,0,0,Laborers,2.0,-32,0
2473,5008963,F,Y,Y,0,135000.0,Working,Secondary / secondary special,Married,House / apartment,-17785,-1712,1,0,0,0,Laborers,2.0,-33,0
2474,5008963,F,Y,Y,0,135000.0,Working,Secondary / secondary special,Married,House / apartment,-17785,-1712,1,0,0,0,Laborers,2.0,-34,0
2475,5008963,F,Y,Y,0,135000.0,Working,Secondary / secondary special,Married,House / apartment,-17785,-1712,1,0,0,0,Laborers,2.0,-35,0
2476,5008963,F,Y,Y,0,135000.0,Working,Secondary / secondary special,Married,House / apartment,-17785,-1712,1,0,0,0,Laborers,2.0,-36,0
2477,5008963,F,Y,Y,0,135000.0,Working,Secondary / secondary special,Married,House / apartment,-17785,-1712,1,0,0,0,Laborers,2.0,-37,0
2478,5008963,F,Y,Y,0,135000.0,Working,Secondary / secondary special,Married,House / apartment,-17785,-1712,1,0,0,0,Laborers,2.0,-38,X
2479,5008966,M,N,Y,0,157500.0,Working,Secondary / secondary special,Married,House / apartment,-16027,-889,1,0,1,0,,2.0,0,0
2480,5008966,M,N,Y,0,157500.0,Working,Secondary / secondary special,Married,House / apartment,-16027,-889,1,0,1,0,,2.0,-1,0
2481,5008966,M,N,Y,0,157500.0,Working,Secondary / secondary special,Married,House / apartment,-16027,-889,1,0,1,0,,2.0,-2,0
2482,5008966,M,N,Y,0,157500.0,Working,Secondary / secondary special,Married,House / apartment,-16027,-889,1,0,1,0,,2.0,-3,0
2483,5008966,M,N,Y,0,157500.0,Working,Secondary / secondary special,Married,House / apartment,-16027,-889,1,0,1,0,,2.0,-4,0
2484,5008966,M,N,Y,0,157500.0,Working,Secondary / secondary special,Married,House / apartment,-16027,-889,1,0,1,0,,2.0,-5,0
2485,5008966,M,N,Y,0,157500.0,Working,Secondary / secondary special,Married,House / apartment,-16027,-889,1,0,1,0,,2.0,-6,0
2486,5008966,M,N,Y,0,157500.0,Working,Secondary / secondary special,Married,House / apartment,-16027,-889,1,0,1,0,,2.0,-7,0
2487,5008966,M,N,Y,0,157500.0,Working,Secondary / secondary special,Married,House / apartment,-16027,-889,1,0,1,0,,2.0,-8,0
2488,5008966,M,N,Y,0,157500.0,Working,Secondary / secondary special,Married,House / apartment,-16027,-889,1,0,1,0,,2.0,-9,0
2489,5008966,M,N,Y,0,157500.0,Working,Secondary / secondary special,Married,House / apartment,-16027,-889,1,0,1,0,,2.0,-10,0
2490,5008966,M,N,Y,0,157500.0,Working,Secondary / secondary special,Married,House / apartment,-16027,-889,1,0,1,0,,2.0,-11,0
2491,5008966,M,N,Y,0,157500.0,Working,Secondary / secondary special,Married,House / apartment,-16027,-889,1,0,1,0,,2.0,-12,1
2492,5008966,M,N,Y,0,157500.0,Working,Secondary / secondary special,Married,House / apartment,-16027,-889,1,0,1,0,,2.0,-13,0
2493,5008966,M,N,Y,0,157500.0,Working,Secondary / secondary special,Married,House / apartment,-16027,-889,1,0,1,0,,2.0,-14,0
2494,5008966,M,N,Y,0,157500.0,Working,Secondary / secondary special,Married,House / apartment,-16027,-889,1,0,1,0,,2.0,-15,X
2495,5008967,M,N,Y,0,157500.0,Working,Secondary / secondary special,Married,House / apartment,-16027,-889,1,0,1,0,,2.0,0,0
2496,5008967,M,N,Y,0,157500.0,Working,Secondary / secondary special,Married,House / apartment,-16027,-889,1,0,1,0,,2.0,-1,0
2497,5008967,M,N,Y,0,157500.0,Working,Secondary / secondary special,Married,House / apartment,-16027,-889,1,0,1,0,,2.0,-2,0
2498,5008967,M,N,Y,0,157500.0,Working,Secondary / secondary special,Married,House / apartment,-16027,-889,1,0,1,0,,2.0,-3,0
2499,5008967,M,N,Y,0,157500.0,Working,Secondary / secondary special,Married,House / apartment,-16027,-889,1,0,1,0,,2.0,-4,0
2500,5008967,M,N,Y,0,157500.0,Working,Secondary / secondary special,Married,House / apartment,-16027,-889,1,0,1,0,,2.0,-5,0
2501,5008967,M,N,Y,0,157500.0,Working,Secondary / secondary special,Married,House / apartment,-16027,-889,1,0,1,0,,2.0,-6,X
2502,5008967,M,N,Y,0,157500.0,Working,Secondary / secondary special,Married,House / apartment,-16027,-889,1,0,1,0,,2.0,-7,0
2503,5008967,M,N,Y,0,157500.0,Working,Secondary / secondary special,Married,House / apartment,-16027,-889,1,0,1,0,,2.0,-8,X
2504,5008967,M,N,Y,0,157500.0,Working,Secondary / secondary special,Married,House / apartment,-16027,-889,1,0,1,0,,2.0,-9,0
2505,5008967,M,N,Y,0,157500.0,Working,Secondary / secondary special,Married,House / apartment,-16027,-889,1,0,1,0,,2.0,-10,X
2506,5008967,M,N,Y,0,157500.0,Working,Secondary / secondary special,Married,House / apartment,-16027,-889,1,0,1,0,,2.0,-11,0
2507,5008967,M,N,Y,0,157500.0,Working,Secondary / secondary special,Married,House / apartment,-16027,-889,1,0,1,0,,2.0,-12,X
2508,5008967,M,N,Y,0,157500.0,Working,Secondary / secondary special,Married,House / apartment,-16027,-889,1,0,1,0,,2.0,-13,X
2509,5008967,M,N,Y,0,157500.0,Working,Secondary / secondary special,Married,House / apartment,-16027,-889,1,0,1,0,,2.0,-14,X
2510,5008967,M,N,Y,0,157500.0,Working,Secondary / secondary special,Married,House / apartment,-16027,-889,1,0,1,0,,2.0,-15,0
2511,5008967,M,N,Y,0,157500.0,Working,Secondary / secondary special,Married,House / apartment,-16027,-889,1,0,1,0,,2.0,-16,0
2512,5008967,M,N,Y,0,157500.0,Working,Secondary / secondary special,Married,House / apartment,-16027,-889,1,0,1,0,,2.0,-17,0
2513,5008967,M,N,Y,0,157500.0,Working,Secondary / secondary special,Married,House / apartment,-16027,-889,1,0,1,0,,2.0,-18,X
2514,5008967,M,N,Y,0,157500.0,Working,Secondary / secondary special,Married,House / apartment,-16027,-889,1,0,1,0,,2.0,-19,0
2515,5008967,M,N,Y,0,157500.0,Working,Secondary / secondary special,Married,House / apartment,-16027,-889,1,0,1,0,,2.0,-20,0
2516,5008967,M,N,Y,0,157500.0,Working,Secondary / secondary special,Married,House / apartment,-16027,-889,1,0,1,0,,2.0,-21,X
2517,5008971,M,N,Y,0,157500.0,Working,Secondary / secondary special,Married,House / apartment,-16027,-889,1,0,1,0,,2.0,-51,0
2518,5008971,M,N,Y,0,157500.0,Working,Secondary / secondary special,Married,House / apartment,-16027,-889,1,0,1,0,,2.0,-52,0
2519,5008971,M,N,Y,0,157500.0,Working,Secondary / secondary special,Married,House / apartment,-16027,-889,1,0,1,0,,2.0,-53,0
2520,5008971,M,N,Y,0,157500.0,Working,Secondary / secondary special,Married,House / apartment,-16027,-889,1,0,1,0,,2.0,-54,0
2521,5008971,M,N,Y,0,157500.0,Working,Secondary / secondary special,Married,House / apartment,-16027,-889,1,0,1,0,,2.0,-55,0
2522,5008973,M,N,Y,0,157500.0,Working,Secondary / secondary special,Married,House / apartment,-16027,-889,1,0,1,0,,2.0,0,0
2523,5008973,M,N,Y,0,157500.0,Working,Secondary / secondary special,Married,House / apartment,-16027,-889,1,0,1,0,,2.0,-1,0
2524,5008973,M,N,Y,0,157500.0,Working,Secondary / secondary special,Married,House / apartment,-16027,-889,1,0,1,0,,2.0,-2,0
2525,5008973,M,N,Y,0,157500.0,Working,Secondary / secondary special,Married,House / apartment,-16027,-889,1,0,1,0,,2.0,-3,0
2526,5008973,M,N,Y,0,157500.0,Working,Secondary / secondary special,Married,House / apartment,-16027,-889,1,0,1,0,,2.0,-4,0
2527,5008974,F,N,Y,0,112500.0,Pensioner,Secondary / secondary special,Married,House / apartment,-22319,365243,1,0,0,0,,2.0,-47,0
2528,5008974,F,N,Y,0,112500.0,Pensioner,Secondary / secondary special,Married,House / apartment,-22319,365243,1,0,0,0,,2.0,-48,0
2529,5008974,F,N,Y,0,112500.0,Pensioner,Secondary / secondary special,Married,House / apartment,-22319,365243,1,0,0,0,,2.0,-49,X
2530,5008975,F,N,Y,0,112500.0,Pensioner,Secondary / secondary special,Married,House / apartment,-22319,365243,1,0,0,0,,2.0,-28,X
2531,5008975,F,N,Y,0,112500.0,Pensioner,Secondary / secondary special,Married,House / apartment,-22319,365243,1,0,0,0,,2.0,-29,0
2532,5008975,F,N,Y,0,112500.0,Pensioner,Secondary / secondary special,Married,House / apartment,-22319,365243,1,0,0,0,,2.0,-30,0
2533,5008975,F,N,Y,0,112500.0,Pensioner,Secondary / secondary special,Married,House / apartment,-22319,365243,1,0,0,0,,2.0,-31,0
2534,5008975,F,N,Y,0,112500.0,Pensioner,Secondary / secondary special,Married,House / apartment,-22319,365243,1,0,0,0,,2.0,-32,0
2535,5008975,F,N,Y,0,112500.0,Pensioner,Secondary / secondary special,Married,House / apartment,-22319,365243,1,0,0,0,,2.0,-33,0
2536,5008975,F,N,Y,0,112500.0,Pensioner,Secondary / secondary special,Married,House / apartment,-22319,365243,1,0,0,0,,2.0,-34,0
2537,5008975,F,N,Y,0,112500.0,Pensioner,Secondary / secondary special,Married,House / apartment,-22319,365243,1,0,0,0,,2.0,-35,0
2538,5008975,F,N,Y,0,112500.0,Pensioner,Secondary / secondary special,Married,House / apartment,-22319,365243,1,0,0,0,,2.0,-36,1
2539,5008975,F,N,Y,0,112500.0,Pensioner,Secondary / secondary special,Married,House / apartment,-22319,365243,1,0,0,0,,2.0,-37,0
2540,5008975,F,N,Y,0,112500.0,Pensioner,Secondary / secondary special,Married,House / apartment,-22319,365243,1,0,0,0,,2.0,-38,0
2541,5008975,F,N,Y,0,112500.0,Pensioner,Secondary / secondary special,Married,House / apartment,-22319,365243,1,0,0,0,,2.0,-39,0
2542,5008975,F,N,Y,0,112500.0,Pensioner,Secondary / secondary special,Married,House / apartment,-22319,365243,1,0,0,0,,2.0,-40,0
2543,5008975,F,N,Y,0,112500.0,Pensioner,Secondary / secondary special,Married,House / apartment,-22319,365243,1,0,0,0,,2.0,-41,1
2544,5008975,F,N,Y,0,112500.0,Pensioner,Secondary / secondary special,Married,House / apartment,-22319,365243,1,0,0,0,,2.0,-42,0
2545,5008975,F,N,Y,0,112500.0,Pensioner,Secondary / secondary special,Married,House / apartment,-22319,365243,1,0,0,0,,2.0,-43,0
2546,5008975,F,N,Y,0,112500.0,Pensioner,Secondary / secondary special,Married,House / apartment,-22319,365243,1,0,0,0,,2.0,-44,0
2547,5008975,F,N,Y,0,112500.0,Pensioner,Secondary / secondary special,Married,House / apartment,-22319,365243,1,0,0,0,,2.0,-45,0
2548,5008975,F,N,Y,0,112500.0,Pensioner,Secondary / secondary special,Married,House / apartment,-22319,365243,1,0,0,0,,2.0,-46,0
2549,5008975,F,N,Y,0,112500.0,Pensioner,Secondary / secondary special,Married,House / apartment,-22319,365243,1,0,0,0,,2.0,-47,0
2550,5008975,F,N,Y,0,112500.0,Pensioner,Secondary / secondary special,Married,House / apartment,-22319,365243,1,0,0,0,,2.0,-48,0
2551,5008975,F,N,Y,0,112500.0,Pensioner,Secondary / secondary special,Married,House / apartment,-22319,365243,1,0,0,0,,2.0,-49,0
2552,5008976,F,N,Y,0,112500.0,Pensioner,Secondary / secondary special,Married,House / apartment,-22319,365243,1,0,0,0,,2.0,0,0
2553,5008976,F,N,Y,0,112500.0,Pensioner,Secondary / secondary special,Married,House / apartment,-22319,365243,1,0,0,0,,2.0,-1,0
2554,5008977,F,N,Y,0,112500.0,Pensioner,Secondary / secondary special,Married,House / apartment,-22319,365243,1,0,0,0,,2.0,0,0
2555,5008977,F,N,Y,0,112500.0,Pensioner,Secondary / secondary special,Married,House / apartment,-22319,365243,1,0,0,0,,2.0,-1,0
2556,5008977,F,N,Y,0,112500.0,Pensioner,Secondary / secondary special,Married,House / apartment,-22319,365243,1,0,0,0,,2.0,-2,0
2557,5008977,F,N,Y,0,112500.0,Pensioner,Secondary / secondary special,Married,House / apartment,-22319,365243,1,0,0,0,,2.0,-3,0
2558,5008977,F,N,Y,0,112500.0,Pensioner,Secondary / secondary special,Married,House / apartment,-22319,365243,1,0,0,0,,2.0,-4,0
2559,5008977,F,N,Y,0,112500.0,Pensioner,Secondary / secondary special,Married,House / apartment,-22319,365243,1,0,0,0,,2.0,-5,0
2560,5008977,F,N,Y,0,112500.0,Pensioner,Secondary / secondary special,Married,House / apartment,-22319,365243,1,0,0,0,,2.0,-6,0
2561,5008977,F,N,Y,0,112500.0,Pensioner,Secondary / secondary special,Married,House / apartment,-22319,365243,1,0,0,0,,2.0,-7,0
2562,5008977,F,N,Y,0,112500.0,Pensioner,Secondary / secondary special,Married,House / apartment,-22319,365243,1,0,0,0,,2.0,-8,0
2563,5008977,F,N,Y,0,112500.0,Pensioner,Secondary / secondary special,Married,House / apartment,-22319,365243,1,0,0,0,,2.0,-9,0
2564,5008977,F,N,Y,0,112500.0,Pensioner,Secondary / secondary special,Married,House / apartment,-22319,365243,1,0,0,0,,2.0,-10,0
2565,5008977,F,N,Y,0,112500.0,Pensioner,Secondary / secondary special,Married,House / apartment,-22319,365243,1,0,0,0,,2.0,-11,0
2566,5008977,F,N,Y,0,112500.0,Pensioner,Secondary / secondary special,Married,House / apartment,-22319,365243,1,0,0,0,,2.0,-12,0
2567,5008977,F,N,Y,0,112500.0,Pensioner,Secondary / secondary special,Married,House / apartment,-22319,365243,1,0,0,0,,2.0,-13,0
2568,5008977,F,N,Y,0,112500.0,Pensioner,Secondary / secondary special,Married,House / apartment,-22319,365243,1,0,0,0,,2.0,-14,0
2569,5008977,F,N,Y,0,112500.0,Pensioner,Secondary / secondary special,Married,House / apartment,-22319,365243,1,0,0,0,,2.0,-15,0
2570,5008977,F,N,Y,0,112500.0,Pensioner,Secondary / secondary special,Married,House / apartment,-22319,365243,1,0,0,0,,2.0,-16,0
2571,5008977,F,N,Y,0,112500.0,Pensioner,Secondary / secondary special,Married,House / apartment,-22319,365243,1,0,0,0,,2.0,-17,0
2572,5008977,F,N,Y,0,112500.0,Pensioner,Secondary / secondary special,Married,House / apartment,-22319,365243,1,0,0,0,,2.0,-18,0
2573,5008977,F,N,Y,0,112500.0,Pensioner,Secondary / secondary special,Married,House / apartment,-22319,365243,1,0,0,0,,2.0,-19,0
2574,5008977,F,N,Y,0,112500.0,Pensioner,Secondary / secondary special,Married,House / apartment,-22319,365243,1,0,0,0,,2.0,-20,0
2575,5008977,F,N,Y,0,112500.0,Pensioner,Secondary / secondary special,Married,House / apartment,-22319,365243,1,0,0,0,,2.0,-21,0
2576,5008977,F,N,Y,0,112500.0,Pensioner,Secondary / secondary special,Married,House / apartment,-22319,365243,1,0,0,0,,2.0,-22,0
2577,5008977,F,N,Y,0,112500.0,Pensioner,Secondary / secondary special,Married,House / apartment,-22319,365243,1,0,0,0,,2.0,-23,0
2578,5008978,F,N,Y,0,112500.0,Pensioner,Secondary / secondary special,Married,House / apartment,-22319,365243,1,0,0,0,,2.0,-17,X
2579,5008978,F,N,Y,0,112500.0,Pensioner,Secondary / secondary special,Married,House / apartment,-22319,365243,1,0,0,0,,2.0,-18,0
2580,5008978,F,N,Y,0,112500.0,Pensioner,Secondary / secondary special,Married,House / apartment,-22319,365243,1,0,0,0,,2.0,-19,0
2581,5008978,F,N,Y,0,112500.0,Pensioner,Secondary / secondary special,Married,House / apartment,-22319,365243,1,0,0,0,,2.0,-20,0
2582,5008978,F,N,Y,0,112500.0,Pensioner,Secondary / secondary special,Married,House / apartment,-22319,365243,1,0,0,0,,2.0,-21,0
2583,5008978,F,N,Y,0,112500.0,Pensioner,Secondary / secondary special,Married,House / apartment,-22319,365243,1,0,0,0,,2.0,-22,0
2584,5008978,F,N,Y,0,112500.0,Pensioner,Secondary / secondary special,Married,House / apartment,-22319,365243,1,0,0,0,,2.0,-23,0
2585,5008978,F,N,Y,0,112500.0,Pensioner,Secondary / secondary special,Married,House / apartment,-22319,365243,1,0,0,0,,2.0,-24,0
2586,5008978,F,N,Y,0,112500.0,Pensioner,Secondary / secondary special,Married,House / apartment,-22319,365243,1,0,0,0,,2.0,-25,1
2587,5008978,F,N,Y,0,112500.0,Pensioner,Secondary / secondary special,Married,House / apartment,-22319,365243,1,0,0,0,,2.0,-26,0
2588,5008978,F,N,Y,0,112500.0,Pensioner,Secondary / secondary special,Married,House / apartment,-22319,365243,1,0,0,0,,2.0,-27,0
2589,5008978,F,N,Y,0,112500.0,Pensioner,Secondary / secondary special,Married,House / apartment,-22319,365243,1,0,0,0,,2.0,-28,0
2590,5008978,F,N,Y,0,112500.0,Pensioner,Secondary / secondary special,Married,House / apartment,-22319,365243,1,0,0,0,,2.0,-29,0
2591,5008978,F,N,Y,0,112500.0,Pensioner,Secondary / secondary special,Married,House / apartment,-22319,365243,1,0,0,0,,2.0,-30,1
2592,5008978,F,N,Y,0,112500.0,Pensioner,Secondary / secondary special,Married,House / apartment,-22319,365243,1,0,0,0,,2.0,-31,0
2593,5008978,F,N,Y,0,112500.0,Pensioner,Secondary / secondary special,Married,House / apartment,-22319,365243,1,0,0,0,,2.0,-32,0
2594,5008978,F,N,Y,0,112500.0,Pensioner,Secondary / secondary special,Married,House / apartment,-22319,365243,1,0,0,0,,2.0,-33,0
2595,5008978,F,N,Y,0,112500.0,Pensioner,Secondary / secondary special,Married,House / apartment,-22319,365243,1,0,0,0,,2.0,-34,0
2596,5008978,F,N,Y,0,112500.0,Pensioner,Secondary / secondary special,Married,House / apartment,-22319,365243,1,0,0,0,,2.0,-35,0
2597,5008978,F,N,Y,0,112500.0,Pensioner,Secondary / secondary special,Married,House / apartment,-22319,365243,1,0,0,0,,2.0,-36,0
2598,5008978,F,N,Y,0,112500.0,Pensioner,Secondary / secondary special,Married,House / apartment,-22319,365243,1,0,0,0,,2.0,-37,0
2599,5008978,F,N,Y,0,112500.0,Pensioner,Secondary / secondary special,Married,House / apartment,-22319,365243,1,0,0,0,,2.0,-38,0
2600,5008979,F,N,Y,0,112500.0,Pensioner,Secondary / secondary special,Married,House / apartment,-22319,365243,1,0,0,0,,2.0,0,C
2601,5008979,F,N,Y,0,112500.0,Pensioner,Secondary / secondary special,Married,House / apartment,-22319,365243,1,0,0,0,,2.0,-1,C
2602,5008979,F,N,Y,0,112500.0,Pensioner,Secondary / secondary special,Married,House / apartment,-22319,365243,1,0,0,0,,2.0,-2,C
2603,5008979,F,N,Y,0,112500.0,Pensioner,Secondary / secondary special,Married,House / apartment,-22319,365243,1,0,0,0,,2.0,-3,C
2604,5008979,F,N,Y,0,112500.0,Pensioner,Secondary / secondary special,Married,House / apartment,-22319,365243,1,0,0,0,,2.0,-4,C
2605,5008979,F,N,Y,0,112500.0,Pensioner,Secondary / secondary special,Married,House / apartment,-22319,365243,1,0,0,0,,2.0,-5,C
2606,5008979,F,N,Y,0,112500.0,Pensioner,Secondary / secondary special,Married,House / apartment,-22319,365243,1,0,0,0,,2.0,-6,C
2607,5008979,F,N,Y,0,112500.0,Pensioner,Secondary / secondary special,Married,House / apartment,-22319,365243,1,0,0,0,,2.0,-7,C
2608,5008979,F,N,Y,0,112500.0,Pensioner,Secondary / secondary special,Married,House / apartment,-22319,365243,1,0,0,0,,2.0,-8,C
2609,5008979,F,N,Y,0,112500.0,Pensioner,Secondary / secondary special,Married,House / apartment,-22319,365243,1,0,0,0,,2.0,-9,C
2610,5008979,F,N,Y,0,112500.0,Pensioner,Secondary / secondary special,Married,House / apartment,-22319,365243,1,0,0,0,,2.0,-10,C
2611,5008979,F,N,Y,0,112500.0,Pensioner,Secondary / secondary special,Married,House / apartment,-22319,365243,1,0,0,0,,2.0,-11,C
2612,5008979,F,N,Y,0,112500.0,Pensioner,Secondary / secondary special,Married,House / apartment,-22319,365243,1,0,0,0,,2.0,-12,C
2613,5008979,F,N,Y,0,112500.0,Pensioner,Secondary / secondary special,Married,House / apartment,-22319,365243,1,0,0,0,,2.0,-13,C
2614,5008979,F,N,Y,0,112500.0,Pensioner,Secondary / secondary special,Married,House / apartment,-22319,365243,1,0,0,0,,2.0,-14,C
2615,5008979,F,N,Y,0,112500.0,Pensioner,Secondary / secondary special,Married,House / apartment,-22319,365243,1,0,0,0,,2.0,-15,C
2616,5008979,F,N,Y,0,112500.0,Pensioner,Secondary / secondary special,Married,House / apartment,-22319,365243,1,0,0,0,,2.0,-16,C
2617,5008979,F,N,Y,0,112500.0,Pensioner,Secondary / secondary special,Married,House / apartment,-22319,365243,1,0,0,0,,2.0,-17,C
2618,5008979,F,N,Y,0,112500.0,Pensioner,Secondary / secondary special,Married,House / apartment,-22319,365243,1,0,0,0,,2.0,-18,C
2619,5008979,F,N,Y,0,112500.0,Pensioner,Secondary / secondary special,Married,House / apartment,-22319,365243,1,0,0,0,,2.0,-19,C
2620,5008979,F,N,Y,0,112500.0,Pensioner,Secondary / secondary special,Married,House / apartment,-22319,365243,1,0,0,0,,2.0,-20,C
2621,5008979,F,N,Y,0,112500.0,Pensioner,Secondary / secondary special,Married,House / apartment,-22319,365243,1,0,0,0,,2.0,-21,C
2622,5008979,F,N,Y,0,112500.0,Pensioner,Secondary / secondary special,Married,House / apartment,-22319,365243,1,0,0,0,,2.0,-22,C
2623,5008979,F,N,Y,0,112500.0,Pensioner,Secondary / secondary special,Married,House / apartment,-22319,365243,1,0,0,0,,2.0,-23,C
2624,5008979,F,N,Y,0,112500.0,Pensioner,Secondary / secondary special,Married,House / apartment,-22319,365243,1,0,0,0,,2.0,-24,C
2625,5008979,F,N,Y,0,112500.0,Pensioner,Secondary / secondary special,Married,House / apartment,-22319,365243,1,0,0,0,,2.0,-25,C
2626,5008979,F,N,Y,0,112500.0,Pensioner,Secondary / secondary special,Married,House / apartment,-22319,365243,1,0,0,0,,2.0,-26,C
2627,5008979,F,N,Y,0,112500.0,Pensioner,Secondary / secondary special,Married,House / apartment,-22319,365243,1,0,0,0,,2.0,-27,C
2628,5008979,F,N,Y,0,112500.0,Pensioner,Secondary / secondary special,Married,House / apartment,-22319,365243,1,0,0,0,,2.0,-28,C
2629,5008979,F,N,Y,0,112500.0,Pensioner,Secondary / secondary special,Married,House / apartment,-22319,365243,1,0,0,0,,2.0,-29,C
2630,5008979,F,N,Y,0,112500.0,Pensioner,Secondary / secondary special,Married,House / apartment,-22319,365243,1,0,0,0,,2.0,-30,0
2631,5008979,F,N,Y,0,112500.0,Pensioner,Secondary / secondary special,Married,House / apartment,-22319,365243,1,0,0,0,,2.0,-31,0
2632,5008979,F,N,Y,0,112500.0,Pensioner,Secondary / secondary special,Married,House / apartment,-22319,365243,1,0,0,0,,2.0,-32,0
2633,5008979,F,N,Y,0,112500.0,Pensioner,Secondary / secondary special,Married,House / apartment,-22319,365243,1,0,0,0,,2.0,-33,0
2634,5008979,F,N,Y,0,112500.0,Pensioner,Secondary / secondary special,Married,House / apartment,-22319,365243,1,0,0,0,,2.0,-34,0
2635,5008979,F,N,Y,0,112500.0,Pensioner,Secondary / secondary special,Married,House / apartment,-22319,365243,1,0,0,0,,2.0,-35,0
2636,5008979,F,N,Y,0,112500.0,Pensioner,Secondary / secondary special,Married,House / apartment,-22319,365243,1,0,0,0,,2.0,-36,0
2637,5008979,F,N,Y,0,112500.0,Pensioner,Secondary / secondary special,Married,House / apartment,-22319,365243,1,0,0,0,,2.0,-37,0
2638,5008980,F,N,Y,0,112500.0,Pensioner,Secondary / secondary special,Married,House / apartment,-22319,365243,1,0,0,0,,2.0,-8,C
2639,5008980,F,N,Y,0,112500.0,Pensioner,Secondary / secondary special,Married,House / apartment,-22319,365243,1,0,0,0,,2.0,-9,C
2640,5008980,F,N,Y,0,112500.0,Pensioner,Secondary / secondary special,Married,House / apartment,-22319,365243,1,0,0,0,,2.0,-10,C
2641,5008980,F,N,Y,0,112500.0,Pensioner,Secondary / secondary special,Married,House / apartment,-22319,365243,1,0,0,0,,2.0,-11,C
2642,5008980,F,N,Y,0,112500.0,Pensioner,Secondary / secondary special,Married,House / apartment,-22319,365243,1,0,0,0,,2.0,-12,C
2643,5008980,F,N,Y,0,112500.0,Pensioner,Secondary / secondary special,Married,House / apartment,-22319,365243,1,0,0,0,,2.0,-13,C
2644,5008980,F,N,Y,0,112500.0,Pensioner,Secondary / secondary special,Married,House / apartment,-22319,365243,1,0,0,0,,2.0,-14,C
2645,5008980,F,N,Y,0,112500.0,Pensioner,Secondary / secondary special,Married,House / apartment,-22319,365243,1,0,0,0,,2.0,-15,C
2646,5008980,F,N,Y,0,112500.0,Pensioner,Secondary / secondary special,Married,House / apartment,-22319,365243,1,0,0,0,,2.0,-16,C
2647,5008980,F,N,Y,0,112500.0,Pensioner,Secondary / secondary special,Married,House / apartment,-22319,365243,1,0,0,0,,2.0,-17,C
2648,5008980,F,N,Y,0,112500.0,Pensioner,Secondary / secondary special,Married,House / apartment,-22319,365243,1,0,0,0,,2.0,-18,C
2649,5008980,F,N,Y,0,112500.0,Pensioner,Secondary / secondary special,Married,House / apartment,-22319,365243,1,0,0,0,,2.0,-19,C
2650,5008980,F,N,Y,0,112500.0,Pensioner,Secondary / secondary special,Married,House / apartment,-22319,365243,1,0,0,0,,2.0,-20,C
2651,5008980,F,N,Y,0,112500.0,Pensioner,Secondary / secondary special,Married,House / apartment,-22319,365243,1,0,0,0,,2.0,-21,C
2652,5008980,F,N,Y,0,112500.0,Pensioner,Secondary / secondary special,Married,House / apartment,-22319,365243,1,0,0,0,,2.0,-22,C
2653,5008980,F,N,Y,0,112500.0,Pensioner,Secondary / secondary special,Married,House / apartment,-22319,365243,1,0,0,0,,2.0,-23,C
2654,5008980,F,N,Y,0,112500.0,Pensioner,Secondary / secondary special,Married,House / apartment,-22319,365243,1,0,0,0,,2.0,-24,C
2655,5008980,F,N,Y,0,112500.0,Pensioner,Secondary / secondary special,Married,House / apartment,-22319,365243,1,0,0,0,,2.0,-25,C
2656,5008980,F,N,Y,0,112500.0,Pensioner,Secondary / secondary special,Married,House / apartment,-22319,365243,1,0,0,0,,2.0,-26,C
2657,5008980,F,N,Y,0,112500.0,Pensioner,Secondary / secondary special,Married,House / apartment,-22319,365243,1,0,0,0,,2.0,-27,C
2658,5008980,F,N,Y,0,112500.0,Pensioner,Secondary / secondary special,Married,House / apartment,-22319,365243,1,0,0,0,,2.0,-28,C
2659,5008980,F,N,Y,0,112500.0,Pensioner,Secondary / secondary special,Married,House / apartment,-22319,365243,1,0,0,0,,2.0,-29,C
2660,5008980,F,N,Y,0,112500.0,Pensioner,Secondary / secondary special,Married,House / apartment,-22319,365243,1,0,0,0,,2.0,-30,C
2661,5008980,F,N,Y,0,112500.0,Pensioner,Secondary / secondary special,Married,House / apartment,-22319,365243,1,0,0,0,,2.0,-31,C
2662,5008980,F,N,Y,0,112500.0,Pensioner,Secondary / secondary special,Married,House / apartment,-22319,365243,1,0,0,0,,2.0,-32,C
2663,5008980,F,N,Y,0,112500.0,Pensioner,Secondary / secondary special,Married,House / apartment,-22319,365243,1,0,0,0,,2.0,-33,C
2664,5008980,F,N,Y,0,112500.0,Pensioner,Secondary / secondary special,Married,House / apartment,-22319,365243,1,0,0,0,,2.0,-34,C
2665,5008980,F,N,Y,0,112500.0,Pensioner,Secondary / secondary special,Married,House / apartment,-22319,365243,1,0,0,0,,2.0,-35,C
2666,5008980,F,N,Y,0,112500.0,Pensioner,Secondary / secondary special,Married,House / apartment,-22319,365243,1,0,0,0,,2.0,-36,C
2667,5008980,F,N,Y,0,112500.0,Pensioner,Secondary / secondary special,Married,House / apartment,-22319,365243,1,0,0,0,,2.0,-37,C
2668,5008980,F,N,Y,0,112500.0,Pensioner,Secondary / secondary special,Married,House / apartment,-22319,365243,1,0,0,0,,2.0,-38,C
2669,5008980,F,N,Y,0,112500.0,Pensioner,Secondary / secondary special,Married,House / apartment,-22319,365243,1,0,0,0,,2.0,-39,C
2670,5008980,F,N,Y,0,112500.0,Pensioner,Secondary / secondary special,Married,House / apartment,-22319,365243,1,0,0,0,,2.0,-40,C
2671,5008980,F,N,Y,0,112500.0,Pensioner,Secondary / secondary special,Married,House / apartment,-22319,365243,1,0,0,0,,2.0,-41,0
2672,5008980,F,N,Y,0,112500.0,Pensioner,Secondary / secondary special,Married,House / apartment,-22319,365243,1,0,0,0,,2.0,-42,0
2673,5008980,F,N,Y,0,112500.0,Pensioner,Secondary / secondary special,Married,House / apartment,-22319,365243,1,0,0,0,,2.0,-43,0
2674,5008980,F,N,Y,0,112500.0,Pensioner,Secondary / secondary special,Married,House / apartment,-22319,365243,1,0,0,0,,2.0,-44,0
2675,5008980,F,N,Y,0,112500.0,Pensioner,Secondary / secondary special,Married,House / apartment,-22319,365243,1,0,0,0,,2.0,-45,0
2676,5008980,F,N,Y,0,112500.0,Pensioner,Secondary / secondary special,Married,House / apartment,-22319,365243,1,0,0,0,,2.0,-46,0
2677,5008980,F,N,Y,0,112500.0,Pensioner,Secondary / secondary special,Married,House / apartment,-22319,365243,1,0,0,0,,2.0,-47,0
2678,5008980,F,N,Y,0,112500.0,Pensioner,Secondary / secondary special,Married,House / apartment,-22319,365243,1,0,0,0,,2.0,-48,0
2679,5008980,F,N,Y,0,112500.0,Pensioner,Secondary / secondary special,Married,House / apartment,-22319,365243,1,0,0,0,,2.0,-49,0
2680,5008980,F,N,Y,0,112500.0,Pensioner,Secondary / secondary special,Married,House / apartment,-22319,365243,1,0,0,0,,2.0,-50,0
2681,5008980,F,N,Y,0,112500.0,Pensioner,Secondary / secondary special,Married,House / apartment,-22319,365243,1,0,0,0,,2.0,-51,0
2682,5008980,F,N,Y,0,112500.0,Pensioner,Secondary / secondary special,Married,House / apartment,-22319,365243,1,0,0,0,,2.0,-52,0
2683,5008980,F,N,Y,0,112500.0,Pensioner,Secondary / secondary special,Married,House / apartment,-22319,365243,1,0,0,0,,2.0,-53,0
2684,5008980,F,N,Y,0,112500.0,Pensioner,Secondary / secondary special,Married,House / apartment,-22319,365243,1,0,0,0,,2.0,-54,0
2685,5008980,F,N,Y,0,112500.0,Pensioner,Secondary / secondary special,Married,House / apartment,-22319,365243,1,0,0,0,,2.0,-55,0
2686,5008980,F,N,Y,0,112500.0,Pensioner,Secondary / secondary special,Married,House / apartment,-22319,365243,1,0,0,0,,2.0,-56,0
2687,5008980,F,N,Y,0,112500.0,Pensioner,Secondary / secondary special,Married,House / apartment,-22319,365243,1,0,0,0,,2.0,-57,0
2688,5008980,F,N,Y,0,112500.0,Pensioner,Secondary / secondary special,Married,House / apartment,-22319,365243,1,0,0,0,,2.0,-58,0
2689,5008981,M,Y,Y,0,112500.0,State servant,Secondary / secondary special,Married,House / apartment,-20874,-2381,1,0,1,0,Drivers,2.0,0,X
2690,5008981,M,Y,Y,0,112500.0,State servant,Secondary / secondary special,Married,House / apartment,-20874,-2381,1,0,1,0,Drivers,2.0,-1,X
2691,5008981,M,Y,Y,0,112500.0,State servant,Secondary / secondary special,Married,House / apartment,-20874,-2381,1,0,1,0,Drivers,2.0,-2,X
2692,5008981,M,Y,Y,0,112500.0,State servant,Secondary / secondary special,Married,House / apartment,-20874,-2381,1,0,1,0,Drivers,2.0,-3,X
2693,5008981,M,Y,Y,0,112500.0,State servant,Secondary / secondary special,Married,House / apartment,-20874,-2381,1,0,1,0,Drivers,2.0,-4,X
2694,5008981,M,Y,Y,0,112500.0,State servant,Secondary / secondary special,Married,House / apartment,-20874,-2381,1,0,1,0,Drivers,2.0,-5,X
2695,5008981,M,Y,Y,0,112500.0,State servant,Secondary / secondary special,Married,House / apartment,-20874,-2381,1,0,1,0,Drivers,2.0,-6,X
2696,5008981,M,Y,Y,0,112500.0,State servant,Secondary / secondary special,Married,House / apartment,-20874,-2381,1,0,1,0,Drivers,2.0,-7,X
2697,5008981,M,Y,Y,0,112500.0,State servant,Secondary / secondary special,Married,House / apartment,-20874,-2381,1,0,1,0,Drivers,2.0,-8,X
2698,5008981,M,Y,Y,0,112500.0,State servant,Secondary / secondary special,Married,House / apartment,-20874,-2381,1,0,1,0,Drivers,2.0,-9,X
2699,5008981,M,Y,Y,0,112500.0,State servant,Secondary / secondary special,Married,House / apartment,-20874,-2381,1,0,1,0,Drivers,2.0,-10,X
2700,5008983,M,Y,Y,0,112500.0,State servant,Secondary / secondary special,Married,House / apartment,-20874,-2381,1,0,1,0,Drivers,2.0,-47,X
2701,5008983,M,Y,Y,0,112500.0,State servant,Secondary / secondary special,Married,House / apartment,-20874,-2381,1,0,1,0,Drivers,2.0,-48,X
2702,5008983,M,Y,Y,0,112500.0,State servant,Secondary / secondary special,Married,House / apartment,-20874,-2381,1,0,1,0,Drivers,2.0,-49,X
2703,5008983,M,Y,Y,0,112500.0,State servant,Secondary / secondary special,Married,House / apartment,-20874,-2381,1,0,1,0,Drivers,2.0,-50,X
2704,5008983,M,Y,Y,0,112500.0,State servant,Secondary / secondary special,Married,House / apartment,-20874,-2381,1,0,1,0,Drivers,2.0,-51,X
2705,5008983,M,Y,Y,0,112500.0,State servant,Secondary / secondary special,Married,House / apartment,-20874,-2381,1,0,1,0,Drivers,2.0,-52,X
2706,5008983,M,Y,Y,0,112500.0,State servant,Secondary / secondary special,Married,House / apartment,-20874,-2381,1,0,1,0,Drivers,2.0,-53,X
2707,5008983,M,Y,Y,0,112500.0,State servant,Secondary / secondary special,Married,House / apartment,-20874,-2381,1,0,1,0,Drivers,2.0,-54,X
2708,5008983,M,Y,Y,0,112500.0,State servant,Secondary / secondary special,Married,House / apartment,-20874,-2381,1,0,1,0,Drivers,2.0,-55,X
2709,5008983,M,Y,Y,0,112500.0,State servant,Secondary / secondary special,Married,House / apartment,-20874,-2381,1,0,1,0,Drivers,2.0,-56,X
2710,5008983,M,Y,Y,0,112500.0,State servant,Secondary / secondary special,Married,House / apartment,-20874,-2381,1,0,1,0,Drivers,2.0,-57,X
2711,5008983,M,Y,Y,0,112500.0,State servant,Secondary / secondary special,Married,House / apartment,-20874,-2381,1,0,1,0,Drivers,2.0,-58,X
2712,5008984,M,Y,Y,0,112500.0,State servant,Secondary / secondary special,Married,House / apartment,-20874,-2381,1,0,1,0,Drivers,2.0,0,C
2713,5008984,M,Y,Y,0,112500.0,State servant,Secondary / secondary special,Married,House / apartment,-20874,-2381,1,0,1,0,Drivers,2.0,-1,C
2714,5008984,M,Y,Y,0,112500.0,State servant,Secondary / secondary special,Married,House / apartment,-20874,-2381,1,0,1,0,Drivers,2.0,-2,C
2715,5008984,M,Y,Y,0,112500.0,State servant,Secondary / secondary special,Married,House / apartment,-20874,-2381,1,0,1,0,Drivers,2.0,-3,X
2716,5008984,M,Y,Y,0,112500.0,State servant,Secondary / secondary special,Married,House / apartment,-20874,-2381,1,0,1,0,Drivers,2.0,-4,X
2717,5008984,M,Y,Y,0,112500.0,State servant,Secondary / secondary special,Married,House / apartment,-20874,-2381,1,0,1,0,Drivers,2.0,-5,X
2718,5008984,M,Y,Y,0,112500.0,State servant,Secondary / secondary special,Married,House / apartment,-20874,-2381,1,0,1,0,Drivers,2.0,-6,X
2719,5008984,M,Y,Y,0,112500.0,State servant,Secondary / secondary special,Married,House / apartment,-20874,-2381,1,0,1,0,Drivers,2.0,-7,X
2720,5008984,M,Y,Y,0,112500.0,State servant,Secondary / secondary special,Married,House / apartment,-20874,-2381,1,0,1,0,Drivers,2.0,-8,X
2721,5008984,M,Y,Y,0,112500.0,State servant,Secondary / secondary special,Married,House / apartment,-20874,-2381,1,0,1,0,Drivers,2.0,-9,X
2722,5008984,M,Y,Y,0,112500.0,State servant,Secondary / secondary special,Married,House / apartment,-20874,-2381,1,0,1,0,Drivers,2.0,-10,X
2723,5008984,M,Y,Y,0,112500.0,State servant,Secondary / secondary special,Married,House / apartment,-20874,-2381,1,0,1,0,Drivers,2.0,-11,X
2724,5008984,M,Y,Y,0,112500.0,State servant,Secondary / secondary special,Married,House / apartment,-20874,-2381,1,0,1,0,Drivers,2.0,-12,X
2725,5008984,M,Y,Y,0,112500.0,State servant,Secondary / secondary special,Married,House / apartment,-20874,-2381,1,0,1,0,Drivers,2.0,-13,X
2726,5008984,M,Y,Y,0,112500.0,State servant,Secondary / secondary special,Married,House / apartment,-20874,-2381,1,0,1,0,Drivers,2.0,-14,X
2727,5008984,M,Y,Y,0,112500.0,State servant,Secondary / secondary special,Married,House / apartment,-20874,-2381,1,0,1,0,Drivers,2.0,-15,X
2728,5008984,M,Y,Y,0,112500.0,State servant,Secondary / secondary special,Married,House / apartment,-20874,-2381,1,0,1,0,Drivers,2.0,-16,X
2729,5008984,M,Y,Y,0,112500.0,State servant,Secondary / secondary special,Married,House / apartment,-20874,-2381,1,0,1,0,Drivers,2.0,-17,X
2730,5008984,M,Y,Y,0,112500.0,State servant,Secondary / secondary special,Married,House / apartment,-20874,-2381,1,0,1,0,Drivers,2.0,-18,X
2731,5008984,M,Y,Y,0,112500.0,State servant,Secondary / secondary special,Married,House / apartment,-20874,-2381,1,0,1,0,Drivers,2.0,-19,X
2732,5008984,M,Y,Y,0,112500.0,State servant,Secondary / secondary special,Married,House / apartment,-20874,-2381,1,0,1,0,Drivers,2.0,-20,X
2733,5008984,M,Y,Y,0,112500.0,State servant,Secondary / secondary special,Married,House / apartment,-20874,-2381,1,0,1,0,Drivers,2.0,-21,X
2734,5008984,M,Y,Y,0,112500.0,State servant,Secondary / secondary special,Married,House / apartment,-20874,-2381,1,0,1,0,Drivers,2.0,-22,X
2735,5008984,M,Y,Y,0,112500.0,State servant,Secondary / secondary special,Married,House / apartment,-20874,-2381,1,0,1,0,Drivers,2.0,-23,X
2736,5008984,M,Y,Y,0,112500.0,State servant,Secondary / secondary special,Married,House / apartment,-20874,-2381,1,0,1,0,Drivers,2.0,-24,X
2737,5008984,M,Y,Y,0,112500.0,State servant,Secondary / secondary special,Married,House / apartment,-20874,-2381,1,0,1,0,Drivers,2.0,-25,X
2738,5008984,M,Y,Y,0,112500.0,State servant,Secondary / secondary special,Married,House / apartment,-20874,-2381,1,0,1,0,Drivers,2.0,-26,X
2739,5008984,M,Y,Y,0,112500.0,State servant,Secondary / secondary special,Married,House / apartment,-20874,-2381,1,0,1,0,Drivers,2.0,-27,X
2740,5008984,M,Y,Y,0,112500.0,State servant,Secondary / secondary special,Married,House / apartment,-20874,-2381,1,0,1,0,Drivers,2.0,-28,X
2741,5008984,M,Y,Y,0,112500.0,State servant,Secondary / secondary special,Married,House / apartment,-20874,-2381,1,0,1,0,Drivers,2.0,-29,X
2742,5008984,M,Y,Y,0,112500.0,State servant,Secondary / secondary special,Married,House / apartment,-20874,-2381,1,0,1,0,Drivers,2.0,-30,X
2743,5008984,M,Y,Y,0,112500.0,State servant,Secondary / secondary special,Married,House / apartment,-20874,-2381,1,0,1,0,Drivers,2.0,-31,X
2744,5008984,M,Y,Y,0,112500.0,State servant,Secondary / secondary special,Married,House / apartment,-20874,-2381,1,0,1,0,Drivers,2.0,-32,X
2745,5008984,M,Y,Y,0,112500.0,State servant,Secondary / secondary special,Married,House / apartment,-20874,-2381,1,0,1,0,Drivers,2.0,-33,X
2746,5008984,M,Y,Y,0,112500.0,State servant,Secondary / secondary special,Married,House / apartment,-20874,-2381,1,0,1,0,Drivers,2.0,-34,X
2747,5008984,M,Y,Y,0,112500.0,State servant,Secondary / secondary special,Married,House / apartment,-20874,-2381,1,0,1,0,Drivers,2.0,-35,X
2748,5008984,M,Y,Y,0,112500.0,State servant,Secondary / secondary special,Married,House / apartment,-20874,-2381,1,0,1,0,Drivers,2.0,-36,X
2749,5008984,M,Y,Y,0,112500.0,State servant,Secondary / secondary special,Married,House / apartment,-20874,-2381,1,0,1,0,Drivers,2.0,-37,X
2750,5008984,M,Y,Y,0,112500.0,State servant,Secondary / secondary special,Married,House / apartment,-20874,-2381,1,0,1,0,Drivers,2.0,-38,X
2751,5008984,M,Y,Y,0,112500.0,State servant,Secondary / secondary special,Married,House / apartment,-20874,-2381,1,0,1,0,Drivers,2.0,-39,X
2752,5008984,M,Y,Y,0,112500.0,State servant,Secondary / secondary special,Married,House / apartment,-20874,-2381,1,0,1,0,Drivers,2.0,-40,X
2753,5008984,M,Y,Y,0,112500.0,State servant,Secondary / secondary special,Married,House / apartment,-20874,-2381,1,0,1,0,Drivers,2.0,-41,X
2754,5008984,M,Y,Y,0,112500.0,State servant,Secondary / secondary special,Married,House / apartment,-20874,-2381,1,0,1,0,Drivers,2.0,-42,X
2755,5008984,M,Y,Y,0,112500.0,State servant,Secondary / secondary special,Married,House / apartment,-20874,-2381,1,0,1,0,Drivers,2.0,-43,X
2756,5008984,M,Y,Y,0,112500.0,State servant,Secondary / secondary special,Married,House / apartment,-20874,-2381,1,0,1,0,Drivers,2.0,-44,X
2757,5008984,M,Y,Y,0,112500.0,State servant,Secondary / secondary special,Married,House / apartment,-20874,-2381,1,0,1,0,Drivers,2.0,-45,X
2758,5008984,M,Y,Y,0,112500.0,State servant,Secondary / secondary special,Married,House / apartment,-20874,-2381,1,0,1,0,Drivers,2.0,-46,X
2759,5008984,M,Y,Y,0,112500.0,State servant,Secondary / secondary special,Married,House / apartment,-20874,-2381,1,0,1,0,Drivers,2.0,-47,X
2760,5008984,M,Y,Y,0,112500.0,State servant,Secondary / secondary special,Married,House / apartment,-20874,-2381,1,0,1,0,Drivers,2.0,-48,X
2761,5008984,M,Y,Y,0,112500.0,State servant,Secondary / secondary special,Married,House / apartment,-20874,-2381,1,0,1,0,Drivers,2.0,-49,X
2762,5008984,M,Y,Y,0,112500.0,State servant,Secondary / secondary special,Married,House / apartment,-20874,-2381,1,0,1,0,Drivers,2.0,-50,X
2763,5008984,M,Y,Y,0,112500.0,State servant,Secondary / secondary special,Married,House / apartment,-20874,-2381,1,0,1,0,Drivers,2.0,-51,X
2764,5008984,M,Y,Y,0,112500.0,State servant,Secondary / secondary special,Married,House / apartment,-20874,-2381,1,0,1,0,Drivers,2.0,-52,X
2765,5008984,M,Y,Y,0,112500.0,State servant,Secondary / secondary special,Married,House / apartment,-20874,-2381,1,0,1,0,Drivers,2.0,-53,X
2766,5008984,M,Y,Y,0,112500.0,State servant,Secondary / secondary special,Married,House / apartment,-20874,-2381,1,0,1,0,Drivers,2.0,-54,X
2767,5008984,M,Y,Y,0,112500.0,State servant,Secondary / secondary special,Married,House / apartment,-20874,-2381,1,0,1,0,Drivers,2.0,-55,X
2768,5008984,M,Y,Y,0,112500.0,State servant,Secondary / secondary special,Married,House / apartment,-20874,-2381,1,0,1,0,Drivers,2.0,-56,X
2769,5008984,M,Y,Y,0,112500.0,State servant,Secondary / secondary special,Married,House / apartment,-20874,-2381,1,0,1,0,Drivers,2.0,-57,X
2770,5008984,M,Y,Y,0,112500.0,State servant,Secondary / secondary special,Married,House / apartment,-20874,-2381,1,0,1,0,Drivers,2.0,-58,X
2771,5008986,M,Y,Y,0,112500.0,State servant,Secondary / secondary special,Married,House / apartment,-20874,-2381,1,0,1,0,Drivers,2.0,0,X
2772,5008986,M,Y,Y,0,112500.0,State servant,Secondary / secondary special,Married,House / apartment,-20874,-2381,1,0,1,0,Drivers,2.0,-1,X
2773,5008986,M,Y,Y,0,112500.0,State servant,Secondary / secondary special,Married,House / apartment,-20874,-2381,1,0,1,0,Drivers,2.0,-2,X
2774,5008986,M,Y,Y,0,112500.0,State servant,Secondary / secondary special,Married,House / apartment,-20874,-2381,1,0,1,0,Drivers,2.0,-3,X
2775,5008986,M,Y,Y,0,112500.0,State servant,Secondary / secondary special,Married,House / apartment,-20874,-2381,1,0,1,0,Drivers,2.0,-4,X
2776,5008986,M,Y,Y,0,112500.0,State servant,Secondary / secondary special,Married,House / apartment,-20874,-2381,1,0,1,0,Drivers,2.0,-5,X
2777,5008986,M,Y,Y,0,112500.0,State servant,Secondary / secondary special,Married,House / apartment,-20874,-2381,1,0,1,0,Drivers,2.0,-6,X
2778,5008986,M,Y,Y,0,112500.0,State servant,Secondary / secondary special,Married,House / apartment,-20874,-2381,1,0,1,0,Drivers,2.0,-7,X
2779,5008986,M,Y,Y,0,112500.0,State servant,Secondary / secondary special,Married,House / apartment,-20874,-2381,1,0,1,0,Drivers,2.0,-8,X
2780,5008986,M,Y,Y,0,112500.0,State servant,Secondary / secondary special,Married,House / apartment,-20874,-2381,1,0,1,0,Drivers,2.0,-9,X
2781,5008986,M,Y,Y,0,112500.0,State servant,Secondary / secondary special,Married,House / apartment,-20874,-2381,1,0,1,0,Drivers,2.0,-10,X
2782,5008987,M,Y,Y,0,112500.0,State servant,Secondary / secondary special,Married,House / apartment,-20874,-2381,1,0,1,0,Drivers,2.0,0,C
2783,5008987,M,Y,Y,0,112500.0,State servant,Secondary / secondary special,Married,House / apartment,-20874,-2381,1,0,1,0,Drivers,2.0,-1,C
2784,5008987,M,Y,Y,0,112500.0,State servant,Secondary / secondary special,Married,House / apartment,-20874,-2381,1,0,1,0,Drivers,2.0,-2,C
2785,5008987,M,Y,Y,0,112500.0,State servant,Secondary / secondary special,Married,House / apartment,-20874,-2381,1,0,1,0,Drivers,2.0,-3,C
2786,5008987,M,Y,Y,0,112500.0,State servant,Secondary / secondary special,Married,House / apartment,-20874,-2381,1,0,1,0,Drivers,2.0,-4,C
2787,5008987,M,Y,Y,0,112500.0,State servant,Secondary / secondary special,Married,House / apartment,-20874,-2381,1,0,1,0,Drivers,2.0,-5,C
2788,5008987,M,Y,Y,0,112500.0,State servant,Secondary / secondary special,Married,House / apartment,-20874,-2381,1,0,1,0,Drivers,2.0,-6,C
2789,5008987,M,Y,Y,0,112500.0,State servant,Secondary / secondary special,Married,House / apartment,-20874,-2381,1,0,1,0,Drivers,2.0,-7,C
2790,5008987,M,Y,Y,0,112500.0,State servant,Secondary / secondary special,Married,House / apartment,-20874,-2381,1,0,1,0,Drivers,2.0,-8,0
2791,5008987,M,Y,Y,0,112500.0,State servant,Secondary / secondary special,Married,House / apartment,-20874,-2381,1,0,1,0,Drivers,2.0,-9,0
2792,5008987,M,Y,Y,0,112500.0,State servant,Secondary / secondary special,Married,House / apartment,-20874,-2381,1,0,1,0,Drivers,2.0,-10,0
2793,5008988,M,Y,Y,0,112500.0,State servant,Secondary / secondary special,Married,House / apartment,-20874,-2381,1,0,1,0,Drivers,2.0,0,X
2794,5008988,M,Y,Y,0,112500.0,State servant,Secondary / secondary special,Married,House / apartment,-20874,-2381,1,0,1,0,Drivers,2.0,-1,X
2795,5008988,M,Y,Y,0,112500.0,State servant,Secondary / secondary special,Married,House / apartment,-20874,-2381,1,0,1,0,Drivers,2.0,-2,X
2796,5008988,M,Y,Y,0,112500.0,State servant,Secondary / secondary special,Married,House / apartment,-20874,-2381,1,0,1,0,Drivers,2.0,-3,X
2797,5008988,M,Y,Y,0,112500.0,State servant,Secondary / secondary special,Married,House / apartment,-20874,-2381,1,0,1,0,Drivers,2.0,-4,X
2798,5008988,M,Y,Y,0,112500.0,State servant,Secondary / secondary special,Married,House / apartment,-20874,-2381,1,0,1,0,Drivers,2.0,-5,X
2799,5008988,M,Y,Y,0,112500.0,State servant,Secondary / secondary special,Married,House / apartment,-20874,-2381,1,0,1,0,Drivers,2.0,-6,X
2800,5008988,M,Y,Y,0,112500.0,State servant,Secondary / secondary special,Married,House / apartment,-20874,-2381,1,0,1,0,Drivers,2.0,-7,X
2801,5008988,M,Y,Y,0,112500.0,State servant,Secondary / secondary special,Married,House / apartment,-20874,-2381,1,0,1,0,Drivers,2.0,-8,X
2802,5008988,M,Y,Y,0,112500.0,State servant,Secondary / secondary special,Married,House / apartment,-20874,-2381,1,0,1,0,Drivers,2.0,-9,X
2803,5008988,M,Y,Y,0,112500.0,State servant,Secondary / secondary special,Married,House / apartment,-20874,-2381,1,0,1,0,Drivers,2.0,-10,X
2804,5008988,M,Y,Y,0,112500.0,State servant,Secondary / secondary special,Married,House / apartment,-20874,-2381,1,0,1,0,Drivers,2.0,-11,X
2805,5008988,M,Y,Y,0,112500.0,State servant,Secondary / secondary special,Married,House / apartment,-20874,-2381,1,0,1,0,Drivers,2.0,-12,X
2806,5008988,M,Y,Y,0,112500.0,State servant,Secondary / secondary special,Married,House / apartment,-20874,-2381,1,0,1,0,Drivers,2.0,-13,X
2807,5008988,M,Y,Y,0,112500.0,State servant,Secondary / secondary special,Married,House / apartment,-20874,-2381,1,0,1,0,Drivers,2.0,-14,X
2808,5008988,M,Y,Y,0,112500.0,State servant,Secondary / secondary special,Married,House / apartment,-20874,-2381,1,0,1,0,Drivers,2.0,-15,X
2809,5008988,M,Y,Y,0,112500.0,State servant,Secondary / secondary special,Married,House / apartment,-20874,-2381,1,0,1,0,Drivers,2.0,-16,X
2810,5008991,F,Y,Y,0,270000.0,Working,Secondary / secondary special,Separated,House / apartment,-16582,-1194,1,1,1,0,Cleaning staff,1.0,-2,X
2811,5008991,F,Y,Y,0,270000.0,Working,Secondary / secondary special,Separated,House / apartment,-16582,-1194,1,1,1,0,Cleaning staff,1.0,-3,0
2812,5008991,F,Y,Y,0,270000.0,Working,Secondary / secondary special,Separated,House / apartment,-16582,-1194,1,1,1,0,Cleaning staff,1.0,-4,0
2813,5008991,F,Y,Y,0,270000.0,Working,Secondary / secondary special,Separated,House / apartment,-16582,-1194,1,1,1,0,Cleaning staff,1.0,-5,0
2814,5008991,F,Y,Y,0,270000.0,Working,Secondary / secondary special,Separated,House / apartment,-16582,-1194,1,1,1,0,Cleaning staff,1.0,-6,0
2815,5008991,F,Y,Y,0,270000.0,Working,Secondary / secondary special,Separated,House / apartment,-16582,-1194,1,1,1,0,Cleaning staff,1.0,-7,0
2816,5008991,F,Y,Y,0,270000.0,Working,Secondary / secondary special,Separated,House / apartment,-16582,-1194,1,1,1,0,Cleaning staff,1.0,-8,0
2817,5008991,F,Y,Y,0,270000.0,Working,Secondary / secondary special,Separated,House / apartment,-16582,-1194,1,1,1,0,Cleaning staff,1.0,-9,0
2818,5008991,F,Y,Y,0,270000.0,Working,Secondary / secondary special,Separated,House / apartment,-16582,-1194,1,1,1,0,Cleaning staff,1.0,-10,0
2819,5008991,F,Y,Y,0,270000.0,Working,Secondary / secondary special,Separated,House / apartment,-16582,-1194,1,1,1,0,Cleaning staff,1.0,-11,0
2820,5008991,F,Y,Y,0,270000.0,Working,Secondary / secondary special,Separated,House / apartment,-16582,-1194,1,1,1,0,Cleaning staff,1.0,-12,0
2821,5008991,F,Y,Y,0,270000.0,Working,Secondary / secondary special,Separated,House / apartment,-16582,-1194,1,1,1,0,Cleaning staff,1.0,-13,0
2822,5008991,F,Y,Y,0,270000.0,Working,Secondary / secondary special,Separated,House / apartment,-16582,-1194,1,1,1,0,Cleaning staff,1.0,-14,0
2823,5008991,F,Y,Y,0,270000.0,Working,Secondary / secondary special,Separated,House / apartment,-16582,-1194,1,1,1,0,Cleaning staff,1.0,-15,0
2824,5008991,F,Y,Y,0,270000.0,Working,Secondary / secondary special,Separated,House / apartment,-16582,-1194,1,1,1,0,Cleaning staff,1.0,-16,0
2825,5008991,F,Y,Y,0,270000.0,Working,Secondary / secondary special,Separated,House / apartment,-16582,-1194,1,1,1,0,Cleaning staff,1.0,-17,0
2826,5008991,F,Y,Y,0,270000.0,Working,Secondary / secondary special,Separated,House / apartment,-16582,-1194,1,1,1,0,Cleaning staff,1.0,-18,0
2827,5008991,F,Y,Y,0,270000.0,Working,Secondary / secondary special,Separated,House / apartment,-16582,-1194,1,1,1,0,Cleaning staff,1.0,-19,0
2828,5008991,F,Y,Y,0,270000.0,Working,Secondary / secondary special,Separated,House / apartment,-16582,-1194,1,1,1,0,Cleaning staff,1.0,-20,0
2829,5008991,F,Y,Y,0,270000.0,Working,Secondary / secondary special,Separated,House / apartment,-16582,-1194,1,1,1,0,Cleaning staff,1.0,-21,0
2830,5008991,F,Y,Y,0,270000.0,Working,Secondary / secondary special,Separated,House / apartment,-16582,-1194,1,1,1,0,Cleaning staff,1.0,-22,0
2831,5008991,F,Y,Y,0,270000.0,Working,Secondary / secondary special,Separated,House / apartment,-16582,-1194,1,1,1,0,Cleaning staff,1.0,-23,0
2832,5008991,F,Y,Y,0,270000.0,Working,Secondary / secondary special,Separated,House / apartment,-16582,-1194,1,1,1,0,Cleaning staff,1.0,-24,0
2833,5008991,F,Y,Y,0,270000.0,Working,Secondary / secondary special,Separated,House / apartment,-16582,-1194,1,1,1,0,Cleaning staff,1.0,-25,0
2834,5008991,F,Y,Y,0,270000.0,Working,Secondary / secondary special,Separated,House / apartment,-16582,-1194,1,1,1,0,Cleaning staff,1.0,-26,0
2835,5008991,F,Y,Y,0,270000.0,Working,Secondary / secondary special,Separated,House / apartment,-16582,-1194,1,1,1,0,Cleaning staff,1.0,-27,0
2836,5008991,F,Y,Y,0,270000.0,Working,Secondary / secondary special,Separated,House / apartment,-16582,-1194,1,1,1,0,Cleaning staff,1.0,-28,0
2837,5008991,F,Y,Y,0,270000.0,Working,Secondary / secondary special,Separated,House / apartment,-16582,-1194,1,1,1,0,Cleaning staff,1.0,-29,X
2838,5008991,F,Y,Y,0,270000.0,Working,Secondary / secondary special,Separated,House / apartment,-16582,-1194,1,1,1,0,Cleaning staff,1.0,-30,X
2839,5008992,F,Y,Y,0,270000.0,Working,Secondary / secondary special,Separated,House / apartment,-16582,-1194,1,1,1,0,Cleaning staff,1.0,0,C
2840,5008992,F,Y,Y,0,270000.0,Working,Secondary / secondary special,Separated,House / apartment,-16582,-1194,1,1,1,0,Cleaning staff,1.0,-1,C
2841,5008992,F,Y,Y,0,270000.0,Working,Secondary / secondary special,Separated,House / apartment,-16582,-1194,1,1,1,0,Cleaning staff,1.0,-2,C
2842,5008992,F,Y,Y,0,270000.0,Working,Secondary / secondary special,Separated,House / apartment,-16582,-1194,1,1,1,0,Cleaning staff,1.0,-3,C
2843,5008992,F,Y,Y,0,270000.0,Working,Secondary / secondary special,Separated,House / apartment,-16582,-1194,1,1,1,0,Cleaning staff,1.0,-4,C
2844,5008992,F,Y,Y,0,270000.0,Working,Secondary / secondary special,Separated,House / apartment,-16582,-1194,1,1,1,0,Cleaning staff,1.0,-5,0
2845,5008992,F,Y,Y,0,270000.0,Working,Secondary / secondary special,Separated,House / apartment,-16582,-1194,1,1,1,0,Cleaning staff,1.0,-6,X
2846,5008993,F,Y,Y,0,270000.0,Working,Secondary / secondary special,Separated,House / apartment,-16582,-1194,1,1,1,0,Cleaning staff,1.0,0,0
2847,5008993,F,Y,Y,0,270000.0,Working,Secondary / secondary special,Separated,House / apartment,-16582,-1194,1,1,1,0,Cleaning staff,1.0,-1,0
2848,5008993,F,Y,Y,0,270000.0,Working,Secondary / secondary special,Separated,House / apartment,-16582,-1194,1,1,1,0,Cleaning staff,1.0,-2,0
2849,5008993,F,Y,Y,0,270000.0,Working,Secondary / secondary special,Separated,House / apartment,-16582,-1194,1,1,1,0,Cleaning staff,1.0,-3,0
2850,5008993,F,Y,Y,0,270000.0,Working,Secondary / secondary special,Separated,House / apartment,-16582,-1194,1,1,1,0,Cleaning staff,1.0,-4,0
2851,5008993,F,Y,Y,0,270000.0,Working,Secondary / secondary special,Separated,House / apartment,-16582,-1194,1,1,1,0,Cleaning staff,1.0,-5,0
2852,5008993,F,Y,Y,0,270000.0,Working,Secondary / secondary special,Separated,House / apartment,-16582,-1194,1,1,1,0,Cleaning staff,1.0,-6,0
2853,5008993,F,Y,Y,0,270000.0,Working,Secondary / secondary special,Separated,House / apartment,-16582,-1194,1,1,1,0,Cleaning staff,1.0,-7,0
2854,5008993,F,Y,Y,0,270000.0,Working,Secondary / secondary special,Separated,House / apartment,-16582,-1194,1,1,1,0,Cleaning staff,1.0,-8,0
2855,5008993,F,Y,Y,0,270000.0,Working,Secondary / secondary special,Separated,House / apartment,-16582,-1194,1,1,1,0,Cleaning staff,1.0,-9,0
2856,5008993,F,Y,Y,0,270000.0,Working,Secondary / secondary special,Separated,House / apartment,-16582,-1194,1,1,1,0,Cleaning staff,1.0,-10,0
2857,5008993,F,Y,Y,0,270000.0,Working,Secondary / secondary special,Separated,House / apartment,-16582,-1194,1,1,1,0,Cleaning staff,1.0,-11,0
2858,5008993,F,Y,Y,0,270000.0,Working,Secondary / secondary special,Separated,House / apartment,-16582,-1194,1,1,1,0,Cleaning staff,1.0,-12,0
2859,5008993,F,Y,Y,0,270000.0,Working,Secondary / secondary special,Separated,House / apartment,-16582,-1194,1,1,1,0,Cleaning staff,1.0,-13,0
2860,5008993,F,Y,Y,0,270000.0,Working,Secondary / secondary special,Separated,House / apartment,-16582,-1194,1,1,1,0,Cleaning staff,1.0,-14,0
2861,5008993,F,Y,Y,0,270000.0,Working,Secondary / secondary special,Separated,House / apartment,-16582,-1194,1,1,1,0,Cleaning staff,1.0,-15,0
2862,5008993,F,Y,Y,0,270000.0,Working,Secondary / secondary special,Separated,House / apartment,-16582,-1194,1,1,1,0,Cleaning staff,1.0,-16,0
2863,5008993,F,Y,Y,0,270000.0,Working,Secondary / secondary special,Separated,House / apartment,-16582,-1194,1,1,1,0,Cleaning staff,1.0,-17,0
2864,5008994,F,Y,Y,0,270000.0,Working,Secondary / secondary special,Separated,House / apartment,-16582,-1194,1,1,1,0,Cleaning staff,1.0,0,0
2865,5008994,F,Y,Y,0,270000.0,Working,Secondary / secondary special,Separated,House / apartment,-16582,-1194,1,1,1,0,Cleaning staff,1.0,-1,0
2866,5008994,F,Y,Y,0,270000.0,Working,Secondary / secondary special,Separated,House / apartment,-16582,-1194,1,1,1,0,Cleaning staff,1.0,-2,0
2867,5008994,F,Y,Y,0,270000.0,Working,Secondary / secondary special,Separated,House / apartment,-16582,-1194,1,1,1,0,Cleaning staff,1.0,-3,0
2868,5008994,F,Y,Y,0,270000.0,Working,Secondary / secondary special,Separated,House / apartment,-16582,-1194,1,1,1,0,Cleaning staff,1.0,-4,0
2869,5008994,F,Y,Y,0,270000.0,Working,Secondary / secondary special,Separated,House / apartment,-16582,-1194,1,1,1,0,Cleaning staff,1.0,-5,0
2870,5008994,F,Y,Y,0,270000.0,Working,Secondary / secondary special,Separated,House / apartment,-16582,-1194,1,1,1,0,Cleaning staff,1.0,-6,0
2871,5008994,F,Y,Y,0,270000.0,Working,Secondary / secondary special,Separated,House / apartment,-16582,-1194,1,1,1,0,Cleaning staff,1.0,-7,0
2872,5008994,F,Y,Y,0,270000.0,Working,Secondary / secondary special,Separated,House / apartment,-16582,-1194,1,1,1,0,Cleaning staff,1.0,-8,0
2873,5008994,F,Y,Y,0,270000.0,Working,Secondary / secondary special,Separated,House / apartment,-16582,-1194,1,1,1,0,Cleaning staff,1.0,-9,0
2874,5008994,F,Y,Y,0,270000.0,Working,Secondary / secondary special,Separated,House / apartment,-16582,-1194,1,1,1,0,Cleaning staff,1.0,-10,0
2875,5008994,F,Y,Y,0,270000.0,Working,Secondary / secondary special,Separated,House / apartment,-16582,-1194,1,1,1,0,Cleaning staff,1.0,-11,0
2876,5008994,F,Y,Y,0,270000.0,Working,Secondary / secondary special,Separated,House / apartment,-16582,-1194,1,1,1,0,Cleaning staff,1.0,-12,0
2877,5008994,F,Y,Y,0,270000.0,Working,Secondary / secondary special,Separated,House / apartment,-16582,-1194,1,1,1,0,Cleaning staff,1.0,-13,0
2878,5008994,F,Y,Y,0,270000.0,Working,Secondary / secondary special,Separated,House / apartment,-16582,-1194,1,1,1,0,Cleaning staff,1.0,-14,0
2879,5008994,F,Y,Y,0,270000.0,Working,Secondary / secondary special,Separated,House / apartment,-16582,-1194,1,1,1,0,Cleaning staff,1.0,-15,0
2880,5008994,F,Y,Y,0,270000.0,Working,Secondary / secondary special,Separated,House / apartment,-16582,-1194,1,1,1,0,Cleaning staff,1.0,-16,0
2881,5008994,F,Y,Y,0,270000.0,Working,Secondary / secondary special,Separated,House / apartment,-16582,-1194,1,1,1,0,Cleaning staff,1.0,-17,X
2882,5008994,F,Y,Y,0,270000.0,Working,Secondary / secondary special,Separated,House / apartment,-16582,-1194,1,1,1,0,Cleaning staff,1.0,-18,X
2883,5008994,F,Y,Y,0,270000.0,Working,Secondary / secondary special,Separated,House / apartment,-16582,-1194,1,1,1,0,Cleaning staff,1.0,-19,X
2884,5008995,F,Y,Y,0,270000.0,Working,Secondary / secondary special,Separated,House / apartment,-16582,-1194,1,1,1,0,Cleaning staff,1.0,-10,X
2885,5008995,F,Y,Y,0,270000.0,Working,Secondary / secondary special,Separated,House / apartment,-16582,-1194,1,1,1,0,Cleaning staff,1.0,-11,0
2886,5008995,F,Y,Y,0,270000.0,Working,Secondary / secondary special,Separated,House / apartment,-16582,-1194,1,1,1,0,Cleaning staff,1.0,-12,0
2887,5008995,F,Y,Y,0,270000.0,Working,Secondary / secondary special,Separated,House / apartment,-16582,-1194,1,1,1,0,Cleaning staff,1.0,-13,0
2888,5008995,F,Y,Y,0,270000.0,Working,Secondary / secondary special,Separated,House / apartment,-16582,-1194,1,1,1,0,Cleaning staff,1.0,-14,0
2889,5008995,F,Y,Y,0,270000.0,Working,Secondary / secondary special,Separated,House / apartment,-16582,-1194,1,1,1,0,Cleaning staff,1.0,-15,0
2890,5008995,F,Y,Y,0,270000.0,Working,Secondary / secondary special,Separated,House / apartment,-16582,-1194,1,1,1,0,Cleaning staff,1.0,-16,0
2891,5008995,F,Y,Y,0,270000.0,Working,Secondary / secondary special,Separated,House / apartment,-16582,-1194,1,1,1,0,Cleaning staff,1.0,-17,0
2892,5008995,F,Y,Y,0,270000.0,Working,Secondary / secondary special,Separated,House / apartment,-16582,-1194,1,1,1,0,Cleaning staff,1.0,-18,0
2893,5008995,F,Y,Y,0,270000.0,Working,Secondary / secondary special,Separated,House / apartment,-16582,-1194,1,1,1,0,Cleaning staff,1.0,-19,0
2894,5008995,F,Y,Y,0,270000.0,Working,Secondary / secondary special,Separated,House / apartment,-16582,-1194,1,1,1,0,Cleaning staff,1.0,-20,0
2895,5008995,F,Y,Y,0,270000.0,Working,Secondary / secondary special,Separated,House / apartment,-16582,-1194,1,1,1,0,Cleaning staff,1.0,-21,0
2896,5008995,F,Y,Y,0,270000.0,Working,Secondary / secondary special,Separated,House / apartment,-16582,-1194,1,1,1,0,Cleaning staff,1.0,-22,0
2897,5008995,F,Y,Y,0,270000.0,Working,Secondary / secondary special,Separated,House / apartment,-16582,-1194,1,1,1,0,Cleaning staff,1.0,-23,0
2898,5008995,F,Y,Y,0,270000.0,Working,Secondary / secondary special,Separated,House / apartment,-16582,-1194,1,1,1,0,Cleaning staff,1.0,-24,0
2899,5008995,F,Y,Y,0,270000.0,Working,Secondary / secondary special,Separated,House / apartment,-16582,-1194,1,1,1,0,Cleaning staff,1.0,-25,0
2900,5008995,F,Y,Y,0,270000.0,Working,Secondary / secondary special,Separated,House / apartment,-16582,-1194,1,1,1,0,Cleaning staff,1.0,-26,0
2901,5008995,F,Y,Y,0,270000.0,Working,Secondary / secondary special,Separated,House / apartment,-16582,-1194,1,1,1,0,Cleaning staff,1.0,-27,0
2902,5008995,F,Y,Y,0,270000.0,Working,Secondary / secondary special,Separated,House / apartment,-16582,-1194,1,1,1,0,Cleaning staff,1.0,-28,0
2903,5112861,F,Y,Y,0,270000.0,Working,Secondary / secondary special,Separated,House / apartment,-16582,-1194,1,1,1,0,Cleaning staff,1.0,-2,X
2904,5112861,F,Y,Y,0,270000.0,Working,Secondary / secondary special,Separated,House / apartment,-16582,-1194,1,1,1,0,Cleaning staff,1.0,-3,0
2905,5112861,F,Y,Y,0,270000.0,Working,Secondary / secondary special,Separated,House / apartment,-16582,-1194,1,1,1,0,Cleaning staff,1.0,-4,0
2906,5112861,F,Y,Y,0,270000.0,Working,Secondary / secondary special,Separated,House / apartment,-16582,-1194,1,1,1,0,Cleaning staff,1.0,-5,0
2907,5112861,F,Y,Y,0,270000.0,Working,Secondary / secondary special,Separated,House / apartment,-16582,-1194,1,1,1,0,Cleaning staff,1.0,-6,0
2908,5112861,F,Y,Y,0,270000.0,Working,Secondary / secondary special,Separated,House / apartment,-16582,-1194,1,1,1,0,Cleaning staff,1.0,-7,0
2909,5112861,F,Y,Y,0,270000.0,Working,Secondary / secondary special,Separated,House / apartment,-16582,-1194,1,1,1,0,Cleaning staff,1.0,-8,0
2910,5112861,F,Y,Y,0,270000.0,Working,Secondary / secondary special,Separated,House / apartment,-16582,-1194,1,1,1,0,Cleaning staff,1.0,-9,0
2911,5112861,F,Y,Y,0,270000.0,Working,Secondary / secondary special,Separated,House / apartment,-16582,-1194,1,1,1,0,Cleaning staff,1.0,-10,0
2912,5112861,F,Y,Y,0,270000.0,Working,Secondary / secondary special,Separated,House / apartment,-16582,-1194,1,1,1,0,Cleaning staff,1.0,-11,0
2913,5112861,F,Y,Y,0,270000.0,Working,Secondary / secondary special,Separated,House / apartment,-16582,-1194,1,1,1,0,Cleaning staff,1.0,-12,0
2914,5112861,F,Y,Y,0,270000.0,Working,Secondary / secondary special,Separated,House / apartment,-16582,-1194,1,1,1,0,Cleaning staff,1.0,-13,0
2915,5112861,F,Y,Y,0,270000.0,Working,Secondary / secondary special,Separated,House / apartment,-16582,-1194,1,1,1,0,Cleaning staff,1.0,-14,0
2916,5112861,F,Y,Y,0,270000.0,Working,Secondary / secondary special,Separated,House / apartment,-16582,-1194,1,1,1,0,Cleaning staff,1.0,-15,0
2917,5112861,F,Y,Y,0,270000.0,Working,Secondary / secondary special,Separated,House / apartment,-16582,-1194,1,1,1,0,Cleaning staff,1.0,-16,0
2918,5112861,F,Y,Y,0,270000.0,Working,Secondary / secondary special,Separated,House / apartment,-16582,-1194,1,1,1,0,Cleaning staff,1.0,-17,0
2919,5112861,F,Y,Y,0,270000.0,Working,Secondary / secondary special,Separated,House / apartment,-16582,-1194,1,1,1,0,Cleaning staff,1.0,-18,0
2920,5112861,F,Y,Y,0,270000.0,Working,Secondary / secondary special,Separated,House / apartment,-16582,-1194,1,1,1,0,Cleaning staff,1.0,-19,0
2921,5112861,F,Y,Y,0,270000.0,Working,Secondary / secondary special,Separated,House / apartment,-16582,-1194,1,1,1,0,Cleaning staff,1.0,-20,0
2922,5112861,F,Y,Y,0,270000.0,Working,Secondary / secondary special,Separated,House / apartment,-16582,-1194,1,1,1,0,Cleaning staff,1.0,-21,0
2923,5008998,F,Y,Y,0,270000.0,Working,Higher education,Married,House / apartment,-10628,-828,1,0,0,1,Managers,2.0,-1,X
2924,5008998,F,Y,Y,0,270000.0,Working,Higher education,Married,House / apartment,-10628,-828,1,0,0,1,Managers,2.0,-2,X
2925,5008998,F,Y,Y,0,270000.0,Working,Higher education,Married,House / apartment,-10628,-828,1,0,0,1,Managers,2.0,-3,X
2926,5008998,F,Y,Y,0,270000.0,Working,Higher education,Married,House / apartment,-10628,-828,1,0,0,1,Managers,2.0,-4,X
2927,5008999,F,Y,Y,0,270000.0,Working,Higher education,Married,House / apartment,-10628,-828,1,0,0,1,Managers,2.0,-21,X
2928,5008999,F,Y,Y,0,270000.0,Working,Higher education,Married,House / apartment,-10628,-828,1,0,0,1,Managers,2.0,-22,X
2929,5008999,F,Y,Y,0,270000.0,Working,Higher education,Married,House / apartment,-10628,-828,1,0,0,1,Managers,2.0,-23,X
2930,5008999,F,Y,Y,0,270000.0,Working,Higher education,Married,House / apartment,-10628,-828,1,0,0,1,Managers,2.0,-24,X
2931,5009000,M,Y,Y,0,157500.0,Working,Secondary / secondary special,Married,House / apartment,-9927,-828,1,0,0,0,Drivers,2.0,0,C
2932,5009000,M,Y,Y,0,157500.0,Working,Secondary / secondary special,Married,House / apartment,-9927,-828,1,0,0,0,Drivers,2.0,-1,C
2933,5009000,M,Y,Y,0,157500.0,Working,Secondary / secondary special,Married,House / apartment,-9927,-828,1,0,0,0,Drivers,2.0,-2,C
2934,5009000,M,Y,Y,0,157500.0,Working,Secondary / secondary special,Married,House / apartment,-9927,-828,1,0,0,0,Drivers,2.0,-3,C
2935,5009000,M,Y,Y,0,157500.0,Working,Secondary / secondary special,Married,House / apartment,-9927,-828,1,0,0,0,Drivers,2.0,-4,C
2936,5009000,M,Y,Y,0,157500.0,Working,Secondary / secondary special,Married,House / apartment,-9927,-828,1,0,0,0,Drivers,2.0,-5,C
2937,5009000,M,Y,Y,0,157500.0,Working,Secondary / secondary special,Married,House / apartment,-9927,-828,1,0,0,0,Drivers,2.0,-6,C
2938,5009000,M,Y,Y,0,157500.0,Working,Secondary / secondary special,Married,House / apartment,-9927,-828,1,0,0,0,Drivers,2.0,-7,C
2939,5009000,M,Y,Y,0,157500.0,Working,Secondary / secondary special,Married,House / apartment,-9927,-828,1,0,0,0,Drivers,2.0,-8,C
2940,5009000,M,Y,Y,0,157500.0,Working,Secondary / secondary special,Married,House / apartment,-9927,-828,1,0,0,0,Drivers,2.0,-9,C
2941,5009000,M,Y,Y,0,157500.0,Working,Secondary / secondary special,Married,House / apartment,-9927,-828,1,0,0,0,Drivers,2.0,-10,C
2942,5009000,M,Y,Y,0,157500.0,Working,Secondary / secondary special,Married,House / apartment,-9927,-828,1,0,0,0,Drivers,2.0,-11,C
2943,5009000,M,Y,Y,0,157500.0,Working,Secondary / secondary special,Married,House / apartment,-9927,-828,1,0,0,0,Drivers,2.0,-12,C
2944,5009000,M,Y,Y,0,157500.0,Working,Secondary / secondary special,Married,House / apartment,-9927,-828,1,0,0,0,Drivers,2.0,-13,C
2945,5009000,M,Y,Y,0,157500.0,Working,Secondary / secondary special,Married,House / apartment,-9927,-828,1,0,0,0,Drivers,2.0,-14,0
2946,5009000,M,Y,Y,0,157500.0,Working,Secondary / secondary special,Married,House / apartment,-9927,-828,1,0,0,0,Drivers,2.0,-15,0
2947,5009000,M,Y,Y,0,157500.0,Working,Secondary / secondary special,Married,House / apartment,-9927,-828,1,0,0,0,Drivers,2.0,-16,0
2948,5009000,M,Y,Y,0,157500.0,Working,Secondary / secondary special,Married,House / apartment,-9927,-828,1,0,0,0,Drivers,2.0,-17,0
2949,5009000,M,Y,Y,0,157500.0,Working,Secondary / secondary special,Married,House / apartment,-9927,-828,1,0,0,0,Drivers,2.0,-18,0
2950,5009000,M,Y,Y,0,157500.0,Working,Secondary / secondary special,Married,House / apartment,-9927,-828,1,0,0,0,Drivers,2.0,-19,0
2951,5009000,M,Y,Y,0,157500.0,Working,Secondary / secondary special,Married,House / apartment,-9927,-828,1,0,0,0,Drivers,2.0,-20,0
2952,5009000,M,Y,Y,0,157500.0,Working,Secondary / secondary special,Married,House / apartment,-9927,-828,1,0,0,0,Drivers,2.0,-21,0
2953,5009000,M,Y,Y,0,157500.0,Working,Secondary / secondary special,Married,House / apartment,-9927,-828,1,0,0,0,Drivers,2.0,-22,0
2954,5009001,M,N,Y,0,166500.0,Working,Secondary / secondary special,Married,House / apartment,-18926,-6276,1,1,1,0,Laborers,2.0,-34,X
2955,5009001,M,N,Y,0,166500.0,Working,Secondary / secondary special,Married,House / apartment,-18926,-6276,1,1,1,0,Laborers,2.0,-35,0
2956,5009001,M,N,Y,0,166500.0,Working,Secondary / secondary special,Married,House / apartment,-18926,-6276,1,1,1,0,Laborers,2.0,-36,0
2957,5009001,M,N,Y,0,166500.0,Working,Secondary / secondary special,Married,House / apartment,-18926,-6276,1,1,1,0,Laborers,2.0,-37,0
2958,5009001,M,N,Y,0,166500.0,Working,Secondary / secondary special,Married,House / apartment,-18926,-6276,1,1,1,0,Laborers,2.0,-38,0
2959,5009001,M,N,Y,0,166500.0,Working,Secondary / secondary special,Married,House / apartment,-18926,-6276,1,1,1,0,Laborers,2.0,-39,0
2960,5009001,M,N,Y,0,166500.0,Working,Secondary / secondary special,Married,House / apartment,-18926,-6276,1,1,1,0,Laborers,2.0,-40,0
2961,5009002,M,N,Y,0,166500.0,Working,Secondary / secondary special,Married,House / apartment,-18926,-6276,1,1,1,0,Laborers,2.0,-38,X
2962,5009002,M,N,Y,0,166500.0,Working,Secondary / secondary special,Married,House / apartment,-18926,-6276,1,1,1,0,Laborers,2.0,-39,0
2963,5009002,M,N,Y,0,166500.0,Working,Secondary / secondary special,Married,House / apartment,-18926,-6276,1,1,1,0,Laborers,2.0,-40,0
2964,5009002,M,N,Y,0,166500.0,Working,Secondary / secondary special,Married,House / apartment,-18926,-6276,1,1,1,0,Laborers,2.0,-41,0
2965,5009002,M,N,Y,0,166500.0,Working,Secondary / secondary special,Married,House / apartment,-18926,-6276,1,1,1,0,Laborers,2.0,-42,0
2966,5009002,M,N,Y,0,166500.0,Working,Secondary / secondary special,Married,House / apartment,-18926,-6276,1,1,1,0,Laborers,2.0,-43,0
2967,5009002,M,N,Y,0,166500.0,Working,Secondary / secondary special,Married,House / apartment,-18926,-6276,1,1,1,0,Laborers,2.0,-44,0
2968,5009005,M,N,Y,0,166500.0,Working,Secondary / secondary special,Married,House / apartment,-18926,-6276,1,1,1,0,Laborers,2.0,-29,X
2969,5009005,M,N,Y,0,166500.0,Working,Secondary / secondary special,Married,House / apartment,-18926,-6276,1,1,1,0,Laborers,2.0,-30,0
2970,5009005,M,N,Y,0,166500.0,Working,Secondary / secondary special,Married,House / apartment,-18926,-6276,1,1,1,0,Laborers,2.0,-31,0
2971,5009005,M,N,Y,0,166500.0,Working,Secondary / secondary special,Married,House / apartment,-18926,-6276,1,1,1,0,Laborers,2.0,-32,0
2972,5009005,M,N,Y,0,166500.0,Working,Secondary / secondary special,Married,House / apartment,-18926,-6276,1,1,1,0,Laborers,2.0,-33,0
2973,5009005,M,N,Y,0,166500.0,Working,Secondary / secondary special,Married,House / apartment,-18926,-6276,1,1,1,0,Laborers,2.0,-34,0
2974,5009005,M,N,Y,0,166500.0,Working,Secondary / secondary special,Married,House / apartment,-18926,-6276,1,1,1,0,Laborers,2.0,-35,0
2975,5009006,M,N,Y,0,166500.0,Working,Secondary / secondary special,Married,House / apartment,-18926,-6276,1,1,1,0,Laborers,2.0,-35,X
2976,5009006,M,N,Y,0,166500.0,Working,Secondary / secondary special,Married,House / apartment,-18926,-6276,1,1,1,0,Laborers,2.0,-36,0
2977,5009006,M,N,Y,0,166500.0,Working,Secondary / secondary special,Married,House / apartment,-18926,-6276,1,1,1,0,Laborers,2.0,-37,0
2978,5009006,M,N,Y,0,166500.0,Working,Secondary / secondary special,Married,House / apartment,-18926,-6276,1,1,1,0,Laborers,2.0,-38,0
2979,5009006,M,N,Y,0,166500.0,Working,Secondary / secondary special,Married,House / apartment,-18926,-6276,1,1,1,0,Laborers,2.0,-39,0
2980,5009006,M,N,Y,0,166500.0,Working,Secondary / secondary special,Married,House / apartment,-18926,-6276,1,1,1,0,Laborers,2.0,-40,0
2981,5009006,M,N,Y,0,166500.0,Working,Secondary / secondary special,Married,House / apartment,-18926,-6276,1,1,1,0,Laborers,2.0,-41,0
2982,5009006,M,N,Y,0,166500.0,Working,Secondary / secondary special,Married,House / apartment,-18926,-6276,1,1,1,0,Laborers,2.0,-42,0
2983,5009006,M,N,Y,0,166500.0,Working,Secondary / secondary special,Married,House / apartment,-18926,-6276,1,1,1,0,Laborers,2.0,-43,X
2984,5009006,M,N,Y,0,166500.0,Working,Secondary / secondary special,Married,House / apartment,-18926,-6276,1,1,1,0,Laborers,2.0,-44,X
2985,5009006,M,N,Y,0,166500.0,Working,Secondary / secondary special,Married,House / apartment,-18926,-6276,1,1,1,0,Laborers,2.0,-45,X
2986,5009007,M,N,Y,0,166500.0,Working,Secondary / secondary special,Married,House / apartment,-18926,-6276,1,1,1,0,Laborers,2.0,-49,X
2987,5009007,M,N,Y,0,166500.0,Working,Secondary / secondary special,Married,House / apartment,-18926,-6276,1,1,1,0,Laborers,2.0,-50,0
2988,5009007,M,N,Y,0,166500.0,Working,Secondary / secondary special,Married,House / apartment,-18926,-6276,1,1,1,0,Laborers,2.0,-51,0
2989,5009007,M,N,Y,0,166500.0,Working,Secondary / secondary special,Married,House / apartment,-18926,-6276,1,1,1,0,Laborers,2.0,-52,0
2990,5009007,M,N,Y,0,166500.0,Working,Secondary / secondary special,Married,House / apartment,-18926,-6276,1,1,1,0,Laborers,2.0,-53,0
2991,5009007,M,N,Y,0,166500.0,Working,Secondary / secondary special,Married,House / apartment,-18926,-6276,1,1,1,0,Laborers,2.0,-54,0
2992,5009007,M,N,Y,0,166500.0,Working,Secondary / secondary special,Married,House / apartment,-18926,-6276,1,1,1,0,Laborers,2.0,-55,0
2993,5009007,M,N,Y,0,166500.0,Working,Secondary / secondary special,Married,House / apartment,-18926,-6276,1,1,1,0,Laborers,2.0,-56,0
2994,5009007,M,N,Y,0,166500.0,Working,Secondary / secondary special,Married,House / apartment,-18926,-6276,1,1,1,0,Laborers,2.0,-57,X
2995,5009007,M,N,Y,0,166500.0,Working,Secondary / secondary special,Married,House / apartment,-18926,-6276,1,1,1,0,Laborers,2.0,-58,X
2996,5009007,M,N,Y,0,166500.0,Working,Secondary / secondary special,Married,House / apartment,-18926,-6276,1,1,1,0,Laborers,2.0,-59,X
2997,5009008,M,N,Y,0,166500.0,Working,Secondary / secondary special,Married,House / apartment,-18926,-6276,1,1,1,0,Laborers,2.0,-3,X
2998,5009008,M,N,Y,0,166500.0,Working,Secondary / secondary special,Married,House / apartment,-18926,-6276,1,1,1,0,Laborers,2.0,-4,0
2999,5009008,M,N,Y,0,166500.0,Working,Secondary / secondary special,Married,House / apartment,-18926,-6276,1,1,1,0,Laborers,2.0,-5,0
3000,5009008,M,N,Y,0,166500.0,Working,Secondary / secondary special,Married,House / apartment,-18926,-6276,1,1,1,0,Laborers,2.0,-6,0
3001,5009008,M,N,Y,0,166500.0,Working,Secondary / secondary special,Married,House / apartment,-18926,-6276,1,1,1,0,Laborers,2.0,-7,0
3002,5009008,M,N,Y,0,166500.0,Working,Secondary / secondary special,Married,House / apartment,-18926,-6276,1,1,1,0,Laborers,2.0,-8,0
3003,5009008,M,N,Y,0,166500.0,Working,Secondary / secondary special,Married,House / apartment,-18926,-6276,1,1,1,0,Laborers,2.0,-9,0
3004,5009009,M,N,Y,0,166500.0,Working,Secondary / secondary special,Married,House / apartment,-18926,-6276,1,1,1,0,Laborers,2.0,-22,X
3005,5009009,M,N,Y,0,166500.0,Working,Secondary / secondary special,Married,House / apartment,-18926,-6276,1,1,1,0,Laborers,2.0,-23,0
3006,5009009,M,N,Y,0,166500.0,Working,Secondary / secondary special,Married,House / apartment,-18926,-6276,1,1,1,0,Laborers,2.0,-24,0
3007,5009009,M,N,Y,0,166500.0,Working,Secondary / secondary special,Married,House / apartment,-18926,-6276,1,1,1,0,Laborers,2.0,-25,0
3008,5009009,M,N,Y,0,166500.0,Working,Secondary / secondary special,Married,House / apartment,-18926,-6276,1,1,1,0,Laborers,2.0,-26,0
3009,5009009,M,N,Y,0,166500.0,Working,Secondary / secondary special,Married,House / apartment,-18926,-6276,1,1,1,0,Laborers,2.0,-27,0
3010,5009009,M,N,Y,0,166500.0,Working,Secondary / secondary special,Married,House / apartment,-18926,-6276,1,1,1,0,Laborers,2.0,-28,0
3011,5009009,M,N,Y,0,166500.0,Working,Secondary / secondary special,Married,House / apartment,-18926,-6276,1,1,1,0,Laborers,2.0,-29,0
3012,5009009,M,N,Y,0,166500.0,Working,Secondary / secondary special,Married,House / apartment,-18926,-6276,1,1,1,0,Laborers,2.0,-30,X
3013,5009009,M,N,Y,0,166500.0,Working,Secondary / secondary special,Married,House / apartment,-18926,-6276,1,1,1,0,Laborers,2.0,-31,X
3014,5009009,M,N,Y,0,166500.0,Working,Secondary / secondary special,Married,House / apartment,-18926,-6276,1,1,1,0,Laborers,2.0,-32,X
3015,5009010,M,N,Y,0,166500.0,Working,Secondary / secondary special,Married,House / apartment,-18926,-6276,1,1,1,0,Laborers,2.0,-6,X
3016,5009010,M,N,Y,0,166500.0,Working,Secondary / secondary special,Married,House / apartment,-18926,-6276,1,1,1,0,Laborers,2.0,-7,0
3017,5009010,M,N,Y,0,166500.0,Working,Secondary / secondary special,Married,House / apartment,-18926,-6276,1,1,1,0,Laborers,2.0,-8,0
3018,5009010,M,N,Y,0,166500.0,Working,Secondary / secondary special,Married,House / apartment,-18926,-6276,1,1,1,0,Laborers,2.0,-9,0
3019,5009010,M,N,Y,0,166500.0,Working,Secondary / secondary special,Married,House / apartment,-18926,-6276,1,1,1,0,Laborers,2.0,-10,0
3020,5009010,M,N,Y,0,166500.0,Working,Secondary / secondary special,Married,House / apartment,-18926,-6276,1,1,1,0,Laborers,2.0,-11,0
3021,5009010,M,N,Y,0,166500.0,Working,Secondary / secondary special,Married,House / apartment,-18926,-6276,1,1,1,0,Laborers,2.0,-12,0
3022,5009012,M,N,Y,0,166500.0,Working,Secondary / secondary special,Married,House / apartment,-18926,-6276,1,1,1,0,Laborers,2.0,0,0
3023,5009012,M,N,Y,0,166500.0,Working,Secondary / secondary special,Married,House / apartment,-18926,-6276,1,1,1,0,Laborers,2.0,-1,0
3024,5009012,M,N,Y,0,166500.0,Working,Secondary / secondary special,Married,House / apartment,-18926,-6276,1,1,1,0,Laborers,2.0,-2,0
3025,5009012,M,N,Y,0,166500.0,Working,Secondary / secondary special,Married,House / apartment,-18926,-6276,1,1,1,0,Laborers,2.0,-3,X
3026,5009012,M,N,Y,0,166500.0,Working,Secondary / secondary special,Married,House / apartment,-18926,-6276,1,1,1,0,Laborers,2.0,-4,X
3027,5009012,M,N,Y,0,166500.0,Working,Secondary / secondary special,Married,House / apartment,-18926,-6276,1,1,1,0,Laborers,2.0,-5,X
3028,5009014,M,N,Y,0,166500.0,Working,Secondary / secondary special,Married,House / apartment,-18926,-6276,1,1,1,0,Laborers,2.0,-29,X
3029,5009014,M,N,Y,0,166500.0,Working,Secondary / secondary special,Married,House / apartment,-18926,-6276,1,1,1,0,Laborers,2.0,-30,0
3030,5009014,M,N,Y,0,166500.0,Working,Secondary / secondary special,Married,House / apartment,-18926,-6276,1,1,1,0,Laborers,2.0,-31,0
3031,5009014,M,N,Y,0,166500.0,Working,Secondary / secondary special,Married,House / apartment,-18926,-6276,1,1,1,0,Laborers,2.0,-32,0
3032,5009014,M,N,Y,0,166500.0,Working,Secondary / secondary special,Married,House / apartment,-18926,-6276,1,1,1,0,Laborers,2.0,-33,0
3033,5009014,M,N,Y,0,166500.0,Working,Secondary / secondary special,Married,House / apartment,-18926,-6276,1,1,1,0,Laborers,2.0,-34,0
3034,5009014,M,N,Y,0,166500.0,Working,Secondary / secondary special,Married,House / apartment,-18926,-6276,1,1,1,0,Laborers,2.0,-35,0
3035,5009016,F,N,Y,2,216000.0,State servant,Higher education,Married,House / apartment,-15444,-3112,1,0,0,1,,4.0,0,C
3036,5009016,F,N,Y,2,216000.0,State servant,Higher education,Married,House / apartment,-15444,-3112,1,0,0,1,,4.0,-1,C
3037,5009016,F,N,Y,2,216000.0,State servant,Higher education,Married,House / apartment,-15444,-3112,1,0,0,1,,4.0,-2,C
3038,5009016,F,N,Y,2,216000.0,State servant,Higher education,Married,House / apartment,-15444,-3112,1,0,0,1,,4.0,-3,C
3039,5009016,F,N,Y,2,216000.0,State servant,Higher education,Married,House / apartment,-15444,-3112,1,0,0,1,,4.0,-4,C
3040,5009016,F,N,Y,2,216000.0,State servant,Higher education,Married,House / apartment,-15444,-3112,1,0,0,1,,4.0,-5,C
3041,5009016,F,N,Y,2,216000.0,State servant,Higher education,Married,House / apartment,-15444,-3112,1,0,0,1,,4.0,-6,C
3042,5009016,F,N,Y,2,216000.0,State servant,Higher education,Married,House / apartment,-15444,-3112,1,0,0,1,,4.0,-7,C
3043,5009016,F,N,Y,2,216000.0,State servant,Higher education,Married,House / apartment,-15444,-3112,1,0,0,1,,4.0,-8,C
3044,5009016,F,N,Y,2,216000.0,State servant,Higher education,Married,House / apartment,-15444,-3112,1,0,0,1,,4.0,-9,C
3045,5009016,F,N,Y,2,216000.0,State servant,Higher education,Married,House / apartment,-15444,-3112,1,0,0,1,,4.0,-10,C
3046,5009016,F,N,Y,2,216000.0,State servant,Higher education,Married,House / apartment,-15444,-3112,1,0,0,1,,4.0,-11,C
3047,5009016,F,N,Y,2,216000.0,State servant,Higher education,Married,House / apartment,-15444,-3112,1,0,0,1,,4.0,-12,C
3048,5009016,F,N,Y,2,216000.0,State servant,Higher education,Married,House / apartment,-15444,-3112,1,0,0,1,,4.0,-13,C
3049,5009016,F,N,Y,2,216000.0,State servant,Higher education,Married,House / apartment,-15444,-3112,1,0,0,1,,4.0,-14,C
3050,5009016,F,N,Y,2,216000.0,State servant,Higher education,Married,House / apartment,-15444,-3112,1,0,0,1,,4.0,-15,C
3051,5009016,F,N,Y,2,216000.0,State servant,Higher education,Married,House / apartment,-15444,-3112,1,0,0,1,,4.0,-16,C
3052,5009016,F,N,Y,2,216000.0,State servant,Higher education,Married,House / apartment,-15444,-3112,1,0,0,1,,4.0,-17,C
3053,5009016,F,N,Y,2,216000.0,State servant,Higher education,Married,House / apartment,-15444,-3112,1,0,0,1,,4.0,-18,C
3054,5009016,F,N,Y,2,216000.0,State servant,Higher education,Married,House / apartment,-15444,-3112,1,0,0,1,,4.0,-19,0
3055,5009016,F,N,Y,2,216000.0,State servant,Higher education,Married,House / apartment,-15444,-3112,1,0,0,1,,4.0,-20,0
3056,5009016,F,N,Y,2,216000.0,State servant,Higher education,Married,House / apartment,-15444,-3112,1,0,0,1,,4.0,-21,0
3057,5009016,F,N,Y,2,216000.0,State servant,Higher education,Married,House / apartment,-15444,-3112,1,0,0,1,,4.0,-22,0
3058,5009016,F,N,Y,2,216000.0,State servant,Higher education,Married,House / apartment,-15444,-3112,1,0,0,1,,4.0,-23,0
3059,5009016,F,N,Y,2,216000.0,State servant,Higher education,Married,House / apartment,-15444,-3112,1,0,0,1,,4.0,-24,0
3060,5009018,F,N,Y,2,216000.0,State servant,Higher education,Married,House / apartment,-15444,-3112,1,0,0,1,,4.0,-31,C
3061,5009018,F,N,Y,2,216000.0,State servant,Higher education,Married,House / apartment,-15444,-3112,1,0,0,1,,4.0,-32,C
3062,5009018,F,N,Y,2,216000.0,State servant,Higher education,Married,House / apartment,-15444,-3112,1,0,0,1,,4.0,-33,C
3063,5009018,F,N,Y,2,216000.0,State servant,Higher education,Married,House / apartment,-15444,-3112,1,0,0,1,,4.0,-34,C
3064,5009018,F,N,Y,2,216000.0,State servant,Higher education,Married,House / apartment,-15444,-3112,1,0,0,1,,4.0,-35,C
3065,5009018,F,N,Y,2,216000.0,State servant,Higher education,Married,House / apartment,-15444,-3112,1,0,0,1,,4.0,-36,C
3066,5009018,F,N,Y,2,216000.0,State servant,Higher education,Married,House / apartment,-15444,-3112,1,0,0,1,,4.0,-37,C
3067,5009018,F,N,Y,2,216000.0,State servant,Higher education,Married,House / apartment,-15444,-3112,1,0,0,1,,4.0,-38,C
3068,5009018,F,N,Y,2,216000.0,State servant,Higher education,Married,House / apartment,-15444,-3112,1,0,0,1,,4.0,-39,C
3069,5009018,F,N,Y,2,216000.0,State servant,Higher education,Married,House / apartment,-15444,-3112,1,0,0,1,,4.0,-40,0
3070,5009018,F,N,Y,2,216000.0,State servant,Higher education,Married,House / apartment,-15444,-3112,1,0,0,1,,4.0,-41,0
3071,5009018,F,N,Y,2,216000.0,State servant,Higher education,Married,House / apartment,-15444,-3112,1,0,0,1,,4.0,-42,0
3072,5009018,F,N,Y,2,216000.0,State servant,Higher education,Married,House / apartment,-15444,-3112,1,0,0,1,,4.0,-43,X
3073,5009019,F,N,Y,2,216000.0,State servant,Higher education,Married,House / apartment,-15444,-3112,1,0,0,1,,4.0,0,0
3074,5009019,F,N,Y,2,216000.0,State servant,Higher education,Married,House / apartment,-15444,-3112,1,0,0,1,,4.0,-1,0
3075,5009019,F,N,Y,2,216000.0,State servant,Higher education,Married,House / apartment,-15444,-3112,1,0,0,1,,4.0,-2,0
3076,5009019,F,N,Y,2,216000.0,State servant,Higher education,Married,House / apartment,-15444,-3112,1,0,0,1,,4.0,-3,0
3077,5009019,F,N,Y,2,216000.0,State servant,Higher education,Married,House / apartment,-15444,-3112,1,0,0,1,,4.0,-4,0
3078,5009019,F,N,Y,2,216000.0,State servant,Higher education,Married,House / apartment,-15444,-3112,1,0,0,1,,4.0,-5,0
3079,5009019,F,N,Y,2,216000.0,State servant,Higher education,Married,House / apartment,-15444,-3112,1,0,0,1,,4.0,-6,0
3080,5009019,F,N,Y,2,216000.0,State servant,Higher education,Married,House / apartment,-15444,-3112,1,0,0,1,,4.0,-7,0
3081,5009019,F,N,Y,2,216000.0,State servant,Higher education,Married,House / apartment,-15444,-3112,1,0,0,1,,4.0,-8,0
3082,5009019,F,N,Y,2,216000.0,State servant,Higher education,Married,House / apartment,-15444,-3112,1,0,0,1,,4.0,-9,0
3083,5009019,F,N,Y,2,216000.0,State servant,Higher education,Married,House / apartment,-15444,-3112,1,0,0,1,,4.0,-10,0
3084,5009019,F,N,Y,2,216000.0,State servant,Higher education,Married,House / apartment,-15444,-3112,1,0,0,1,,4.0,-11,0
3085,5009019,F,N,Y,2,216000.0,State servant,Higher education,Married,House / apartment,-15444,-3112,1,0,0,1,,4.0,-12,0
3086,5009019,F,N,Y,2,216000.0,State servant,Higher education,Married,House / apartment,-15444,-3112,1,0,0,1,,4.0,-13,0
3087,5009019,F,N,Y,2,216000.0,State servant,Higher education,Married,House / apartment,-15444,-3112,1,0,0,1,,4.0,-14,0
3088,5009019,F,N,Y,2,216000.0,State servant,Higher education,Married,House / apartment,-15444,-3112,1,0,0,1,,4.0,-15,0
3089,5009019,F,N,Y,2,216000.0,State servant,Higher education,Married,House / apartment,-15444,-3112,1,0,0,1,,4.0,-16,0
3090,5009019,F,N,Y,2,216000.0,State servant,Higher education,Married,House / apartment,-15444,-3112,1,0,0,1,,4.0,-17,0
3091,5009019,F,N,Y,2,216000.0,State servant,Higher education,Married,House / apartment,-15444,-3112,1,0,0,1,,4.0,-18,0
3092,5009019,F,N,Y,2,216000.0,State servant,Higher education,Married,House / apartment,-15444,-3112,1,0,0,1,,4.0,-19,0
3093,5009019,F,N,Y,2,216000.0,State servant,Higher education,Married,House / apartment,-15444,-3112,1,0,0,1,,4.0,-20,0
3094,5009019,F,N,Y,2,216000.0,State servant,Higher education,Married,House / apartment,-15444,-3112,1,0,0,1,,4.0,-21,0
3095,5009019,F,N,Y,2,216000.0,State servant,Higher education,Married,House / apartment,-15444,-3112,1,0,0,1,,4.0,-22,0
3096,5009019,F,N,Y,2,216000.0,State servant,Higher education,Married,House / apartment,-15444,-3112,1,0,0,1,,4.0,-23,0
3097,5009019,F,N,Y,2,216000.0,State servant,Higher education,Married,House / apartment,-15444,-3112,1,0,0,1,,4.0,-24,0
3098,5009019,F,N,Y,2,216000.0,State servant,Higher education,Married,House / apartment,-15444,-3112,1,0,0,1,,4.0,-25,0
3099,5009019,F,N,Y,2,216000.0,State servant,Higher education,Married,House / apartment,-15444,-3112,1,0,0,1,,4.0,-26,0
3100,5009019,F,N,Y,2,216000.0,State servant,Higher education,Married,House / apartment,-15444,-3112,1,0,0,1,,4.0,-27,0
3101,5009019,F,N,Y,2,216000.0,State servant,Higher education,Married,House / apartment,-15444,-3112,1,0,0,1,,4.0,-28,0
3102,5009019,F,N,Y,2,216000.0,State servant,Higher education,Married,House / apartment,-15444,-3112,1,0,0,1,,4.0,-29,0
3103,5009019,F,N,Y,2,216000.0,State servant,Higher education,Married,House / apartment,-15444,-3112,1,0,0,1,,4.0,-30,0
3104,5009019,F,N,Y,2,216000.0,State servant,Higher education,Married,House / apartment,-15444,-3112,1,0,0,1,,4.0,-31,0
3105,5009019,F,N,Y,2,216000.0,State servant,Higher education,Married,House / apartment,-15444,-3112,1,0,0,1,,4.0,-32,0
3106,5009020,F,N,Y,2,216000.0,State servant,Higher education,Married,House / apartment,-15444,-3112,1,0,0,1,,4.0,-8,C
3107,5009020,F,N,Y,2,216000.0,State servant,Higher education,Married,House / apartment,-15444,-3112,1,0,0,1,,4.0,-9,C
3108,5009020,F,N,Y,2,216000.0,State servant,Higher education,Married,House / apartment,-15444,-3112,1,0,0,1,,4.0,-10,C
3109,5009020,F,N,Y,2,216000.0,State servant,Higher education,Married,House / apartment,-15444,-3112,1,0,0,1,,4.0,-11,C
3110,5009020,F,N,Y,2,216000.0,State servant,Higher education,Married,House / apartment,-15444,-3112,1,0,0,1,,4.0,-12,C
3111,5009020,F,N,Y,2,216000.0,State servant,Higher education,Married,House / apartment,-15444,-3112,1,0,0,1,,4.0,-13,C
3112,5009020,F,N,Y,2,216000.0,State servant,Higher education,Married,House / apartment,-15444,-3112,1,0,0,1,,4.0,-14,C
3113,5009020,F,N,Y,2,216000.0,State servant,Higher education,Married,House / apartment,-15444,-3112,1,0,0,1,,4.0,-15,C
3114,5009020,F,N,Y,2,216000.0,State servant,Higher education,Married,House / apartment,-15444,-3112,1,0,0,1,,4.0,-16,C
3115,5009020,F,N,Y,2,216000.0,State servant,Higher education,Married,House / apartment,-15444,-3112,1,0,0,1,,4.0,-17,C
3116,5009020,F,N,Y,2,216000.0,State servant,Higher education,Married,House / apartment,-15444,-3112,1,0,0,1,,4.0,-18,C
3117,5009020,F,N,Y,2,216000.0,State servant,Higher education,Married,House / apartment,-15444,-3112,1,0,0,1,,4.0,-19,C
3118,5009020,F,N,Y,2,216000.0,State servant,Higher education,Married,House / apartment,-15444,-3112,1,0,0,1,,4.0,-20,C
3119,5009020,F,N,Y,2,216000.0,State servant,Higher education,Married,House / apartment,-15444,-3112,1,0,0,1,,4.0,-21,0
3120,5009020,F,N,Y,2,216000.0,State servant,Higher education,Married,House / apartment,-15444,-3112,1,0,0,1,,4.0,-22,0
3121,5009020,F,N,Y,2,216000.0,State servant,Higher education,Married,House / apartment,-15444,-3112,1,0,0,1,,4.0,-23,0
3122,5009020,F,N,Y,2,216000.0,State servant,Higher education,Married,House / apartment,-15444,-3112,1,0,0,1,,4.0,-24,0
3123,5009020,F,N,Y,2,216000.0,State servant,Higher education,Married,House / apartment,-15444,-3112,1,0,0,1,,4.0,-25,0
3124,5009020,F,N,Y,2,216000.0,State servant,Higher education,Married,House / apartment,-15444,-3112,1,0,0,1,,4.0,-26,0
3125,5009020,F,N,Y,2,216000.0,State servant,Higher education,Married,House / apartment,-15444,-3112,1,0,0,1,,4.0,-27,0
3126,5009020,F,N,Y,2,216000.0,State servant,Higher education,Married,House / apartment,-15444,-3112,1,0,0,1,,4.0,-28,0
3127,5009020,F,N,Y,2,216000.0,State servant,Higher education,Married,House / apartment,-15444,-3112,1,0,0,1,,4.0,-29,0
3128,5009020,F,N,Y,2,216000.0,State servant,Higher education,Married,House / apartment,-15444,-3112,1,0,0,1,,4.0,-30,0
3129,5009020,F,N,Y,2,216000.0,State servant,Higher education,Married,House / apartment,-15444,-3112,1,0,0,1,,4.0,-31,0
3130,5009020,F,N,Y,2,216000.0,State servant,Higher education,Married,House / apartment,-15444,-3112,1,0,0,1,,4.0,-32,0
3131,5009022,F,N,Y,2,216000.0,State servant,Higher education,Married,House / apartment,-15444,-3112,1,0,0,1,,4.0,-2,C
3132,5009022,F,N,Y,2,216000.0,State servant,Higher education,Married,House / apartment,-15444,-3112,1,0,0,1,,4.0,-3,C
3133,5009022,F,N,Y,2,216000.0,State servant,Higher education,Married,House / apartment,-15444,-3112,1,0,0,1,,4.0,-4,C
3134,5009022,F,N,Y,2,216000.0,State servant,Higher education,Married,House / apartment,-15444,-3112,1,0,0,1,,4.0,-5,C
3135,5009022,F,N,Y,2,216000.0,State servant,Higher education,Married,House / apartment,-15444,-3112,1,0,0,1,,4.0,-6,C
3136,5009022,F,N,Y,2,216000.0,State servant,Higher education,Married,House / apartment,-15444,-3112,1,0,0,1,,4.0,-7,C
3137,5009022,F,N,Y,2,216000.0,State servant,Higher education,Married,House / apartment,-15444,-3112,1,0,0,1,,4.0,-8,C
3138,5009022,F,N,Y,2,216000.0,State servant,Higher education,Married,House / apartment,-15444,-3112,1,0,0,1,,4.0,-9,C
3139,5009022,F,N,Y,2,216000.0,State servant,Higher education,Married,House / apartment,-15444,-3112,1,0,0,1,,4.0,-10,C
3140,5009022,F,N,Y,2,216000.0,State servant,Higher education,Married,House / apartment,-15444,-3112,1,0,0,1,,4.0,-11,C
3141,5009022,F,N,Y,2,216000.0,State servant,Higher education,Married,House / apartment,-15444,-3112,1,0,0,1,,4.0,-12,C
3142,5009022,F,N,Y,2,216000.0,State servant,Higher education,Married,House / apartment,-15444,-3112,1,0,0,1,,4.0,-13,C
3143,5009022,F,N,Y,2,216000.0,State servant,Higher education,Married,House / apartment,-15444,-3112,1,0,0,1,,4.0,-14,C
3144,5009022,F,N,Y,2,216000.0,State servant,Higher education,Married,House / apartment,-15444,-3112,1,0,0,1,,4.0,-15,C
3145,5009022,F,N,Y,2,216000.0,State servant,Higher education,Married,House / apartment,-15444,-3112,1,0,0,1,,4.0,-16,C
3146,5009022,F,N,Y,2,216000.0,State servant,Higher education,Married,House / apartment,-15444,-3112,1,0,0,1,,4.0,-17,C
3147,5009022,F,N,Y,2,216000.0,State servant,Higher education,Married,House / apartment,-15444,-3112,1,0,0,1,,4.0,-18,C
3148,5009022,F,N,Y,2,216000.0,State servant,Higher education,Married,House / apartment,-15444,-3112,1,0,0,1,,4.0,-19,C
3149,5009022,F,N,Y,2,216000.0,State servant,Higher education,Married,House / apartment,-15444,-3112,1,0,0,1,,4.0,-20,C
3150,5009022,F,N,Y,2,216000.0,State servant,Higher education,Married,House / apartment,-15444,-3112,1,0,0,1,,4.0,-21,C
3151,5009022,F,N,Y,2,216000.0,State servant,Higher education,Married,House / apartment,-15444,-3112,1,0,0,1,,4.0,-22,C
3152,5009022,F,N,Y,2,216000.0,State servant,Higher education,Married,House / apartment,-15444,-3112,1,0,0,1,,4.0,-23,C
3153,5009022,F,N,Y,2,216000.0,State servant,Higher education,Married,House / apartment,-15444,-3112,1,0,0,1,,4.0,-24,C
3154,5009022,F,N,Y,2,216000.0,State servant,Higher education,Married,House / apartment,-15444,-3112,1,0,0,1,,4.0,-25,C
3155,5009022,F,N,Y,2,216000.0,State servant,Higher education,Married,House / apartment,-15444,-3112,1,0,0,1,,4.0,-26,C
3156,5009022,F,N,Y,2,216000.0,State servant,Higher education,Married,House / apartment,-15444,-3112,1,0,0,1,,4.0,-27,C
3157,5009022,F,N,Y,2,216000.0,State servant,Higher education,Married,House / apartment,-15444,-3112,1,0,0,1,,4.0,-28,C
3158,5009022,F,N,Y,2,216000.0,State servant,Higher education,Married,House / apartment,-15444,-3112,1,0,0,1,,4.0,-29,C
3159,5009022,F,N,Y,2,216000.0,State servant,Higher education,Married,House / apartment,-15444,-3112,1,0,0,1,,4.0,-30,C
3160,5009022,F,N,Y,2,216000.0,State servant,Higher education,Married,House / apartment,-15444,-3112,1,0,0,1,,4.0,-31,C
3161,5009022,F,N,Y,2,216000.0,State servant,Higher education,Married,House / apartment,-15444,-3112,1,0,0,1,,4.0,-32,C
3162,5009022,F,N,Y,2,216000.0,State servant,Higher education,Married,House / apartment,-15444,-3112,1,0,0,1,,4.0,-33,C
3163,5009022,F,N,Y,2,216000.0,State servant,Higher education,Married,House / apartment,-15444,-3112,1,0,0,1,,4.0,-34,C
3164,5009022,F,N,Y,2,216000.0,State servant,Higher education,Married,House / apartment,-15444,-3112,1,0,0,1,,4.0,-35,C
3165,5009022,F,N,Y,2,216000.0,State servant,Higher education,Married,House / apartment,-15444,-3112,1,0,0,1,,4.0,-36,0
3166,5009022,F,N,Y,2,216000.0,State servant,Higher education,Married,House / apartment,-15444,-3112,1,0,0,1,,4.0,-37,0
3167,5009022,F,N,Y,2,216000.0,State servant,Higher education,Married,House / apartment,-15444,-3112,1,0,0,1,,4.0,-38,0
3168,5009022,F,N,Y,2,216000.0,State servant,Higher education,Married,House / apartment,-15444,-3112,1,0,0,1,,4.0,-39,0
3169,5009022,F,N,Y,2,216000.0,State servant,Higher education,Married,House / apartment,-15444,-3112,1,0,0,1,,4.0,-40,0
3170,5009022,F,N,Y,2,216000.0,State servant,Higher education,Married,House / apartment,-15444,-3112,1,0,0,1,,4.0,-41,0
3171,5009023,F,N,Y,2,216000.0,State servant,Higher education,Married,House / apartment,-15444,-3112,1,0,0,1,,4.0,0,C
3172,5009023,F,N,Y,2,216000.0,State servant,Higher education,Married,House / apartment,-15444,-3112,1,0,0,1,,4.0,-1,C
3173,5009023,F,N,Y,2,216000.0,State servant,Higher education,Married,House / apartment,-15444,-3112,1,0,0,1,,4.0,-2,C
3174,5009023,F,N,Y,2,216000.0,State servant,Higher education,Married,House / apartment,-15444,-3112,1,0,0,1,,4.0,-3,C
3175,5009023,F,N,Y,2,216000.0,State servant,Higher education,Married,House / apartment,-15444,-3112,1,0,0,1,,4.0,-4,C
3176,5009023,F,N,Y,2,216000.0,State servant,Higher education,Married,House / apartment,-15444,-3112,1,0,0,1,,4.0,-5,C
3177,5009023,F,N,Y,2,216000.0,State servant,Higher education,Married,House / apartment,-15444,-3112,1,0,0,1,,4.0,-6,C
3178,5009023,F,N,Y,2,216000.0,State servant,Higher education,Married,House / apartment,-15444,-3112,1,0,0,1,,4.0,-7,C
3179,5009023,F,N,Y,2,216000.0,State servant,Higher education,Married,House / apartment,-15444,-3112,1,0,0,1,,4.0,-8,C
3180,5009023,F,N,Y,2,216000.0,State servant,Higher education,Married,House / apartment,-15444,-3112,1,0,0,1,,4.0,-9,C
3181,5009023,F,N,Y,2,216000.0,State servant,Higher education,Married,House / apartment,-15444,-3112,1,0,0,1,,4.0,-10,C
3182,5009023,F,N,Y,2,216000.0,State servant,Higher education,Married,House / apartment,-15444,-3112,1,0,0,1,,4.0,-11,C
3183,5009023,F,N,Y,2,216000.0,State servant,Higher education,Married,House / apartment,-15444,-3112,1,0,0,1,,4.0,-12,C
3184,5009023,F,N,Y,2,216000.0,State servant,Higher education,Married,House / apartment,-15444,-3112,1,0,0,1,,4.0,-13,C
3185,5009023,F,N,Y,2,216000.0,State servant,Higher education,Married,House / apartment,-15444,-3112,1,0,0,1,,4.0,-14,C
3186,5009023,F,N,Y,2,216000.0,State servant,Higher education,Married,House / apartment,-15444,-3112,1,0,0,1,,4.0,-15,C
3187,5009023,F,N,Y,2,216000.0,State servant,Higher education,Married,House / apartment,-15444,-3112,1,0,0,1,,4.0,-16,C
3188,5009023,F,N,Y,2,216000.0,State servant,Higher education,Married,House / apartment,-15444,-3112,1,0,0,1,,4.0,-17,C
3189,5009023,F,N,Y,2,216000.0,State servant,Higher education,Married,House / apartment,-15444,-3112,1,0,0,1,,4.0,-18,C
3190,5009023,F,N,Y,2,216000.0,State servant,Higher education,Married,House / apartment,-15444,-3112,1,0,0,1,,4.0,-19,C
3191,5009023,F,N,Y,2,216000.0,State servant,Higher education,Married,House / apartment,-15444,-3112,1,0,0,1,,4.0,-20,C
3192,5009023,F,N,Y,2,216000.0,State servant,Higher education,Married,House / apartment,-15444,-3112,1,0,0,1,,4.0,-21,C
3193,5009023,F,N,Y,2,216000.0,State servant,Higher education,Married,House / apartment,-15444,-3112,1,0,0,1,,4.0,-22,C
3194,5009023,F,N,Y,2,216000.0,State servant,Higher education,Married,House / apartment,-15444,-3112,1,0,0,1,,4.0,-23,C
3195,5009023,F,N,Y,2,216000.0,State servant,Higher education,Married,House / apartment,-15444,-3112,1,0,0,1,,4.0,-24,C
3196,5009023,F,N,Y,2,216000.0,State servant,Higher education,Married,House / apartment,-15444,-3112,1,0,0,1,,4.0,-25,C
3197,5009023,F,N,Y,2,216000.0,State servant,Higher education,Married,House / apartment,-15444,-3112,1,0,0,1,,4.0,-26,C
3198,5009023,F,N,Y,2,216000.0,State servant,Higher education,Married,House / apartment,-15444,-3112,1,0,0,1,,4.0,-27,C
3199,5009023,F,N,Y,2,216000.0,State servant,Higher education,Married,House / apartment,-15444,-3112,1,0,0,1,,4.0,-28,C
3200,5009023,F,N,Y,2,216000.0,State servant,Higher education,Married,House / apartment,-15444,-3112,1,0,0,1,,4.0,-29,C
3201,5009023,F,N,Y,2,216000.0,State servant,Higher education,Married,House / apartment,-15444,-3112,1,0,0,1,,4.0,-30,0
3202,5009023,F,N,Y,2,216000.0,State servant,Higher education,Married,House / apartment,-15444,-3112,1,0,0,1,,4.0,-31,0
3203,5009023,F,N,Y,2,216000.0,State servant,Higher education,Married,House / apartment,-15444,-3112,1,0,0,1,,4.0,-32,0
3204,5009023,F,N,Y,2,216000.0,State servant,Higher education,Married,House / apartment,-15444,-3112,1,0,0,1,,4.0,-33,0
3205,5009023,F,N,Y,2,216000.0,State servant,Higher education,Married,House / apartment,-15444,-3112,1,0,0,1,,4.0,-34,0
3206,5009023,F,N,Y,2,216000.0,State servant,Higher education,Married,House / apartment,-15444,-3112,1,0,0,1,,4.0,-35,0
3207,5009024,F,N,Y,2,216000.0,State servant,Higher education,Married,House / apartment,-15444,-3112,1,0,0,1,,4.0,0,C
3208,5009024,F,N,Y,2,216000.0,State servant,Higher education,Married,House / apartment,-15444,-3112,1,0,0,1,,4.0,-1,C
3209,5009024,F,N,Y,2,216000.0,State servant,Higher education,Married,House / apartment,-15444,-3112,1,0,0,1,,4.0,-2,C
3210,5009024,F,N,Y,2,216000.0,State servant,Higher education,Married,House / apartment,-15444,-3112,1,0,0,1,,4.0,-3,0
3211,5009024,F,N,Y,2,216000.0,State servant,Higher education,Married,House / apartment,-15444,-3112,1,0,0,1,,4.0,-4,0
3212,5009024,F,N,Y,2,216000.0,State servant,Higher education,Married,House / apartment,-15444,-3112,1,0,0,1,,4.0,-5,0
3213,5009024,F,N,Y,2,216000.0,State servant,Higher education,Married,House / apartment,-15444,-3112,1,0,0,1,,4.0,-6,0
3214,5009024,F,N,Y,2,216000.0,State servant,Higher education,Married,House / apartment,-15444,-3112,1,0,0,1,,4.0,-7,0
3215,5009024,F,N,Y,2,216000.0,State servant,Higher education,Married,House / apartment,-15444,-3112,1,0,0,1,,4.0,-8,0
3216,5009025,F,N,Y,2,216000.0,State servant,Higher education,Married,House / apartment,-15444,-3112,1,0,0,1,,4.0,0,C
3217,5009025,F,N,Y,2,216000.0,State servant,Higher education,Married,House / apartment,-15444,-3112,1,0,0,1,,4.0,-1,C
3218,5009025,F,N,Y,2,216000.0,State servant,Higher education,Married,House / apartment,-15444,-3112,1,0,0,1,,4.0,-2,C
3219,5009025,F,N,Y,2,216000.0,State servant,Higher education,Married,House / apartment,-15444,-3112,1,0,0,1,,4.0,-3,C
3220,5009025,F,N,Y,2,216000.0,State servant,Higher education,Married,House / apartment,-15444,-3112,1,0,0,1,,4.0,-4,C
3221,5009025,F,N,Y,2,216000.0,State servant,Higher education,Married,House / apartment,-15444,-3112,1,0,0,1,,4.0,-5,C
3222,5009025,F,N,Y,2,216000.0,State servant,Higher education,Married,House / apartment,-15444,-3112,1,0,0,1,,4.0,-6,C
3223,5009025,F,N,Y,2,216000.0,State servant,Higher education,Married,House / apartment,-15444,-3112,1,0,0,1,,4.0,-7,C
3224,5009025,F,N,Y,2,216000.0,State servant,Higher education,Married,House / apartment,-15444,-3112,1,0,0,1,,4.0,-8,C
3225,5009025,F,N,Y,2,216000.0,State servant,Higher education,Married,House / apartment,-15444,-3112,1,0,0,1,,4.0,-9,C
3226,5009025,F,N,Y,2,216000.0,State servant,Higher education,Married,House / apartment,-15444,-3112,1,0,0,1,,4.0,-10,C
3227,5009025,F,N,Y,2,216000.0,State servant,Higher education,Married,House / apartment,-15444,-3112,1,0,0,1,,4.0,-11,C
3228,5009025,F,N,Y,2,216000.0,State servant,Higher education,Married,House / apartment,-15444,-3112,1,0,0,1,,4.0,-12,C
3229,5009025,F,N,Y,2,216000.0,State servant,Higher education,Married,House / apartment,-15444,-3112,1,0,0,1,,4.0,-13,C
3230,5009025,F,N,Y,2,216000.0,State servant,Higher education,Married,House / apartment,-15444,-3112,1,0,0,1,,4.0,-14,C
3231,5009025,F,N,Y,2,216000.0,State servant,Higher education,Married,House / apartment,-15444,-3112,1,0,0,1,,4.0,-15,C
3232,5009025,F,N,Y,2,216000.0,State servant,Higher education,Married,House / apartment,-15444,-3112,1,0,0,1,,4.0,-16,C
3233,5009025,F,N,Y,2,216000.0,State servant,Higher education,Married,House / apartment,-15444,-3112,1,0,0,1,,4.0,-17,C
3234,5009025,F,N,Y,2,216000.0,State servant,Higher education,Married,House / apartment,-15444,-3112,1,0,0,1,,4.0,-18,C
3235,5009025,F,N,Y,2,216000.0,State servant,Higher education,Married,House / apartment,-15444,-3112,1,0,0,1,,4.0,-19,C
3236,5009025,F,N,Y,2,216000.0,State servant,Higher education,Married,House / apartment,-15444,-3112,1,0,0,1,,4.0,-20,C
3237,5009025,F,N,Y,2,216000.0,State servant,Higher education,Married,House / apartment,-15444,-3112,1,0,0,1,,4.0,-21,C
3238,5009025,F,N,Y,2,216000.0,State servant,Higher education,Married,House / apartment,-15444,-3112,1,0,0,1,,4.0,-22,C
3239,5009025,F,N,Y,2,216000.0,State servant,Higher education,Married,House / apartment,-15444,-3112,1,0,0,1,,4.0,-23,C
3240,5009025,F,N,Y,2,216000.0,State servant,Higher education,Married,House / apartment,-15444,-3112,1,0,0,1,,4.0,-24,C
3241,5009025,F,N,Y,2,216000.0,State servant,Higher education,Married,House / apartment,-15444,-3112,1,0,0,1,,4.0,-25,C
3242,5009025,F,N,Y,2,216000.0,State servant,Higher education,Married,House / apartment,-15444,-3112,1,0,0,1,,4.0,-26,C
3243,5009025,F,N,Y,2,216000.0,State servant,Higher education,Married,House / apartment,-15444,-3112,1,0,0,1,,4.0,-27,C
3244,5009025,F,N,Y,2,216000.0,State servant,Higher education,Married,House / apartment,-15444,-3112,1,0,0,1,,4.0,-28,0
3245,5009025,F,N,Y,2,216000.0,State servant,Higher education,Married,House / apartment,-15444,-3112,1,0,0,1,,4.0,-29,0
3246,5009025,F,N,Y,2,216000.0,State servant,Higher education,Married,House / apartment,-15444,-3112,1,0,0,1,,4.0,-30,0
3247,5009025,F,N,Y,2,216000.0,State servant,Higher education,Married,House / apartment,-15444,-3112,1,0,0,1,,4.0,-31,0
3248,5009025,F,N,Y,2,216000.0,State servant,Higher education,Married,House / apartment,-15444,-3112,1,0,0,1,,4.0,-32,0
3249,5009025,F,N,Y,2,216000.0,State servant,Higher education,Married,House / apartment,-15444,-3112,1,0,0,1,,4.0,-33,0
3250,5009027,F,Y,Y,0,270000.0,Commercial associate,Secondary / secondary special,Married,House / apartment,-19861,-10843,1,0,0,1,Laborers,2.0,0,0
3251,5009027,F,Y,Y,0,270000.0,Commercial associate,Secondary / secondary special,Married,House / apartment,-19861,-10843,1,0,0,1,Laborers,2.0,-1,0
3252,5009027,F,Y,Y,0,270000.0,Commercial associate,Secondary / secondary special,Married,House / apartment,-19861,-10843,1,0,0,1,Laborers,2.0,-2,X
3253,5009027,F,Y,Y,0,270000.0,Commercial associate,Secondary / secondary special,Married,House / apartment,-19861,-10843,1,0,0,1,Laborers,2.0,-3,0
3254,5009027,F,Y,Y,0,270000.0,Commercial associate,Secondary / secondary special,Married,House / apartment,-19861,-10843,1,0,0,1,Laborers,2.0,-4,0
3255,5009027,F,Y,Y,0,270000.0,Commercial associate,Secondary / secondary special,Married,House / apartment,-19861,-10843,1,0,0,1,Laborers,2.0,-5,0
3256,5009027,F,Y,Y,0,270000.0,Commercial associate,Secondary / secondary special,Married,House / apartment,-19861,-10843,1,0,0,1,Laborers,2.0,-6,X
3257,5009027,F,Y,Y,0,270000.0,Commercial associate,Secondary / secondary special,Married,House / apartment,-19861,-10843,1,0,0,1,Laborers,2.0,-7,0
3258,5009027,F,Y,Y,0,270000.0,Commercial associate,Secondary / secondary special,Married,House / apartment,-19861,-10843,1,0,0,1,Laborers,2.0,-8,X
3259,5009027,F,Y,Y,0,270000.0,Commercial associate,Secondary / secondary special,Married,House / apartment,-19861,-10843,1,0,0,1,Laborers,2.0,-9,0
3260,5009027,F,Y,Y,0,270000.0,Commercial associate,Secondary / secondary special,Married,House / apartment,-19861,-10843,1,0,0,1,Laborers,2.0,-10,0
3261,5009027,F,Y,Y,0,270000.0,Commercial associate,Secondary / secondary special,Married,House / apartment,-19861,-10843,1,0,0,1,Laborers,2.0,-11,X
3262,5009027,F,Y,Y,0,270000.0,Commercial associate,Secondary / secondary special,Married,House / apartment,-19861,-10843,1,0,0,1,Laborers,2.0,-12,0
3263,5009027,F,Y,Y,0,270000.0,Commercial associate,Secondary / secondary special,Married,House / apartment,-19861,-10843,1,0,0,1,Laborers,2.0,-13,0
3264,5009027,F,Y,Y,0,270000.0,Commercial associate,Secondary / secondary special,Married,House / apartment,-19861,-10843,1,0,0,1,Laborers,2.0,-14,0
3265,5009027,F,Y,Y,0,270000.0,Commercial associate,Secondary / secondary special,Married,House / apartment,-19861,-10843,1,0,0,1,Laborers,2.0,-15,0
3266,5009027,F,Y,Y,0,270000.0,Commercial associate,Secondary / secondary special,Married,House / apartment,-19861,-10843,1,0,0,1,Laborers,2.0,-16,0
3267,5009027,F,Y,Y,0,270000.0,Commercial associate,Secondary / secondary special,Married,House / apartment,-19861,-10843,1,0,0,1,Laborers,2.0,-17,0
3268,5009027,F,Y,Y,0,270000.0,Commercial associate,Secondary / secondary special,Married,House / apartment,-19861,-10843,1,0,0,1,Laborers,2.0,-18,X
3269,5009027,F,Y,Y,0,270000.0,Commercial associate,Secondary / secondary special,Married,House / apartment,-19861,-10843,1,0,0,1,Laborers,2.0,-19,0
3270,5009027,F,Y,Y,0,270000.0,Commercial associate,Secondary / secondary special,Married,House / apartment,-19861,-10843,1,0,0,1,Laborers,2.0,-20,X
3271,5009027,F,Y,Y,0,270000.0,Commercial associate,Secondary / secondary special,Married,House / apartment,-19861,-10843,1,0,0,1,Laborers,2.0,-21,X
3272,5112862,F,Y,Y,0,270000.0,Commercial associate,Secondary / secondary special,Married,House / apartment,-19861,-10843,1,0,0,1,Laborers,2.0,-12,C
3273,5112862,F,Y,Y,0,270000.0,Commercial associate,Secondary / secondary special,Married,House / apartment,-19861,-10843,1,0,0,1,Laborers,2.0,-13,C
3274,5112862,F,Y,Y,0,270000.0,Commercial associate,Secondary / secondary special,Married,House / apartment,-19861,-10843,1,0,0,1,Laborers,2.0,-14,C
3275,5112862,F,Y,Y,0,270000.0,Commercial associate,Secondary / secondary special,Married,House / apartment,-19861,-10843,1,0,0,1,Laborers,2.0,-15,C
3276,5112862,F,Y,Y,0,270000.0,Commercial associate,Secondary / secondary special,Married,House / apartment,-19861,-10843,1,0,0,1,Laborers,2.0,-16,C
3277,5112862,F,Y,Y,0,270000.0,Commercial associate,Secondary / secondary special,Married,House / apartment,-19861,-10843,1,0,0,1,Laborers,2.0,-17,C
3278,5112862,F,Y,Y,0,270000.0,Commercial associate,Secondary / secondary special,Married,House / apartment,-19861,-10843,1,0,0,1,Laborers,2.0,-18,C
3279,5112862,F,Y,Y,0,270000.0,Commercial associate,Secondary / secondary special,Married,House / apartment,-19861,-10843,1,0,0,1,Laborers,2.0,-19,C
3280,5112862,F,Y,Y,0,270000.0,Commercial associate,Secondary / secondary special,Married,House / apartment,-19861,-10843,1,0,0,1,Laborers,2.0,-20,C
3281,5112862,F,Y,Y,0,270000.0,Commercial associate,Secondary / secondary special,Married,House / apartment,-19861,-10843,1,0,0,1,Laborers,2.0,-21,C
3282,5112862,F,Y,Y,0,270000.0,Commercial associate,Secondary / secondary special,Married,House / apartment,-19861,-10843,1,0,0,1,Laborers,2.0,-22,C
3283,5112862,F,Y,Y,0,270000.0,Commercial associate,Secondary / secondary special,Married,House / apartment,-19861,-10843,1,0,0,1,Laborers,2.0,-23,C
3284,5112862,F,Y,Y,0,270000.0,Commercial associate,Secondary / secondary special,Married,House / apartment,-19861,-10843,1,0,0,1,Laborers,2.0,-24,C
3285,5112862,F,Y,Y,0,270000.0,Commercial associate,Secondary / secondary special,Married,House / apartment,-19861,-10843,1,0,0,1,Laborers,2.0,-25,C
3286,5112862,F,Y,Y,0,270000.0,Commercial associate,Secondary / secondary special,Married,House / apartment,-19861,-10843,1,0,0,1,Laborers,2.0,-26,C
3287,5112862,F,Y,Y,0,270000.0,Commercial associate,Secondary / secondary special,Married,House / apartment,-19861,-10843,1,0,0,1,Laborers,2.0,-27,C
3288,5112862,F,Y,Y,0,270000.0,Commercial associate,Secondary / secondary special,Married,House / apartment,-19861,-10843,1,0,0,1,Laborers,2.0,-28,C
3289,5112862,F,Y,Y,0,270000.0,Commercial associate,Secondary / secondary special,Married,House / apartment,-19861,-10843,1,0,0,1,Laborers,2.0,-29,C
3290,5112862,F,Y,Y,0,270000.0,Commercial associate,Secondary / secondary special,Married,House / apartment,-19861,-10843,1,0,0,1,Laborers,2.0,-30,C
3291,5112862,F,Y,Y,0,270000.0,Commercial associate,Secondary / secondary special,Married,House / apartment,-19861,-10843,1,0,0,1,Laborers,2.0,-31,C
3292,5112862,F,Y,Y,0,270000.0,Commercial associate,Secondary / secondary special,Married,House / apartment,-19861,-10843,1,0,0,1,Laborers,2.0,-32,C
3293,5112862,F,Y,Y,0,270000.0,Commercial associate,Secondary / secondary special,Married,House / apartment,-19861,-10843,1,0,0,1,Laborers,2.0,-33,C
3294,5112862,F,Y,Y,0,270000.0,Commercial associate,Secondary / secondary special,Married,House / apartment,-19861,-10843,1,0,0,1,Laborers,2.0,-34,C
3295,5112862,F,Y,Y,0,270000.0,Commercial associate,Secondary / secondary special,Married,House / apartment,-19861,-10843,1,0,0,1,Laborers,2.0,-35,C
3296,5112862,F,Y,Y,0,270000.0,Commercial associate,Secondary / secondary special,Married,House / apartment,-19861,-10843,1,0,0,1,Laborers,2.0,-36,0
3297,5112862,F,Y,Y,0,270000.0,Commercial associate,Secondary / secondary special,Married,House / apartment,-19861,-10843,1,0,0,1,Laborers,2.0,-37,0
3298,5112862,F,Y,Y,0,270000.0,Commercial associate,Secondary / secondary special,Married,House / apartment,-19861,-10843,1,0,0,1,Laborers,2.0,-38,0
3299,5112862,F,Y,Y,0,270000.0,Commercial associate,Secondary / secondary special,Married,House / apartment,-19861,-10843,1,0,0,1,Laborers,2.0,-39,0
3300,5112862,F,Y,Y,0,270000.0,Commercial associate,Secondary / secondary special,Married,House / apartment,-19861,-10843,1,0,0,1,Laborers,2.0,-40,0
3301,5009028,F,Y,Y,0,225000.0,Commercial associate,Secondary / secondary special,Married,House / apartment,-14450,-2777,1,0,0,0,Laborers,2.0,-7,X
3302,5009028,F,Y,Y,0,225000.0,Commercial associate,Secondary / secondary special,Married,House / apartment,-14450,-2777,1,0,0,0,Laborers,2.0,-8,0
3303,5009028,F,Y,Y,0,225000.0,Commercial associate,Secondary / secondary special,Married,House / apartment,-14450,-2777,1,0,0,0,Laborers,2.0,-9,0
3304,5009028,F,Y,Y,0,225000.0,Commercial associate,Secondary / secondary special,Married,House / apartment,-14450,-2777,1,0,0,0,Laborers,2.0,-10,0
3305,5009028,F,Y,Y,0,225000.0,Commercial associate,Secondary / secondary special,Married,House / apartment,-14450,-2777,1,0,0,0,Laborers,2.0,-11,0
3306,5009028,F,Y,Y,0,225000.0,Commercial associate,Secondary / secondary special,Married,House / apartment,-14450,-2777,1,0,0,0,Laborers,2.0,-12,0
3307,5009028,F,Y,Y,0,225000.0,Commercial associate,Secondary / secondary special,Married,House / apartment,-14450,-2777,1,0,0,0,Laborers,2.0,-13,1
3308,5009028,F,Y,Y,0,225000.0,Commercial associate,Secondary / secondary special,Married,House / apartment,-14450,-2777,1,0,0,0,Laborers,2.0,-14,0
3309,5009028,F,Y,Y,0,225000.0,Commercial associate,Secondary / secondary special,Married,House / apartment,-14450,-2777,1,0,0,0,Laborers,2.0,-15,0
3310,5009028,F,Y,Y,0,225000.0,Commercial associate,Secondary / secondary special,Married,House / apartment,-14450,-2777,1,0,0,0,Laborers,2.0,-16,0
3311,5009028,F,Y,Y,0,225000.0,Commercial associate,Secondary / secondary special,Married,House / apartment,-14450,-2777,1,0,0,0,Laborers,2.0,-17,0
3312,5009029,F,Y,Y,0,225000.0,Commercial associate,Secondary / secondary special,Married,House / apartment,-14450,-2777,1,0,0,0,Laborers,2.0,0,C
3313,5009029,F,Y,Y,0,225000.0,Commercial associate,Secondary / secondary special,Married,House / apartment,-14450,-2777,1,0,0,0,Laborers,2.0,-1,C
3314,5009029,F,Y,Y,0,225000.0,Commercial associate,Secondary / secondary special,Married,House / apartment,-14450,-2777,1,0,0,0,Laborers,2.0,-2,C
3315,5009029,F,Y,Y,0,225000.0,Commercial associate,Secondary / secondary special,Married,House / apartment,-14450,-2777,1,0,0,0,Laborers,2.0,-3,C
3316,5009029,F,Y,Y,0,225000.0,Commercial associate,Secondary / secondary special,Married,House / apartment,-14450,-2777,1,0,0,0,Laborers,2.0,-4,C
3317,5009029,F,Y,Y,0,225000.0,Commercial associate,Secondary / secondary special,Married,House / apartment,-14450,-2777,1,0,0,0,Laborers,2.0,-5,C
3318,5009029,F,Y,Y,0,225000.0,Commercial associate,Secondary / secondary special,Married,House / apartment,-14450,-2777,1,0,0,0,Laborers,2.0,-6,C
3319,5009029,F,Y,Y,0,225000.0,Commercial associate,Secondary / secondary special,Married,House / apartment,-14450,-2777,1,0,0,0,Laborers,2.0,-7,C
3320,5009029,F,Y,Y,0,225000.0,Commercial associate,Secondary / secondary special,Married,House / apartment,-14450,-2777,1,0,0,0,Laborers,2.0,-8,C
3321,5009029,F,Y,Y,0,225000.0,Commercial associate,Secondary / secondary special,Married,House / apartment,-14450,-2777,1,0,0,0,Laborers,2.0,-9,C
3322,5009029,F,Y,Y,0,225000.0,Commercial associate,Secondary / secondary special,Married,House / apartment,-14450,-2777,1,0,0,0,Laborers,2.0,-10,C
3323,5009029,F,Y,Y,0,225000.0,Commercial associate,Secondary / secondary special,Married,House / apartment,-14450,-2777,1,0,0,0,Laborers,2.0,-11,C
3324,5009029,F,Y,Y,0,225000.0,Commercial associate,Secondary / secondary special,Married,House / apartment,-14450,-2777,1,0,0,0,Laborers,2.0,-12,C
3325,5009029,F,Y,Y,0,225000.0,Commercial associate,Secondary / secondary special,Married,House / apartment,-14450,-2777,1,0,0,0,Laborers,2.0,-13,C
3326,5009029,F,Y,Y,0,225000.0,Commercial associate,Secondary / secondary special,Married,House / apartment,-14450,-2777,1,0,0,0,Laborers,2.0,-14,C
3327,5009029,F,Y,Y,0,225000.0,Commercial associate,Secondary / secondary special,Married,House / apartment,-14450,-2777,1,0,0,0,Laborers,2.0,-15,X
3328,5009031,F,N,Y,0,315000.0,Working,Secondary / secondary special,Single / not married,House / apartment,-10554,-1194,1,0,0,0,Accountants,1.0,0,C
3329,5009031,F,N,Y,0,315000.0,Working,Secondary / secondary special,Single / not married,House / apartment,-10554,-1194,1,0,0,0,Accountants,1.0,-1,C
3330,5009031,F,N,Y,0,315000.0,Working,Secondary / secondary special,Single / not married,House / apartment,-10554,-1194,1,0,0,0,Accountants,1.0,-2,X
3331,5009031,F,N,Y,0,315000.0,Working,Secondary / secondary special,Single / not married,House / apartment,-10554,-1194,1,0,0,0,Accountants,1.0,-3,X
3332,5009031,F,N,Y,0,315000.0,Working,Secondary / secondary special,Single / not married,House / apartment,-10554,-1194,1,0,0,0,Accountants,1.0,-4,X
3333,5009031,F,N,Y,0,315000.0,Working,Secondary / secondary special,Single / not married,House / apartment,-10554,-1194,1,0,0,0,Accountants,1.0,-5,X
3334,5009031,F,N,Y,0,315000.0,Working,Secondary / secondary special,Single / not married,House / apartment,-10554,-1194,1,0,0,0,Accountants,1.0,-6,X
3335,5009031,F,N,Y,0,315000.0,Working,Secondary / secondary special,Single / not married,House / apartment,-10554,-1194,1,0,0,0,Accountants,1.0,-7,X
3336,5009031,F,N,Y,0,315000.0,Working,Secondary / secondary special,Single / not married,House / apartment,-10554,-1194,1,0,0,0,Accountants,1.0,-8,X
3337,5009031,F,N,Y,0,315000.0,Working,Secondary / secondary special,Single / not married,House / apartment,-10554,-1194,1,0,0,0,Accountants,1.0,-9,X
3338,5009031,F,N,Y,0,315000.0,Working,Secondary / secondary special,Single / not married,House / apartment,-10554,-1194,1,0,0,0,Accountants,1.0,-10,X
3339,5009031,F,N,Y,0,315000.0,Working,Secondary / secondary special,Single / not married,House / apartment,-10554,-1194,1,0,0,0,Accountants,1.0,-11,0
3340,5009031,F,N,Y,0,315000.0,Working,Secondary / secondary special,Single / not married,House / apartment,-10554,-1194,1,0,0,0,Accountants,1.0,-12,0
3341,5009031,F,N,Y,0,315000.0,Working,Secondary / secondary special,Single / not married,House / apartment,-10554,-1194,1,0,0,0,Accountants,1.0,-13,X
3342,5009032,F,N,Y,0,315000.0,Working,Secondary / secondary special,Single / not married,House / apartment,-10554,-1194,1,0,0,0,Accountants,1.0,0,C
3343,5009032,F,N,Y,0,315000.0,Working,Secondary / secondary special,Single / not married,House / apartment,-10554,-1194,1,0,0,0,Accountants,1.0,-1,C
3344,5009032,F,N,Y,0,315000.0,Working,Secondary / secondary special,Single / not married,House / apartment,-10554,-1194,1,0,0,0,Accountants,1.0,-2,X
3345,5009032,F,N,Y,0,315000.0,Working,Secondary / secondary special,Single / not married,House / apartment,-10554,-1194,1,0,0,0,Accountants,1.0,-3,X
3346,5009032,F,N,Y,0,315000.0,Working,Secondary / secondary special,Single / not married,House / apartment,-10554,-1194,1,0,0,0,Accountants,1.0,-4,X
3347,5009032,F,N,Y,0,315000.0,Working,Secondary / secondary special,Single / not married,House / apartment,-10554,-1194,1,0,0,0,Accountants,1.0,-5,X
3348,5009032,F,N,Y,0,315000.0,Working,Secondary / secondary special,Single / not married,House / apartment,-10554,-1194,1,0,0,0,Accountants,1.0,-6,X
3349,5009032,F,N,Y,0,315000.0,Working,Secondary / secondary special,Single / not married,House / apartment,-10554,-1194,1,0,0,0,Accountants,1.0,-7,X
3350,5009032,F,N,Y,0,315000.0,Working,Secondary / secondary special,Single / not married,House / apartment,-10554,-1194,1,0,0,0,Accountants,1.0,-8,X
3351,5009032,F,N,Y,0,315000.0,Working,Secondary / secondary special,Single / not married,House / apartment,-10554,-1194,1,0,0,0,Accountants,1.0,-9,X
3352,5009032,F,N,Y,0,315000.0,Working,Secondary / secondary special,Single / not married,House / apartment,-10554,-1194,1,0,0,0,Accountants,1.0,-10,X
3353,5009032,F,N,Y,0,315000.0,Working,Secondary / secondary special,Single / not married,House / apartment,-10554,-1194,1,0,0,0,Accountants,1.0,-11,0
3354,5009032,F,N,Y,0,315000.0,Working,Secondary / secondary special,Single / not married,House / apartment,-10554,-1194,1,0,0,0,Accountants,1.0,-12,0
3355,5009032,F,N,Y,0,315000.0,Working,Secondary / secondary special,Single / not married,House / apartment,-10554,-1194,1,0,0,0,Accountants,1.0,-13,X
3356,5009033,F,N,N,0,255150.0,Pensioner,Incomplete higher,Civil marriage,Rented apartment,-18682,365243,1,0,0,0,,2.0,0,X
3357,5009033,F,N,N,0,255150.0,Pensioner,Incomplete higher,Civil marriage,Rented apartment,-18682,365243,1,0,0,0,,2.0,-1,X
3358,5009033,F,N,N,0,255150.0,Pensioner,Incomplete higher,Civil marriage,Rented apartment,-18682,365243,1,0,0,0,,2.0,-2,X
3359,5009033,F,N,N,0,255150.0,Pensioner,Incomplete higher,Civil marriage,Rented apartment,-18682,365243,1,0,0,0,,2.0,-3,X
3360,5009033,F,N,N,0,255150.0,Pensioner,Incomplete higher,Civil marriage,Rented apartment,-18682,365243,1,0,0,0,,2.0,-4,X
3361,5009033,F,N,N,0,255150.0,Pensioner,Incomplete higher,Civil marriage,Rented apartment,-18682,365243,1,0,0,0,,2.0,-5,X
3362,5009033,F,N,N,0,255150.0,Pensioner,Incomplete higher,Civil marriage,Rented apartment,-18682,365243,1,0,0,0,,2.0,-6,X
3363,5009033,F,N,N,0,255150.0,Pensioner,Incomplete higher,Civil marriage,Rented apartment,-18682,365243,1,0,0,0,,2.0,-7,X
3364,5009033,F,N,N,0,255150.0,Pensioner,Incomplete higher,Civil marriage,Rented apartment,-18682,365243,1,0,0,0,,2.0,-8,X
3365,5009033,F,N,N,0,255150.0,Pensioner,Incomplete higher,Civil marriage,Rented apartment,-18682,365243,1,0,0,0,,2.0,-9,X
3366,5009033,F,N,N,0,255150.0,Pensioner,Incomplete higher,Civil marriage,Rented apartment,-18682,365243,1,0,0,0,,2.0,-10,X
3367,5009033,F,N,N,0,255150.0,Pensioner,Incomplete higher,Civil marriage,Rented apartment,-18682,365243,1,0,0,0,,2.0,-11,X
3368,5009033,F,N,N,0,255150.0,Pensioner,Incomplete higher,Civil marriage,Rented apartment,-18682,365243,1,0,0,0,,2.0,-12,X
3369,5009033,F,N,N,0,255150.0,Pensioner,Incomplete higher,Civil marriage,Rented apartment,-18682,365243,1,0,0,0,,2.0,-13,0
3370,5009033,F,N,N,0,255150.0,Pensioner,Incomplete higher,Civil marriage,Rented apartment,-18682,365243,1,0,0,0,,2.0,-14,0
3371,5009033,F,N,N,0,255150.0,Pensioner,Incomplete higher,Civil marriage,Rented apartment,-18682,365243,1,0,0,0,,2.0,-15,0
3372,5009033,F,N,N,0,255150.0,Pensioner,Incomplete higher,Civil marriage,Rented apartment,-18682,365243,1,0,0,0,,2.0,-16,0
3373,5009034,F,N,N,0,255150.0,Pensioner,Incomplete higher,Civil marriage,Rented apartment,-18682,365243,1,0,0,0,,2.0,-14,C
3374,5009034,F,N,N,0,255150.0,Pensioner,Incomplete higher,Civil marriage,Rented apartment,-18682,365243,1,0,0,0,,2.0,-15,C
3375,5009034,F,N,N,0,255150.0,Pensioner,Incomplete higher,Civil marriage,Rented apartment,-18682,365243,1,0,0,0,,2.0,-16,C
3376,5009034,F,N,N,0,255150.0,Pensioner,Incomplete higher,Civil marriage,Rented apartment,-18682,365243,1,0,0,0,,2.0,-17,C
3377,5009034,F,N,N,0,255150.0,Pensioner,Incomplete higher,Civil marriage,Rented apartment,-18682,365243,1,0,0,0,,2.0,-18,C
3378,5009034,F,N,N,0,255150.0,Pensioner,Incomplete higher,Civil marriage,Rented apartment,-18682,365243,1,0,0,0,,2.0,-19,C
3379,5009034,F,N,N,0,255150.0,Pensioner,Incomplete higher,Civil marriage,Rented apartment,-18682,365243,1,0,0,0,,2.0,-20,C
3380,5009034,F,N,N,0,255150.0,Pensioner,Incomplete higher,Civil marriage,Rented apartment,-18682,365243,1,0,0,0,,2.0,-21,0
3381,5009034,F,N,N,0,255150.0,Pensioner,Incomplete higher,Civil marriage,Rented apartment,-18682,365243,1,0,0,0,,2.0,-22,0
3382,5009034,F,N,N,0,255150.0,Pensioner,Incomplete higher,Civil marriage,Rented apartment,-18682,365243,1,0,0,0,,2.0,-23,0
3383,5009034,F,N,N,0,255150.0,Pensioner,Incomplete higher,Civil marriage,Rented apartment,-18682,365243,1,0,0,0,,2.0,-24,0
3384,5009034,F,N,N,0,255150.0,Pensioner,Incomplete higher,Civil marriage,Rented apartment,-18682,365243,1,0,0,0,,2.0,-25,0
3385,5009034,F,N,N,0,255150.0,Pensioner,Incomplete higher,Civil marriage,Rented apartment,-18682,365243,1,0,0,0,,2.0,-26,0
3386,5009034,F,N,N,0,255150.0,Pensioner,Incomplete higher,Civil marriage,Rented apartment,-18682,365243,1,0,0,0,,2.0,-27,0
3387,5009034,F,N,N,0,255150.0,Pensioner,Incomplete higher,Civil marriage,Rented apartment,-18682,365243,1,0,0,0,,2.0,-28,0
3388,5009034,F,N,N,0,255150.0,Pensioner,Incomplete higher,Civil marriage,Rented apartment,-18682,365243,1,0,0,0,,2.0,-29,0
3389,5009034,F,N,N,0,255150.0,Pensioner,Incomplete higher,Civil marriage,Rented apartment,-18682,365243,1,0,0,0,,2.0,-30,0
3390,5009034,F,N,N,0,255150.0,Pensioner,Incomplete higher,Civil marriage,Rented apartment,-18682,365243,1,0,0,0,,2.0,-31,0
3391,5009035,F,N,N,0,255150.0,Pensioner,Incomplete higher,Civil marriage,Rented apartment,-18682,365243,1,0,0,0,,2.0,0,X
3392,5009035,F,N,N,0,255150.0,Pensioner,Incomplete higher,Civil marriage,Rented apartment,-18682,365243,1,0,0,0,,2.0,-1,X
3393,5009035,F,N,N,0,255150.0,Pensioner,Incomplete higher,Civil marriage,Rented apartment,-18682,365243,1,0,0,0,,2.0,-2,0
3394,5009035,F,N,N,0,255150.0,Pensioner,Incomplete higher,Civil marriage,Rented apartment,-18682,365243,1,0,0,0,,2.0,-3,0
3395,5009035,F,N,N,0,255150.0,Pensioner,Incomplete higher,Civil marriage,Rented apartment,-18682,365243,1,0,0,0,,2.0,-4,0
3396,5009035,F,N,N,0,255150.0,Pensioner,Incomplete higher,Civil marriage,Rented apartment,-18682,365243,1,0,0,0,,2.0,-5,0
3397,5009036,F,N,N,0,255150.0,Pensioner,Incomplete higher,Civil marriage,Rented apartment,-18682,365243,1,0,0,0,,2.0,0,C
3398,5009036,F,N,N,0,255150.0,Pensioner,Incomplete higher,Civil marriage,Rented apartment,-18682,365243,1,0,0,0,,2.0,-1,C
3399,5009036,F,N,N,0,255150.0,Pensioner,Incomplete higher,Civil marriage,Rented apartment,-18682,365243,1,0,0,0,,2.0,-2,C
3400,5009036,F,N,N,0,255150.0,Pensioner,Incomplete higher,Civil marriage,Rented apartment,-18682,365243,1,0,0,0,,2.0,-3,C
3401,5009036,F,N,N,0,255150.0,Pensioner,Incomplete higher,Civil marriage,Rented apartment,-18682,365243,1,0,0,0,,2.0,-4,C
3402,5009036,F,N,N,0,255150.0,Pensioner,Incomplete higher,Civil marriage,Rented apartment,-18682,365243,1,0,0,0,,2.0,-5,C
3403,5009036,F,N,N,0,255150.0,Pensioner,Incomplete higher,Civil marriage,Rented apartment,-18682,365243,1,0,0,0,,2.0,-6,C
3404,5009036,F,N,N,0,255150.0,Pensioner,Incomplete higher,Civil marriage,Rented apartment,-18682,365243,1,0,0,0,,2.0,-7,C
3405,5009036,F,N,N,0,255150.0,Pensioner,Incomplete higher,Civil marriage,Rented apartment,-18682,365243,1,0,0,0,,2.0,-8,C
3406,5009036,F,N,N,0,255150.0,Pensioner,Incomplete higher,Civil marriage,Rented apartment,-18682,365243,1,0,0,0,,2.0,-9,C
3407,5009036,F,N,N,0,255150.0,Pensioner,Incomplete higher,Civil marriage,Rented apartment,-18682,365243,1,0,0,0,,2.0,-10,C
3408,5009036,F,N,N,0,255150.0,Pensioner,Incomplete higher,Civil marriage,Rented apartment,-18682,365243,1,0,0,0,,2.0,-11,0
3409,5009036,F,N,N,0,255150.0,Pensioner,Incomplete higher,Civil marriage,Rented apartment,-18682,365243,1,0,0,0,,2.0,-12,X
3410,5009036,F,N,N,0,255150.0,Pensioner,Incomplete higher,Civil marriage,Rented apartment,-18682,365243,1,0,0,0,,2.0,-13,0
3411,5009036,F,N,N,0,255150.0,Pensioner,Incomplete higher,Civil marriage,Rented apartment,-18682,365243,1,0,0,0,,2.0,-14,0
3412,5009036,F,N,N,0,255150.0,Pensioner,Incomplete higher,Civil marriage,Rented apartment,-18682,365243,1,0,0,0,,2.0,-15,X
3413,5009036,F,N,N,0,255150.0,Pensioner,Incomplete higher,Civil marriage,Rented apartment,-18682,365243,1,0,0,0,,2.0,-16,0
3414,5009036,F,N,N,0,255150.0,Pensioner,Incomplete higher,Civil marriage,Rented apartment,-18682,365243,1,0,0,0,,2.0,-17,0
3415,5009036,F,N,N,0,255150.0,Pensioner,Incomplete higher,Civil marriage,Rented apartment,-18682,365243,1,0,0,0,,2.0,-18,X
3416,5009037,F,N,N,0,255150.0,Pensioner,Incomplete higher,Civil marriage,Rented apartment,-18682,365243,1,0,0,0,,2.0,0,X
3417,5009037,F,N,N,0,255150.0,Pensioner,Incomplete higher,Civil marriage,Rented apartment,-18682,365243,1,0,0,0,,2.0,-1,X
3418,5009037,F,N,N,0,255150.0,Pensioner,Incomplete higher,Civil marriage,Rented apartment,-18682,365243,1,0,0,0,,2.0,-2,X
3419,5009037,F,N,N,0,255150.0,Pensioner,Incomplete higher,Civil marriage,Rented apartment,-18682,365243,1,0,0,0,,2.0,-3,X
3420,5009037,F,N,N,0,255150.0,Pensioner,Incomplete higher,Civil marriage,Rented apartment,-18682,365243,1,0,0,0,,2.0,-4,X
3421,5009037,F,N,N,0,255150.0,Pensioner,Incomplete higher,Civil marriage,Rented apartment,-18682,365243,1,0,0,0,,2.0,-5,X
3422,5009037,F,N,N,0,255150.0,Pensioner,Incomplete higher,Civil marriage,Rented apartment,-18682,365243,1,0,0,0,,2.0,-6,X
3423,5009037,F,N,N,0,255150.0,Pensioner,Incomplete higher,Civil marriage,Rented apartment,-18682,365243,1,0,0,0,,2.0,-7,X
3424,5009037,F,N,N,0,255150.0,Pensioner,Incomplete higher,Civil marriage,Rented apartment,-18682,365243,1,0,0,0,,2.0,-8,X
3425,5009037,F,N,N,0,255150.0,Pensioner,Incomplete higher,Civil marriage,Rented apartment,-18682,365243,1,0,0,0,,2.0,-9,X
3426,5009037,F,N,N,0,255150.0,Pensioner,Incomplete higher,Civil marriage,Rented apartment,-18682,365243,1,0,0,0,,2.0,-10,X
3427,5009037,F,N,N,0,255150.0,Pensioner,Incomplete higher,Civil marriage,Rented apartment,-18682,365243,1,0,0,0,,2.0,-11,X
3428,5009037,F,N,N,0,255150.0,Pensioner,Incomplete higher,Civil marriage,Rented apartment,-18682,365243,1,0,0,0,,2.0,-12,X
3429,5009037,F,N,N,0,255150.0,Pensioner,Incomplete higher,Civil marriage,Rented apartment,-18682,365243,1,0,0,0,,2.0,-13,X
3430,5009037,F,N,N,0,255150.0,Pensioner,Incomplete higher,Civil marriage,Rented apartment,-18682,365243,1,0,0,0,,2.0,-14,X
3431,5009037,F,N,N,0,255150.0,Pensioner,Incomplete higher,Civil marriage,Rented apartment,-18682,365243,1,0,0,0,,2.0,-15,X
3432,5009037,F,N,N,0,255150.0,Pensioner,Incomplete higher,Civil marriage,Rented apartment,-18682,365243,1,0,0,0,,2.0,-16,0
3433,5009037,F,N,N,0,255150.0,Pensioner,Incomplete higher,Civil marriage,Rented apartment,-18682,365243,1,0,0,0,,2.0,-17,0
3434,5009037,F,N,N,0,255150.0,Pensioner,Incomplete higher,Civil marriage,Rented apartment,-18682,365243,1,0,0,0,,2.0,-18,0
3435,5009037,F,N,N,0,255150.0,Pensioner,Incomplete higher,Civil marriage,Rented apartment,-18682,365243,1,0,0,0,,2.0,-19,0
3436,5009038,F,N,N,0,255150.0,Pensioner,Incomplete higher,Civil marriage,Rented apartment,-18682,365243,1,0,0,0,,2.0,0,X
3437,5009038,F,N,N,0,255150.0,Pensioner,Incomplete higher,Civil marriage,Rented apartment,-18682,365243,1,0,0,0,,2.0,-1,X
3438,5009038,F,N,N,0,255150.0,Pensioner,Incomplete higher,Civil marriage,Rented apartment,-18682,365243,1,0,0,0,,2.0,-2,X
3439,5009038,F,N,N,0,255150.0,Pensioner,Incomplete higher,Civil marriage,Rented apartment,-18682,365243,1,0,0,0,,2.0,-3,X
3440,5009038,F,N,N,0,255150.0,Pensioner,Incomplete higher,Civil marriage,Rented apartment,-18682,365243,1,0,0,0,,2.0,-4,X
3441,5009038,F,N,N,0,255150.0,Pensioner,Incomplete higher,Civil marriage,Rented apartment,-18682,365243,1,0,0,0,,2.0,-5,X
3442,5009038,F,N,N,0,255150.0,Pensioner,Incomplete higher,Civil marriage,Rented apartment,-18682,365243,1,0,0,0,,2.0,-6,X
3443,5009038,F,N,N,0,255150.0,Pensioner,Incomplete higher,Civil marriage,Rented apartment,-18682,365243,1,0,0,0,,2.0,-7,X
3444,5009038,F,N,N,0,255150.0,Pensioner,Incomplete higher,Civil marriage,Rented apartment,-18682,365243,1,0,0,0,,2.0,-8,X
3445,5009038,F,N,N,0,255150.0,Pensioner,Incomplete higher,Civil marriage,Rented apartment,-18682,365243,1,0,0,0,,2.0,-9,0
3446,5009038,F,N,N,0,255150.0,Pensioner,Incomplete higher,Civil marriage,Rented apartment,-18682,365243,1,0,0,0,,2.0,-10,0
3447,5009038,F,N,N,0,255150.0,Pensioner,Incomplete higher,Civil marriage,Rented apartment,-18682,365243,1,0,0,0,,2.0,-11,0
3448,5009038,F,N,N,0,255150.0,Pensioner,Incomplete higher,Civil marriage,Rented apartment,-18682,365243,1,0,0,0,,2.0,-12,0
3449,5009039,F,N,Y,2,157500.0,Working,Secondary / secondary special,Single / not married,House / apartment,-14326,-555,1,0,0,0,Core staff,3.0,0,C
3450,5009039,F,N,Y,2,157500.0,Working,Secondary / secondary special,Single / not married,House / apartment,-14326,-555,1,0,0,0,Core staff,3.0,-1,C
3451,5009039,F,N,Y,2,157500.0,Working,Secondary / secondary special,Single / not married,House / apartment,-14326,-555,1,0,0,0,Core staff,3.0,-2,C
3452,5009039,F,N,Y,2,157500.0,Working,Secondary / secondary special,Single / not married,House / apartment,-14326,-555,1,0,0,0,Core staff,3.0,-3,C
3453,5009039,F,N,Y,2,157500.0,Working,Secondary / secondary special,Single / not married,House / apartment,-14326,-555,1,0,0,0,Core staff,3.0,-4,C
3454,5009039,F,N,Y,2,157500.0,Working,Secondary / secondary special,Single / not married,House / apartment,-14326,-555,1,0,0,0,Core staff,3.0,-5,C
3455,5009039,F,N,Y,2,157500.0,Working,Secondary / secondary special,Single / not married,House / apartment,-14326,-555,1,0,0,0,Core staff,3.0,-6,X
3456,5009039,F,N,Y,2,157500.0,Working,Secondary / secondary special,Single / not married,House / apartment,-14326,-555,1,0,0,0,Core staff,3.0,-7,0
3457,5009039,F,N,Y,2,157500.0,Working,Secondary / secondary special,Single / not married,House / apartment,-14326,-555,1,0,0,0,Core staff,3.0,-8,X
3458,5009040,F,N,Y,2,157500.0,Working,Secondary / secondary special,Single / not married,House / apartment,-14326,-555,1,0,0,0,Core staff,3.0,0,C
3459,5009040,F,N,Y,2,157500.0,Working,Secondary / secondary special,Single / not married,House / apartment,-14326,-555,1,0,0,0,Core staff,3.0,-1,X
3460,5009040,F,N,Y,2,157500.0,Working,Secondary / secondary special,Single / not married,House / apartment,-14326,-555,1,0,0,0,Core staff,3.0,-2,0
3461,5009040,F,N,Y,2,157500.0,Working,Secondary / secondary special,Single / not married,House / apartment,-14326,-555,1,0,0,0,Core staff,3.0,-3,X
3462,5009042,F,N,Y,0,148500.0,Working,Higher education,Married,House / apartment,-17641,-889,1,0,0,0,Core staff,2.0,0,X
3463,5009042,F,N,Y,0,148500.0,Working,Higher education,Married,House / apartment,-17641,-889,1,0,0,0,Core staff,2.0,-1,X
3464,5009042,F,N,Y,0,148500.0,Working,Higher education,Married,House / apartment,-17641,-889,1,0,0,0,Core staff,2.0,-2,X
3465,5009042,F,N,Y,0,148500.0,Working,Higher education,Married,House / apartment,-17641,-889,1,0,0,0,Core staff,2.0,-3,X
3466,5009042,F,N,Y,0,148500.0,Working,Higher education,Married,House / apartment,-17641,-889,1,0,0,0,Core staff,2.0,-4,X
3467,5009042,F,N,Y,0,148500.0,Working,Higher education,Married,House / apartment,-17641,-889,1,0,0,0,Core staff,2.0,-5,X
3468,5009042,F,N,Y,0,148500.0,Working,Higher education,Married,House / apartment,-17641,-889,1,0,0,0,Core staff,2.0,-6,0
3469,5009042,F,N,Y,0,148500.0,Working,Higher education,Married,House / apartment,-17641,-889,1,0,0,0,Core staff,2.0,-7,X
3470,5009042,F,N,Y,0,148500.0,Working,Higher education,Married,House / apartment,-17641,-889,1,0,0,0,Core staff,2.0,-8,0
3471,5009042,F,N,Y,0,148500.0,Working,Higher education,Married,House / apartment,-17641,-889,1,0,0,0,Core staff,2.0,-9,X
3472,5009042,F,N,Y,0,148500.0,Working,Higher education,Married,House / apartment,-17641,-889,1,0,0,0,Core staff,2.0,-10,0
3473,5009042,F,N,Y,0,148500.0,Working,Higher education,Married,House / apartment,-17641,-889,1,0,0,0,Core staff,2.0,-11,X
3474,5009042,F,N,Y,0,148500.0,Working,Higher education,Married,House / apartment,-17641,-889,1,0,0,0,Core staff,2.0,-12,0
3475,5009042,F,N,Y,0,148500.0,Working,Higher education,Married,House / apartment,-17641,-889,1,0,0,0,Core staff,2.0,-13,X
3476,5009042,F,N,Y,0,148500.0,Working,Higher education,Married,House / apartment,-17641,-889,1,0,0,0,Core staff,2.0,-14,0
3477,5009042,F,N,Y,0,148500.0,Working,Higher education,Married,House / apartment,-17641,-889,1,0,0,0,Core staff,2.0,-15,X
3478,5009042,F,N,Y,0,148500.0,Working,Higher education,Married,House / apartment,-17641,-889,1,0,0,0,Core staff,2.0,-16,0
3479,5009042,F,N,Y,0,148500.0,Working,Higher education,Married,House / apartment,-17641,-889,1,0,0,0,Core staff,2.0,-17,0
3480,5009042,F,N,Y,0,148500.0,Working,Higher education,Married,House / apartment,-17641,-889,1,0,0,0,Core staff,2.0,-18,X
3481,5009042,F,N,Y,0,148500.0,Working,Higher education,Married,House / apartment,-17641,-889,1,0,0,0,Core staff,2.0,-19,X
3482,5009042,F,N,Y,0,148500.0,Working,Higher education,Married,House / apartment,-17641,-889,1,0,0,0,Core staff,2.0,-20,0
3483,5009043,F,N,Y,0,148500.0,Working,Higher education,Married,House / apartment,-17641,-889,1,0,0,0,Core staff,2.0,-2,X
3484,5009043,F,N,Y,0,148500.0,Working,Higher education,Married,House / apartment,-17641,-889,1,0,0,0,Core staff,2.0,-3,0
3485,5009043,F,N,Y,0,148500.0,Working,Higher education,Married,House / apartment,-17641,-889,1,0,0,0,Core staff,2.0,-4,0
3486,5009043,F,N,Y,0,148500.0,Working,Higher education,Married,House / apartment,-17641,-889,1,0,0,0,Core staff,2.0,-5,0
3487,5009043,F,N,Y,0,148500.0,Working,Higher education,Married,House / apartment,-17641,-889,1,0,0,0,Core staff,2.0,-6,0
3488,5009043,F,N,Y,0,148500.0,Working,Higher education,Married,House / apartment,-17641,-889,1,0,0,0,Core staff,2.0,-7,0
3489,5009043,F,N,Y,0,148500.0,Working,Higher education,Married,House / apartment,-17641,-889,1,0,0,0,Core staff,2.0,-8,0
3490,5009043,F,N,Y,0,148500.0,Working,Higher education,Married,House / apartment,-17641,-889,1,0,0,0,Core staff,2.0,-9,0
3491,5009043,F,N,Y,0,148500.0,Working,Higher education,Married,House / apartment,-17641,-889,1,0,0,0,Core staff,2.0,-10,0
3492,5009043,F,N,Y,0,148500.0,Working,Higher education,Married,House / apartment,-17641,-889,1,0,0,0,Core staff,2.0,-11,0
3493,5009043,F,N,Y,0,148500.0,Working,Higher education,Married,House / apartment,-17641,-889,1,0,0,0,Core staff,2.0,-12,0
3494,5009043,F,N,Y,0,148500.0,Working,Higher education,Married,House / apartment,-17641,-889,1,0,0,0,Core staff,2.0,-13,0
3495,5009043,F,N,Y,0,148500.0,Working,Higher education,Married,House / apartment,-17641,-889,1,0,0,0,Core staff,2.0,-14,0
3496,5009043,F,N,Y,0,148500.0,Working,Higher education,Married,House / apartment,-17641,-889,1,0,0,0,Core staff,2.0,-15,0
3497,5009043,F,N,Y,0,148500.0,Working,Higher education,Married,House / apartment,-17641,-889,1,0,0,0,Core staff,2.0,-16,X
3498,5009043,F,N,Y,0,148500.0,Working,Higher education,Married,House / apartment,-17641,-889,1,0,0,0,Core staff,2.0,-17,X
3499,5009043,F,N,Y,0,148500.0,Working,Higher education,Married,House / apartment,-17641,-889,1,0,0,0,Core staff,2.0,-18,X
3500,5009043,F,N,Y,0,148500.0,Working,Higher education,Married,House / apartment,-17641,-889,1,0,0,0,Core staff,2.0,-19,0
3501,5009043,F,N,Y,0,148500.0,Working,Higher education,Married,House / apartment,-17641,-889,1,0,0,0,Core staff,2.0,-20,0
3502,5009044,F,N,Y,0,148500.0,Working,Higher education,Married,House / apartment,-17641,-889,1,0,0,0,Core staff,2.0,-4,X
3503,5009044,F,N,Y,0,148500.0,Working,Higher education,Married,House / apartment,-17641,-889,1,0,0,0,Core staff,2.0,-5,0
3504,5009044,F,N,Y,0,148500.0,Working,Higher education,Married,House / apartment,-17641,-889,1,0,0,0,Core staff,2.0,-6,1
3505,5009044,F,N,Y,0,148500.0,Working,Higher education,Married,House / apartment,-17641,-889,1,0,0,0,Core staff,2.0,-7,0
3506,5009044,F,N,Y,0,148500.0,Working,Higher education,Married,House / apartment,-17641,-889,1,0,0,0,Core staff,2.0,-8,0
3507,5009044,F,N,Y,0,148500.0,Working,Higher education,Married,House / apartment,-17641,-889,1,0,0,0,Core staff,2.0,-9,0
3508,5009044,F,N,Y,0,148500.0,Working,Higher education,Married,House / apartment,-17641,-889,1,0,0,0,Core staff,2.0,-10,0
3509,5009044,F,N,Y,0,148500.0,Working,Higher education,Married,House / apartment,-17641,-889,1,0,0,0,Core staff,2.0,-11,0
3510,5009044,F,N,Y,0,148500.0,Working,Higher education,Married,House / apartment,-17641,-889,1,0,0,0,Core staff,2.0,-12,0
3511,5009044,F,N,Y,0,148500.0,Working,Higher education,Married,House / apartment,-17641,-889,1,0,0,0,Core staff,2.0,-13,0
3512,5009044,F,N,Y,0,148500.0,Working,Higher education,Married,House / apartment,-17641,-889,1,0,0,0,Core staff,2.0,-14,0
3513,5009044,F,N,Y,0,148500.0,Working,Higher education,Married,House / apartment,-17641,-889,1,0,0,0,Core staff,2.0,-15,0
3514,5009044,F,N,Y,0,148500.0,Working,Higher education,Married,House / apartment,-17641,-889,1,0,0,0,Core staff,2.0,-16,0
3515,5009044,F,N,Y,0,148500.0,Working,Higher education,Married,House / apartment,-17641,-889,1,0,0,0,Core staff,2.0,-17,0
3516,5009044,F,N,Y,0,148500.0,Working,Higher education,Married,House / apartment,-17641,-889,1,0,0,0,Core staff,2.0,-18,0
3517,5009045,F,N,Y,0,148500.0,Working,Higher education,Married,House / apartment,-17641,-889,1,0,0,0,Core staff,2.0,-3,X
3518,5009045,F,N,Y,0,148500.0,Working,Higher education,Married,House / apartment,-17641,-889,1,0,0,0,Core staff,2.0,-4,0
3519,5009045,F,N,Y,0,148500.0,Working,Higher education,Married,House / apartment,-17641,-889,1,0,0,0,Core staff,2.0,-5,1
3520,5009045,F,N,Y,0,148500.0,Working,Higher education,Married,House / apartment,-17641,-889,1,0,0,0,Core staff,2.0,-6,0
3521,5009045,F,N,Y,0,148500.0,Working,Higher education,Married,House / apartment,-17641,-889,1,0,0,0,Core staff,2.0,-7,0
3522,5009045,F,N,Y,0,148500.0,Working,Higher education,Married,House / apartment,-17641,-889,1,0,0,0,Core staff,2.0,-8,0
3523,5009045,F,N,Y,0,148500.0,Working,Higher education,Married,House / apartment,-17641,-889,1,0,0,0,Core staff,2.0,-9,0
3524,5009045,F,N,Y,0,148500.0,Working,Higher education,Married,House / apartment,-17641,-889,1,0,0,0,Core staff,2.0,-10,0
3525,5009045,F,N,Y,0,148500.0,Working,Higher education,Married,House / apartment,-17641,-889,1,0,0,0,Core staff,2.0,-11,0
3526,5009045,F,N,Y,0,148500.0,Working,Higher education,Married,House / apartment,-17641,-889,1,0,0,0,Core staff,2.0,-12,0
3527,5009045,F,N,Y,0,148500.0,Working,Higher education,Married,House / apartment,-17641,-889,1,0,0,0,Core staff,2.0,-13,0
3528,5009045,F,N,Y,0,148500.0,Working,Higher education,Married,House / apartment,-17641,-889,1,0,0,0,Core staff,2.0,-14,0
3529,5009045,F,N,Y,0,148500.0,Working,Higher education,Married,House / apartment,-17641,-889,1,0,0,0,Core staff,2.0,-15,0
3530,5009045,F,N,Y,0,148500.0,Working,Higher education,Married,House / apartment,-17641,-889,1,0,0,0,Core staff,2.0,-16,0
3531,5009045,F,N,Y,0,148500.0,Working,Higher education,Married,House / apartment,-17641,-889,1,0,0,0,Core staff,2.0,-17,0
3532,5009046,F,N,Y,0,148500.0,Working,Higher education,Married,House / apartment,-17641,-889,1,0,0,0,Core staff,2.0,0,0
3533,5009046,F,N,Y,0,148500.0,Working,Higher education,Married,House / apartment,-17641,-889,1,0,0,0,Core staff,2.0,-1,X
3534,5009046,F,N,Y,0,148500.0,Working,Higher education,Married,House / apartment,-17641,-889,1,0,0,0,Core staff,2.0,-2,0
3535,5009046,F,N,Y,0,148500.0,Working,Higher education,Married,House / apartment,-17641,-889,1,0,0,0,Core staff,2.0,-3,X
3536,5009046,F,N,Y,0,148500.0,Working,Higher education,Married,House / apartment,-17641,-889,1,0,0,0,Core staff,2.0,-4,0
3537,5009046,F,N,Y,0,148500.0,Working,Higher education,Married,House / apartment,-17641,-889,1,0,0,0,Core staff,2.0,-5,0
3538,5009046,F,N,Y,0,148500.0,Working,Higher education,Married,House / apartment,-17641,-889,1,0,0,0,Core staff,2.0,-6,X
3539,5009046,F,N,Y,0,148500.0,Working,Higher education,Married,House / apartment,-17641,-889,1,0,0,0,Core staff,2.0,-7,X
3540,5009047,F,N,Y,0,148500.0,Working,Higher education,Married,House / apartment,-17641,-889,1,0,0,0,Core staff,2.0,0,0
3541,5009047,F,N,Y,0,148500.0,Working,Higher education,Married,House / apartment,-17641,-889,1,0,0,0,Core staff,2.0,-1,0
3542,5009047,F,N,Y,0,148500.0,Working,Higher education,Married,House / apartment,-17641,-889,1,0,0,0,Core staff,2.0,-2,0
3543,5009047,F,N,Y,0,148500.0,Working,Higher education,Married,House / apartment,-17641,-889,1,0,0,0,Core staff,2.0,-3,0
3544,5009047,F,N,Y,0,148500.0,Working,Higher education,Married,House / apartment,-17641,-889,1,0,0,0,Core staff,2.0,-4,0
3545,5009047,F,N,Y,0,148500.0,Working,Higher education,Married,House / apartment,-17641,-889,1,0,0,0,Core staff,2.0,-5,0
3546,5009047,F,N,Y,0,148500.0,Working,Higher education,Married,House / apartment,-17641,-889,1,0,0,0,Core staff,2.0,-6,0
3547,5009047,F,N,Y,0,148500.0,Working,Higher education,Married,House / apartment,-17641,-889,1,0,0,0,Core staff,2.0,-7,0
3548,5009047,F,N,Y,0,148500.0,Working,Higher education,Married,House / apartment,-17641,-889,1,0,0,0,Core staff,2.0,-8,0
3549,5009047,F,N,Y,0,148500.0,Working,Higher education,Married,House / apartment,-17641,-889,1,0,0,0,Core staff,2.0,-9,0
3550,5009047,F,N,Y,0,148500.0,Working,Higher education,Married,House / apartment,-17641,-889,1,0,0,0,Core staff,2.0,-10,0
3551,5009047,F,N,Y,0,148500.0,Working,Higher education,Married,House / apartment,-17641,-889,1,0,0,0,Core staff,2.0,-11,X
3552,5009050,F,N,Y,2,202500.0,Working,Higher education,Married,House / apartment,-10997,-2289,1,0,0,1,Core staff,4.0,-21,C
3553,5009050,F,N,Y,2,202500.0,Working,Higher education,Married,House / apartment,-10997,-2289,1,0,0,1,Core staff,4.0,-22,C
3554,5009050,F,N,Y,2,202500.0,Working,Higher education,Married,House / apartment,-10997,-2289,1,0,0,1,Core staff,4.0,-23,C
3555,5009050,F,N,Y,2,202500.0,Working,Higher education,Married,House / apartment,-10997,-2289,1,0,0,1,Core staff,4.0,-24,C
3556,5009050,F,N,Y,2,202500.0,Working,Higher education,Married,House / apartment,-10997,-2289,1,0,0,1,Core staff,4.0,-25,C
3557,5009050,F,N,Y,2,202500.0,Working,Higher education,Married,House / apartment,-10997,-2289,1,0,0,1,Core staff,4.0,-26,C
3558,5009050,F,N,Y,2,202500.0,Working,Higher education,Married,House / apartment,-10997,-2289,1,0,0,1,Core staff,4.0,-27,C
3559,5009050,F,N,Y,2,202500.0,Working,Higher education,Married,House / apartment,-10997,-2289,1,0,0,1,Core staff,4.0,-28,C
3560,5009050,F,N,Y,2,202500.0,Working,Higher education,Married,House / apartment,-10997,-2289,1,0,0,1,Core staff,4.0,-29,0
3561,5009050,F,N,Y,2,202500.0,Working,Higher education,Married,House / apartment,-10997,-2289,1,0,0,1,Core staff,4.0,-30,0
3562,5009050,F,N,Y,2,202500.0,Working,Higher education,Married,House / apartment,-10997,-2289,1,0,0,1,Core staff,4.0,-31,0
3563,5009050,F,N,Y,2,202500.0,Working,Higher education,Married,House / apartment,-10997,-2289,1,0,0,1,Core staff,4.0,-32,0
3564,5009050,F,N,Y,2,202500.0,Working,Higher education,Married,House / apartment,-10997,-2289,1,0,0,1,Core staff,4.0,-33,0
3565,5009050,F,N,Y,2,202500.0,Working,Higher education,Married,House / apartment,-10997,-2289,1,0,0,1,Core staff,4.0,-34,0
3566,5009051,F,N,Y,2,202500.0,Working,Higher education,Married,House / apartment,-10997,-2289,1,0,0,1,Core staff,4.0,-14,C
3567,5009051,F,N,Y,2,202500.0,Working,Higher education,Married,House / apartment,-10997,-2289,1,0,0,1,Core staff,4.0,-15,C
3568,5009051,F,N,Y,2,202500.0,Working,Higher education,Married,House / apartment,-10997,-2289,1,0,0,1,Core staff,4.0,-16,C
3569,5009051,F,N,Y,2,202500.0,Working,Higher education,Married,House / apartment,-10997,-2289,1,0,0,1,Core staff,4.0,-17,C
3570,5009051,F,N,Y,2,202500.0,Working,Higher education,Married,House / apartment,-10997,-2289,1,0,0,1,Core staff,4.0,-18,C
3571,5009051,F,N,Y,2,202500.0,Working,Higher education,Married,House / apartment,-10997,-2289,1,0,0,1,Core staff,4.0,-19,C
3572,5009051,F,N,Y,2,202500.0,Working,Higher education,Married,House / apartment,-10997,-2289,1,0,0,1,Core staff,4.0,-20,C
3573,5009051,F,N,Y,2,202500.0,Working,Higher education,Married,House / apartment,-10997,-2289,1,0,0,1,Core staff,4.0,-21,C
3574,5009051,F,N,Y,2,202500.0,Working,Higher education,Married,House / apartment,-10997,-2289,1,0,0,1,Core staff,4.0,-22,C
3575,5009051,F,N,Y,2,202500.0,Working,Higher education,Married,House / apartment,-10997,-2289,1,0,0,1,Core staff,4.0,-23,C
3576,5009051,F,N,Y,2,202500.0,Working,Higher education,Married,House / apartment,-10997,-2289,1,0,0,1,Core staff,4.0,-24,C
3577,5009051,F,N,Y,2,202500.0,Working,Higher education,Married,House / apartment,-10997,-2289,1,0,0,1,Core staff,4.0,-25,C
3578,5009051,F,N,Y,2,202500.0,Working,Higher education,Married,House / apartment,-10997,-2289,1,0,0,1,Core staff,4.0,-26,C
3579,5009051,F,N,Y,2,202500.0,Working,Higher education,Married,House / apartment,-10997,-2289,1,0,0,1,Core staff,4.0,-27,C
3580,5009051,F,N,Y,2,202500.0,Working,Higher education,Married,House / apartment,-10997,-2289,1,0,0,1,Core staff,4.0,-28,C
3581,5009051,F,N,Y,2,202500.0,Working,Higher education,Married,House / apartment,-10997,-2289,1,0,0,1,Core staff,4.0,-29,C
3582,5009051,F,N,Y,2,202500.0,Working,Higher education,Married,House / apartment,-10997,-2289,1,0,0,1,Core staff,4.0,-30,C
3583,5009051,F,N,Y,2,202500.0,Working,Higher education,Married,House / apartment,-10997,-2289,1,0,0,1,Core staff,4.0,-31,C
3584,5009051,F,N,Y,2,202500.0,Working,Higher education,Married,House / apartment,-10997,-2289,1,0,0,1,Core staff,4.0,-32,C
3585,5009051,F,N,Y,2,202500.0,Working,Higher education,Married,House / apartment,-10997,-2289,1,0,0,1,Core staff,4.0,-33,C
3586,5009051,F,N,Y,2,202500.0,Working,Higher education,Married,House / apartment,-10997,-2289,1,0,0,1,Core staff,4.0,-34,0
3587,5009051,F,N,Y,2,202500.0,Working,Higher education,Married,House / apartment,-10997,-2289,1,0,0,1,Core staff,4.0,-35,0
3588,5009051,F,N,Y,2,202500.0,Working,Higher education,Married,House / apartment,-10997,-2289,1,0,0,1,Core staff,4.0,-36,0
3589,5009051,F,N,Y,2,202500.0,Working,Higher education,Married,House / apartment,-10997,-2289,1,0,0,1,Core staff,4.0,-37,0
3590,5009051,F,N,Y,2,202500.0,Working,Higher education,Married,House / apartment,-10997,-2289,1,0,0,1,Core staff,4.0,-38,0
3591,5009051,F,N,Y,2,202500.0,Working,Higher education,Married,House / apartment,-10997,-2289,1,0,0,1,Core staff,4.0,-39,0
3592,5009051,F,N,Y,2,202500.0,Working,Higher education,Married,House / apartment,-10997,-2289,1,0,0,1,Core staff,4.0,-40,0
3593,5009051,F,N,Y,2,202500.0,Working,Higher education,Married,House / apartment,-10997,-2289,1,0,0,1,Core staff,4.0,-41,0
3594,5009051,F,N,Y,2,202500.0,Working,Higher education,Married,House / apartment,-10997,-2289,1,0,0,1,Core staff,4.0,-42,0
3595,5009051,F,N,Y,2,202500.0,Working,Higher education,Married,House / apartment,-10997,-2289,1,0,0,1,Core staff,4.0,-43,0
3596,5009051,F,N,Y,2,202500.0,Working,Higher education,Married,House / apartment,-10997,-2289,1,0,0,1,Core staff,4.0,-44,0
3597,5009051,F,N,Y,2,202500.0,Working,Higher education,Married,House / apartment,-10997,-2289,1,0,0,1,Core staff,4.0,-45,0
3598,5009051,F,N,Y,2,202500.0,Working,Higher education,Married,House / apartment,-10997,-2289,1,0,0,1,Core staff,4.0,-46,0
3599,5009051,F,N,Y,2,202500.0,Working,Higher education,Married,House / apartment,-10997,-2289,1,0,0,1,Core staff,4.0,-47,0
3600,5009051,F,N,Y,2,202500.0,Working,Higher education,Married,House / apartment,-10997,-2289,1,0,0,1,Core staff,4.0,-48,0
3601,5009051,F,N,Y,2,202500.0,Working,Higher education,Married,House / apartment,-10997,-2289,1,0,0,1,Core staff,4.0,-49,0
3602,5009051,F,N,Y,2,202500.0,Working,Higher education,Married,House / apartment,-10997,-2289,1,0,0,1,Core staff,4.0,-50,0
3603,5009051,F,N,Y,2,202500.0,Working,Higher education,Married,House / apartment,-10997,-2289,1,0,0,1,Core staff,4.0,-51,0
3604,5009051,F,N,Y,2,202500.0,Working,Higher education,Married,House / apartment,-10997,-2289,1,0,0,1,Core staff,4.0,-52,0
3605,5009051,F,N,Y,2,202500.0,Working,Higher education,Married,House / apartment,-10997,-2289,1,0,0,1,Core staff,4.0,-53,0
3606,5009051,F,N,Y,2,202500.0,Working,Higher education,Married,House / apartment,-10997,-2289,1,0,0,1,Core staff,4.0,-54,0
3607,5009051,F,N,Y,2,202500.0,Working,Higher education,Married,House / apartment,-10997,-2289,1,0,0,1,Core staff,4.0,-55,1
3608,5009051,F,N,Y,2,202500.0,Working,Higher education,Married,House / apartment,-10997,-2289,1,0,0,1,Core staff,4.0,-56,0
3609,5009052,F,N,Y,2,202500.0,Working,Higher education,Married,House / apartment,-10997,-2289,1,0,0,1,Core staff,4.0,0,C
3610,5009052,F,N,Y,2,202500.0,Working,Higher education,Married,House / apartment,-10997,-2289,1,0,0,1,Core staff,4.0,-1,C
3611,5009052,F,N,Y,2,202500.0,Working,Higher education,Married,House / apartment,-10997,-2289,1,0,0,1,Core staff,4.0,-2,C
3612,5009052,F,N,Y,2,202500.0,Working,Higher education,Married,House / apartment,-10997,-2289,1,0,0,1,Core staff,4.0,-3,C
3613,5009052,F,N,Y,2,202500.0,Working,Higher education,Married,House / apartment,-10997,-2289,1,0,0,1,Core staff,4.0,-4,C
3614,5009052,F,N,Y,2,202500.0,Working,Higher education,Married,House / apartment,-10997,-2289,1,0,0,1,Core staff,4.0,-5,C
3615,5009052,F,N,Y,2,202500.0,Working,Higher education,Married,House / apartment,-10997,-2289,1,0,0,1,Core staff,4.0,-6,C
3616,5009052,F,N,Y,2,202500.0,Working,Higher education,Married,House / apartment,-10997,-2289,1,0,0,1,Core staff,4.0,-7,C
3617,5009052,F,N,Y,2,202500.0,Working,Higher education,Married,House / apartment,-10997,-2289,1,0,0,1,Core staff,4.0,-8,C
3618,5009052,F,N,Y,2,202500.0,Working,Higher education,Married,House / apartment,-10997,-2289,1,0,0,1,Core staff,4.0,-9,C
3619,5009052,F,N,Y,2,202500.0,Working,Higher education,Married,House / apartment,-10997,-2289,1,0,0,1,Core staff,4.0,-10,C
3620,5009052,F,N,Y,2,202500.0,Working,Higher education,Married,House / apartment,-10997,-2289,1,0,0,1,Core staff,4.0,-11,C
3621,5009052,F,N,Y,2,202500.0,Working,Higher education,Married,House / apartment,-10997,-2289,1,0,0,1,Core staff,4.0,-12,C
3622,5009052,F,N,Y,2,202500.0,Working,Higher education,Married,House / apartment,-10997,-2289,1,0,0,1,Core staff,4.0,-13,C
3623,5009052,F,N,Y,2,202500.0,Working,Higher education,Married,House / apartment,-10997,-2289,1,0,0,1,Core staff,4.0,-14,C
3624,5009052,F,N,Y,2,202500.0,Working,Higher education,Married,House / apartment,-10997,-2289,1,0,0,1,Core staff,4.0,-15,C
3625,5009052,F,N,Y,2,202500.0,Working,Higher education,Married,House / apartment,-10997,-2289,1,0,0,1,Core staff,4.0,-16,C
3626,5009052,F,N,Y,2,202500.0,Working,Higher education,Married,House / apartment,-10997,-2289,1,0,0,1,Core staff,4.0,-17,C
3627,5009052,F,N,Y,2,202500.0,Working,Higher education,Married,House / apartment,-10997,-2289,1,0,0,1,Core staff,4.0,-18,C
3628,5009052,F,N,Y,2,202500.0,Working,Higher education,Married,House / apartment,-10997,-2289,1,0,0,1,Core staff,4.0,-19,C
3629,5009052,F,N,Y,2,202500.0,Working,Higher education,Married,House / apartment,-10997,-2289,1,0,0,1,Core staff,4.0,-20,C
3630,5009052,F,N,Y,2,202500.0,Working,Higher education,Married,House / apartment,-10997,-2289,1,0,0,1,Core staff,4.0,-21,C
3631,5009052,F,N,Y,2,202500.0,Working,Higher education,Married,House / apartment,-10997,-2289,1,0,0,1,Core staff,4.0,-22,C
3632,5009052,F,N,Y,2,202500.0,Working,Higher education,Married,House / apartment,-10997,-2289,1,0,0,1,Core staff,4.0,-23,C
3633,5009052,F,N,Y,2,202500.0,Working,Higher education,Married,House / apartment,-10997,-2289,1,0,0,1,Core staff,4.0,-24,C
3634,5009052,F,N,Y,2,202500.0,Working,Higher education,Married,House / apartment,-10997,-2289,1,0,0,1,Core staff,4.0,-25,C
3635,5009052,F,N,Y,2,202500.0,Working,Higher education,Married,House / apartment,-10997,-2289,1,0,0,1,Core staff,4.0,-26,C
3636,5009052,F,N,Y,2,202500.0,Working,Higher education,Married,House / apartment,-10997,-2289,1,0,0,1,Core staff,4.0,-27,C
3637,5009052,F,N,Y,2,202500.0,Working,Higher education,Married,House / apartment,-10997,-2289,1,0,0,1,Core staff,4.0,-28,C
3638,5009052,F,N,Y,2,202500.0,Working,Higher education,Married,House / apartment,-10997,-2289,1,0,0,1,Core staff,4.0,-29,C
3639,5009052,F,N,Y,2,202500.0,Working,Higher education,Married,House / apartment,-10997,-2289,1,0,0,1,Core staff,4.0,-30,C
3640,5009052,F,N,Y,2,202500.0,Working,Higher education,Married,House / apartment,-10997,-2289,1,0,0,1,Core staff,4.0,-31,0
3641,5009052,F,N,Y,2,202500.0,Working,Higher education,Married,House / apartment,-10997,-2289,1,0,0,1,Core staff,4.0,-32,0
3642,5009052,F,N,Y,2,202500.0,Working,Higher education,Married,House / apartment,-10997,-2289,1,0,0,1,Core staff,4.0,-33,0
3643,5009052,F,N,Y,2,202500.0,Working,Higher education,Married,House / apartment,-10997,-2289,1,0,0,1,Core staff,4.0,-34,0
3644,5009052,F,N,Y,2,202500.0,Working,Higher education,Married,House / apartment,-10997,-2289,1,0,0,1,Core staff,4.0,-35,0
3645,5009052,F,N,Y,2,202500.0,Working,Higher education,Married,House / apartment,-10997,-2289,1,0,0,1,Core staff,4.0,-36,0
3646,5009052,F,N,Y,2,202500.0,Working,Higher education,Married,House / apartment,-10997,-2289,1,0,0,1,Core staff,4.0,-37,0
3647,5009052,F,N,Y,2,202500.0,Working,Higher education,Married,House / apartment,-10997,-2289,1,0,0,1,Core staff,4.0,-38,0
3648,5009052,F,N,Y,2,202500.0,Working,Higher education,Married,House / apartment,-10997,-2289,1,0,0,1,Core staff,4.0,-39,0
3649,5009052,F,N,Y,2,202500.0,Working,Higher education,Married,House / apartment,-10997,-2289,1,0,0,1,Core staff,4.0,-40,0
3650,5009052,F,N,Y,2,202500.0,Working,Higher education,Married,House / apartment,-10997,-2289,1,0,0,1,Core staff,4.0,-41,0
3651,5009052,F,N,Y,2,202500.0,Working,Higher education,Married,House / apartment,-10997,-2289,1,0,0,1,Core staff,4.0,-42,0
3652,5009052,F,N,Y,2,202500.0,Working,Higher education,Married,House / apartment,-10997,-2289,1,0,0,1,Core staff,4.0,-43,0
3653,5009052,F,N,Y,2,202500.0,Working,Higher education,Married,House / apartment,-10997,-2289,1,0,0,1,Core staff,4.0,-44,0
3654,5009052,F,N,Y,2,202500.0,Working,Higher education,Married,House / apartment,-10997,-2289,1,0,0,1,Core staff,4.0,-45,0
3655,5009052,F,N,Y,2,202500.0,Working,Higher education,Married,House / apartment,-10997,-2289,1,0,0,1,Core staff,4.0,-46,0
3656,5009052,F,N,Y,2,202500.0,Working,Higher education,Married,House / apartment,-10997,-2289,1,0,0,1,Core staff,4.0,-47,0
3657,5009053,F,N,Y,2,202500.0,Working,Higher education,Married,House / apartment,-10997,-2289,1,0,0,1,Core staff,4.0,-38,C
3658,5009053,F,N,Y,2,202500.0,Working,Higher education,Married,House / apartment,-10997,-2289,1,0,0,1,Core staff,4.0,-39,C
3659,5009053,F,N,Y,2,202500.0,Working,Higher education,Married,House / apartment,-10997,-2289,1,0,0,1,Core staff,4.0,-40,C
3660,5009053,F,N,Y,2,202500.0,Working,Higher education,Married,House / apartment,-10997,-2289,1,0,0,1,Core staff,4.0,-41,C
3661,5009053,F,N,Y,2,202500.0,Working,Higher education,Married,House / apartment,-10997,-2289,1,0,0,1,Core staff,4.0,-42,C
3662,5009053,F,N,Y,2,202500.0,Working,Higher education,Married,House / apartment,-10997,-2289,1,0,0,1,Core staff,4.0,-43,C
3663,5009053,F,N,Y,2,202500.0,Working,Higher education,Married,House / apartment,-10997,-2289,1,0,0,1,Core staff,4.0,-44,C
3664,5009053,F,N,Y,2,202500.0,Working,Higher education,Married,House / apartment,-10997,-2289,1,0,0,1,Core staff,4.0,-45,C
3665,5009053,F,N,Y,2,202500.0,Working,Higher education,Married,House / apartment,-10997,-2289,1,0,0,1,Core staff,4.0,-46,0
3666,5009053,F,N,Y,2,202500.0,Working,Higher education,Married,House / apartment,-10997,-2289,1,0,0,1,Core staff,4.0,-47,0
3667,5009053,F,N,Y,2,202500.0,Working,Higher education,Married,House / apartment,-10997,-2289,1,0,0,1,Core staff,4.0,-48,0
3668,5009053,F,N,Y,2,202500.0,Working,Higher education,Married,House / apartment,-10997,-2289,1,0,0,1,Core staff,4.0,-49,0
3669,5009053,F,N,Y,2,202500.0,Working,Higher education,Married,House / apartment,-10997,-2289,1,0,0,1,Core staff,4.0,-50,0
3670,5009053,F,N,Y,2,202500.0,Working,Higher education,Married,House / apartment,-10997,-2289,1,0,0,1,Core staff,4.0,-51,0
3671,5009055,F,N,Y,2,202500.0,Working,Higher education,Married,House / apartment,-10997,-2289,1,0,0,1,Core staff,4.0,-42,X
3672,5009055,F,N,Y,2,202500.0,Working,Higher education,Married,House / apartment,-10997,-2289,1,0,0,1,Core staff,4.0,-43,X
3673,5009055,F,N,Y,2,202500.0,Working,Higher education,Married,House / apartment,-10997,-2289,1,0,0,1,Core staff,4.0,-44,X
3674,5009055,F,N,Y,2,202500.0,Working,Higher education,Married,House / apartment,-10997,-2289,1,0,0,1,Core staff,4.0,-45,X
3675,5009055,F,N,Y,2,202500.0,Working,Higher education,Married,House / apartment,-10997,-2289,1,0,0,1,Core staff,4.0,-46,X
3676,5009055,F,N,Y,2,202500.0,Working,Higher education,Married,House / apartment,-10997,-2289,1,0,0,1,Core staff,4.0,-47,X
3677,5009055,F,N,Y,2,202500.0,Working,Higher education,Married,House / apartment,-10997,-2289,1,0,0,1,Core staff,4.0,-48,X
3678,5009055,F,N,Y,2,202500.0,Working,Higher education,Married,House / apartment,-10997,-2289,1,0,0,1,Core staff,4.0,-49,X
3679,5009055,F,N,Y,2,202500.0,Working,Higher education,Married,House / apartment,-10997,-2289,1,0,0,1,Core staff,4.0,-50,X
3680,5009055,F,N,Y,2,202500.0,Working,Higher education,Married,House / apartment,-10997,-2289,1,0,0,1,Core staff,4.0,-51,X
3681,5009055,F,N,Y,2,202500.0,Working,Higher education,Married,House / apartment,-10997,-2289,1,0,0,1,Core staff,4.0,-52,X
3682,5009055,F,N,Y,2,202500.0,Working,Higher education,Married,House / apartment,-10997,-2289,1,0,0,1,Core staff,4.0,-53,X
3683,5009055,F,N,Y,2,202500.0,Working,Higher education,Married,House / apartment,-10997,-2289,1,0,0,1,Core staff,4.0,-54,X
3684,5009055,F,N,Y,2,202500.0,Working,Higher education,Married,House / apartment,-10997,-2289,1,0,0,1,Core staff,4.0,-55,0
3685,5009056,M,N,Y,0,202500.0,Working,Secondary / secondary special,Single / not married,House / apartment,-8861,-889,1,1,0,0,Drivers,1.0,-15,0
3686,5009056,M,N,Y,0,202500.0,Working,Secondary / secondary special,Single / not married,House / apartment,-8861,-889,1,1,0,0,Drivers,1.0,-16,0
3687,5009056,M,N,Y,0,202500.0,Working,Secondary / secondary special,Single / not married,House / apartment,-8861,-889,1,1,0,0,Drivers,1.0,-17,0
3688,5009056,M,N,Y,0,202500.0,Working,Secondary / secondary special,Single / not married,House / apartment,-8861,-889,1,1,0,0,Drivers,1.0,-18,0
3689,5009056,M,N,Y,0,202500.0,Working,Secondary / secondary special,Single / not married,House / apartment,-8861,-889,1,1,0,0,Drivers,1.0,-19,0
3690,5009056,M,N,Y,0,202500.0,Working,Secondary / secondary special,Single / not married,House / apartment,-8861,-889,1,1,0,0,Drivers,1.0,-20,0
3691,5009056,M,N,Y,0,202500.0,Working,Secondary / secondary special,Single / not married,House / apartment,-8861,-889,1,1,0,0,Drivers,1.0,-21,0
3692,5009056,M,N,Y,0,202500.0,Working,Secondary / secondary special,Single / not married,House / apartment,-8861,-889,1,1,0,0,Drivers,1.0,-22,0
3693,5009056,M,N,Y,0,202500.0,Working,Secondary / secondary special,Single / not married,House / apartment,-8861,-889,1,1,0,0,Drivers,1.0,-23,0
3694,5009056,M,N,Y,0,202500.0,Working,Secondary / secondary special,Single / not married,House / apartment,-8861,-889,1,1,0,0,Drivers,1.0,-24,0
3695,5009057,M,N,Y,0,202500.0,Working,Secondary / secondary special,Single / not married,House / apartment,-8861,-889,1,1,0,0,Drivers,1.0,0,0
3696,5009057,M,N,Y,0,202500.0,Working,Secondary / secondary special,Single / not married,House / apartment,-8861,-889,1,1,0,0,Drivers,1.0,-1,0
3697,5009057,M,N,Y,0,202500.0,Working,Secondary / secondary special,Single / not married,House / apartment,-8861,-889,1,1,0,0,Drivers,1.0,-2,0
3698,5009057,M,N,Y,0,202500.0,Working,Secondary / secondary special,Single / not married,House / apartment,-8861,-889,1,1,0,0,Drivers,1.0,-3,0
3699,5009057,M,N,Y,0,202500.0,Working,Secondary / secondary special,Single / not married,House / apartment,-8861,-889,1,1,0,0,Drivers,1.0,-4,0
3700,5009057,M,N,Y,0,202500.0,Working,Secondary / secondary special,Single / not married,House / apartment,-8861,-889,1,1,0,0,Drivers,1.0,-5,0
3701,5009057,M,N,Y,0,202500.0,Working,Secondary / secondary special,Single / not married,House / apartment,-8861,-889,1,1,0,0,Drivers,1.0,-6,0
3702,5009057,M,N,Y,0,202500.0,Working,Secondary / secondary special,Single / not married,House / apartment,-8861,-889,1,1,0,0,Drivers,1.0,-7,0
3703,5009057,M,N,Y,0,202500.0,Working,Secondary / secondary special,Single / not married,House / apartment,-8861,-889,1,1,0,0,Drivers,1.0,-8,0
3704,5009057,M,N,Y,0,202500.0,Working,Secondary / secondary special,Single / not married,House / apartment,-8861,-889,1,1,0,0,Drivers,1.0,-9,0
3705,5009058,F,Y,Y,0,112500.0,Commercial associate,Secondary / secondary special,Single / not married,House / apartment,-7489,-797,1,0,1,1,Private service staff,1.0,0,X
3706,5009060,F,N,Y,0,94500.0,Pensioner,Higher education,Married,House / apartment,-22331,365243,1,0,1,0,,2.0,0,0
3707,5009060,F,N,Y,0,94500.0,Pensioner,Higher education,Married,House / apartment,-22331,365243,1,0,1,0,,2.0,-1,0
3708,5009060,F,N,Y,0,94500.0,Pensioner,Higher education,Married,House / apartment,-22331,365243,1,0,1,0,,2.0,-2,0
3709,5009060,F,N,Y,0,94500.0,Pensioner,Higher education,Married,House / apartment,-22331,365243,1,0,1,0,,2.0,-3,0
3710,5009062,M,Y,Y,0,315000.0,Working,Secondary / secondary special,Civil marriage,House / apartment,-10450,-2077,1,0,0,0,Sales staff,2.0,-8,C
3711,5009062,M,Y,Y,0,315000.0,Working,Secondary / secondary special,Civil marriage,House / apartment,-10450,-2077,1,0,0,0,Sales staff,2.0,-9,C
3712,5009062,M,Y,Y,0,315000.0,Working,Secondary / secondary special,Civil marriage,House / apartment,-10450,-2077,1,0,0,0,Sales staff,2.0,-10,C
3713,5009062,M,Y,Y,0,315000.0,Working,Secondary / secondary special,Civil marriage,House / apartment,-10450,-2077,1,0,0,0,Sales staff,2.0,-11,C
3714,5009062,M,Y,Y,0,315000.0,Working,Secondary / secondary special,Civil marriage,House / apartment,-10450,-2077,1,0,0,0,Sales staff,2.0,-12,C
3715,5009062,M,Y,Y,0,315000.0,Working,Secondary / secondary special,Civil marriage,House / apartment,-10450,-2077,1,0,0,0,Sales staff,2.0,-13,C
3716,5009062,M,Y,Y,0,315000.0,Working,Secondary / secondary special,Civil marriage,House / apartment,-10450,-2077,1,0,0,0,Sales staff,2.0,-14,C
3717,5009062,M,Y,Y,0,315000.0,Working,Secondary / secondary special,Civil marriage,House / apartment,-10450,-2077,1,0,0,0,Sales staff,2.0,-15,C
3718,5009062,M,Y,Y,0,315000.0,Working,Secondary / secondary special,Civil marriage,House / apartment,-10450,-2077,1,0,0,0,Sales staff,2.0,-16,C
3719,5009062,M,Y,Y,0,315000.0,Working,Secondary / secondary special,Civil marriage,House / apartment,-10450,-2077,1,0,0,0,Sales staff,2.0,-17,C
3720,5009062,M,Y,Y,0,315000.0,Working,Secondary / secondary special,Civil marriage,House / apartment,-10450,-2077,1,0,0,0,Sales staff,2.0,-18,C
3721,5009062,M,Y,Y,0,315000.0,Working,Secondary / secondary special,Civil marriage,House / apartment,-10450,-2077,1,0,0,0,Sales staff,2.0,-19,C
3722,5009062,M,Y,Y,0,315000.0,Working,Secondary / secondary special,Civil marriage,House / apartment,-10450,-2077,1,0,0,0,Sales staff,2.0,-20,C
3723,5009062,M,Y,Y,0,315000.0,Working,Secondary / secondary special,Civil marriage,House / apartment,-10450,-2077,1,0,0,0,Sales staff,2.0,-21,C
3724,5009062,M,Y,Y,0,315000.0,Working,Secondary / secondary special,Civil marriage,House / apartment,-10450,-2077,1,0,0,0,Sales staff,2.0,-22,C
3725,5009062,M,Y,Y,0,315000.0,Working,Secondary / secondary special,Civil marriage,House / apartment,-10450,-2077,1,0,0,0,Sales staff,2.0,-23,C
3726,5009062,M,Y,Y,0,315000.0,Working,Secondary / secondary special,Civil marriage,House / apartment,-10450,-2077,1,0,0,0,Sales staff,2.0,-24,0
3727,5009062,M,Y,Y,0,315000.0,Working,Secondary / secondary special,Civil marriage,House / apartment,-10450,-2077,1,0,0,0,Sales staff,2.0,-25,0
3728,5009062,M,Y,Y,0,315000.0,Working,Secondary / secondary special,Civil marriage,House / apartment,-10450,-2077,1,0,0,0,Sales staff,2.0,-26,0
3729,5009062,M,Y,Y,0,315000.0,Working,Secondary / secondary special,Civil marriage,House / apartment,-10450,-2077,1,0,0,0,Sales staff,2.0,-27,X
3730,5009062,M,Y,Y,0,315000.0,Working,Secondary / secondary special,Civil marriage,House / apartment,-10450,-2077,1,0,0,0,Sales staff,2.0,-28,X
3731,5009062,M,Y,Y,0,315000.0,Working,Secondary / secondary special,Civil marriage,House / apartment,-10450,-2077,1,0,0,0,Sales staff,2.0,-29,X
3732,5009062,M,Y,Y,0,315000.0,Working,Secondary / secondary special,Civil marriage,House / apartment,-10450,-2077,1,0,0,0,Sales staff,2.0,-30,X
3733,5009062,M,Y,Y,0,315000.0,Working,Secondary / secondary special,Civil marriage,House / apartment,-10450,-2077,1,0,0,0,Sales staff,2.0,-31,X
3734,5009062,M,Y,Y,0,315000.0,Working,Secondary / secondary special,Civil marriage,House / apartment,-10450,-2077,1,0,0,0,Sales staff,2.0,-32,X
3735,5009062,M,Y,Y,0,315000.0,Working,Secondary / secondary special,Civil marriage,House / apartment,-10450,-2077,1,0,0,0,Sales staff,2.0,-33,X
3736,5009062,M,Y,Y,0,315000.0,Working,Secondary / secondary special,Civil marriage,House / apartment,-10450,-2077,1,0,0,0,Sales staff,2.0,-34,X
3737,5009062,M,Y,Y,0,315000.0,Working,Secondary / secondary special,Civil marriage,House / apartment,-10450,-2077,1,0,0,0,Sales staff,2.0,-35,X
3738,5009062,M,Y,Y,0,315000.0,Working,Secondary / secondary special,Civil marriage,House / apartment,-10450,-2077,1,0,0,0,Sales staff,2.0,-36,X
3739,5009062,M,Y,Y,0,315000.0,Working,Secondary / secondary special,Civil marriage,House / apartment,-10450,-2077,1,0,0,0,Sales staff,2.0,-37,X
3740,5009062,M,Y,Y,0,315000.0,Working,Secondary / secondary special,Civil marriage,House / apartment,-10450,-2077,1,0,0,0,Sales staff,2.0,-38,X
3741,5009062,M,Y,Y,0,315000.0,Working,Secondary / secondary special,Civil marriage,House / apartment,-10450,-2077,1,0,0,0,Sales staff,2.0,-39,X
3742,5009062,M,Y,Y,0,315000.0,Working,Secondary / secondary special,Civil marriage,House / apartment,-10450,-2077,1,0,0,0,Sales staff,2.0,-40,X
3743,5009062,M,Y,Y,0,315000.0,Working,Secondary / secondary special,Civil marriage,House / apartment,-10450,-2077,1,0,0,0,Sales staff,2.0,-41,X
3744,5009062,M,Y,Y,0,315000.0,Working,Secondary / secondary special,Civil marriage,House / apartment,-10450,-2077,1,0,0,0,Sales staff,2.0,-42,X
3745,5009062,M,Y,Y,0,315000.0,Working,Secondary / secondary special,Civil marriage,House / apartment,-10450,-2077,1,0,0,0,Sales staff,2.0,-43,X
3746,5009062,M,Y,Y,0,315000.0,Working,Secondary / secondary special,Civil marriage,House / apartment,-10450,-2077,1,0,0,0,Sales staff,2.0,-44,X
3747,5009062,M,Y,Y,0,315000.0,Working,Secondary / secondary special,Civil marriage,House / apartment,-10450,-2077,1,0,0,0,Sales staff,2.0,-45,X
3748,5009063,M,Y,Y,0,315000.0,Working,Secondary / secondary special,Civil marriage,House / apartment,-10450,-2077,1,0,0,0,Sales staff,2.0,0,C
3749,5009063,M,Y,Y,0,315000.0,Working,Secondary / secondary special,Civil marriage,House / apartment,-10450,-2077,1,0,0,0,Sales staff,2.0,-1,C
3750,5009063,M,Y,Y,0,315000.0,Working,Secondary / secondary special,Civil marriage,House / apartment,-10450,-2077,1,0,0,0,Sales staff,2.0,-2,C
3751,5009063,M,Y,Y,0,315000.0,Working,Secondary / secondary special,Civil marriage,House / apartment,-10450,-2077,1,0,0,0,Sales staff,2.0,-3,C
3752,5009063,M,Y,Y,0,315000.0,Working,Secondary / secondary special,Civil marriage,House / apartment,-10450,-2077,1,0,0,0,Sales staff,2.0,-4,C
3753,5009063,M,Y,Y,0,315000.0,Working,Secondary / secondary special,Civil marriage,House / apartment,-10450,-2077,1,0,0,0,Sales staff,2.0,-5,C
3754,5009063,M,Y,Y,0,315000.0,Working,Secondary / secondary special,Civil marriage,House / apartment,-10450,-2077,1,0,0,0,Sales staff,2.0,-6,0
3755,5009063,M,Y,Y,0,315000.0,Working,Secondary / secondary special,Civil marriage,House / apartment,-10450,-2077,1,0,0,0,Sales staff,2.0,-7,0
3756,5009063,M,Y,Y,0,315000.0,Working,Secondary / secondary special,Civil marriage,House / apartment,-10450,-2077,1,0,0,0,Sales staff,2.0,-8,0
3757,5009063,M,Y,Y,0,315000.0,Working,Secondary / secondary special,Civil marriage,House / apartment,-10450,-2077,1,0,0,0,Sales staff,2.0,-9,X
3758,5009063,M,Y,Y,0,315000.0,Working,Secondary / secondary special,Civil marriage,House / apartment,-10450,-2077,1,0,0,0,Sales staff,2.0,-10,X
3759,5009063,M,Y,Y,0,315000.0,Working,Secondary / secondary special,Civil marriage,House / apartment,-10450,-2077,1,0,0,0,Sales staff,2.0,-11,X
3760,5009063,M,Y,Y,0,315000.0,Working,Secondary / secondary special,Civil marriage,House / apartment,-10450,-2077,1,0,0,0,Sales staff,2.0,-12,X
3761,5009063,M,Y,Y,0,315000.0,Working,Secondary / secondary special,Civil marriage,House / apartment,-10450,-2077,1,0,0,0,Sales staff,2.0,-13,X
3762,5009063,M,Y,Y,0,315000.0,Working,Secondary / secondary special,Civil marriage,House / apartment,-10450,-2077,1,0,0,0,Sales staff,2.0,-14,X
3763,5009063,M,Y,Y,0,315000.0,Working,Secondary / secondary special,Civil marriage,House / apartment,-10450,-2077,1,0,0,0,Sales staff,2.0,-15,X
3764,5009063,M,Y,Y,0,315000.0,Working,Secondary / secondary special,Civil marriage,House / apartment,-10450,-2077,1,0,0,0,Sales staff,2.0,-16,X
3765,5009063,M,Y,Y,0,315000.0,Working,Secondary / secondary special,Civil marriage,House / apartment,-10450,-2077,1,0,0,0,Sales staff,2.0,-17,X
3766,5009063,M,Y,Y,0,315000.0,Working,Secondary / secondary special,Civil marriage,House / apartment,-10450,-2077,1,0,0,0,Sales staff,2.0,-18,X
3767,5009063,M,Y,Y,0,315000.0,Working,Secondary / secondary special,Civil marriage,House / apartment,-10450,-2077,1,0,0,0,Sales staff,2.0,-19,X
3768,5009063,M,Y,Y,0,315000.0,Working,Secondary / secondary special,Civil marriage,House / apartment,-10450,-2077,1,0,0,0,Sales staff,2.0,-20,X
3769,5009063,M,Y,Y,0,315000.0,Working,Secondary / secondary special,Civil marriage,House / apartment,-10450,-2077,1,0,0,0,Sales staff,2.0,-21,X
3770,5009063,M,Y,Y,0,315000.0,Working,Secondary / secondary special,Civil marriage,House / apartment,-10450,-2077,1,0,0,0,Sales staff,2.0,-22,X
3771,5009063,M,Y,Y,0,315000.0,Working,Secondary / secondary special,Civil marriage,House / apartment,-10450,-2077,1,0,0,0,Sales staff,2.0,-23,X
3772,5009063,M,Y,Y,0,315000.0,Working,Secondary / secondary special,Civil marriage,House / apartment,-10450,-2077,1,0,0,0,Sales staff,2.0,-24,X
3773,5009063,M,Y,Y,0,315000.0,Working,Secondary / secondary special,Civil marriage,House / apartment,-10450,-2077,1,0,0,0,Sales staff,2.0,-25,X
3774,5009063,M,Y,Y,0,315000.0,Working,Secondary / secondary special,Civil marriage,House / apartment,-10450,-2077,1,0,0,0,Sales staff,2.0,-26,X
3775,5009063,M,Y,Y,0,315000.0,Working,Secondary / secondary special,Civil marriage,House / apartment,-10450,-2077,1,0,0,0,Sales staff,2.0,-27,X
3776,5009064,M,Y,Y,0,315000.0,Working,Secondary / secondary special,Civil marriage,House / apartment,-10450,-2077,1,0,0,0,Sales staff,2.0,0,X
3777,5009064,M,Y,Y,0,315000.0,Working,Secondary / secondary special,Civil marriage,House / apartment,-10450,-2077,1,0,0,0,Sales staff,2.0,-1,X
3778,5009064,M,Y,Y,0,315000.0,Working,Secondary / secondary special,Civil marriage,House / apartment,-10450,-2077,1,0,0,0,Sales staff,2.0,-2,X
3779,5009064,M,Y,Y,0,315000.0,Working,Secondary / secondary special,Civil marriage,House / apartment,-10450,-2077,1,0,0,0,Sales staff,2.0,-3,X
3780,5009064,M,Y,Y,0,315000.0,Working,Secondary / secondary special,Civil marriage,House / apartment,-10450,-2077,1,0,0,0,Sales staff,2.0,-4,X
3781,5009065,M,Y,Y,0,315000.0,Working,Secondary / secondary special,Civil marriage,House / apartment,-10450,-2077,1,0,0,0,Sales staff,2.0,0,X
3782,5009065,M,Y,Y,0,315000.0,Working,Secondary / secondary special,Civil marriage,House / apartment,-10450,-2077,1,0,0,0,Sales staff,2.0,-1,X
3783,5009065,M,Y,Y,0,315000.0,Working,Secondary / secondary special,Civil marriage,House / apartment,-10450,-2077,1,0,0,0,Sales staff,2.0,-2,X
3784,5009065,M,Y,Y,0,315000.0,Working,Secondary / secondary special,Civil marriage,House / apartment,-10450,-2077,1,0,0,0,Sales staff,2.0,-3,X
3785,5009065,M,Y,Y,0,315000.0,Working,Secondary / secondary special,Civil marriage,House / apartment,-10450,-2077,1,0,0,0,Sales staff,2.0,-4,X
3786,5009065,M,Y,Y,0,315000.0,Working,Secondary / secondary special,Civil marriage,House / apartment,-10450,-2077,1,0,0,0,Sales staff,2.0,-5,X
3787,5009065,M,Y,Y,0,315000.0,Working,Secondary / secondary special,Civil marriage,House / apartment,-10450,-2077,1,0,0,0,Sales staff,2.0,-6,X
3788,5009065,M,Y,Y,0,315000.0,Working,Secondary / secondary special,Civil marriage,House / apartment,-10450,-2077,1,0,0,0,Sales staff,2.0,-7,X
3789,5009065,M,Y,Y,0,315000.0,Working,Secondary / secondary special,Civil marriage,House / apartment,-10450,-2077,1,0,0,0,Sales staff,2.0,-8,X
3790,5009065,M,Y,Y,0,315000.0,Working,Secondary / secondary special,Civil marriage,House / apartment,-10450,-2077,1,0,0,0,Sales staff,2.0,-9,X
3791,5009065,M,Y,Y,0,315000.0,Working,Secondary / secondary special,Civil marriage,House / apartment,-10450,-2077,1,0,0,0,Sales staff,2.0,-10,X
3792,5009066,M,Y,Y,0,315000.0,Working,Secondary / secondary special,Civil marriage,House / apartment,-10450,-2077,1,0,0,0,Sales staff,2.0,0,0
3793,5009066,M,Y,Y,0,315000.0,Working,Secondary / secondary special,Civil marriage,House / apartment,-10450,-2077,1,0,0,0,Sales staff,2.0,-1,0
3794,5009066,M,Y,Y,0,315000.0,Working,Secondary / secondary special,Civil marriage,House / apartment,-10450,-2077,1,0,0,0,Sales staff,2.0,-2,0
3795,5009066,M,Y,Y,0,315000.0,Working,Secondary / secondary special,Civil marriage,House / apartment,-10450,-2077,1,0,0,0,Sales staff,2.0,-3,0
3796,5009066,M,Y,Y,0,315000.0,Working,Secondary / secondary special,Civil marriage,House / apartment,-10450,-2077,1,0,0,0,Sales staff,2.0,-4,0
3797,5009066,M,Y,Y,0,315000.0,Working,Secondary / secondary special,Civil marriage,House / apartment,-10450,-2077,1,0,0,0,Sales staff,2.0,-5,0
3798,5009066,M,Y,Y,0,315000.0,Working,Secondary / secondary special,Civil marriage,House / apartment,-10450,-2077,1,0,0,0,Sales staff,2.0,-6,0
3799,5009066,M,Y,Y,0,315000.0,Working,Secondary / secondary special,Civil marriage,House / apartment,-10450,-2077,1,0,0,0,Sales staff,2.0,-7,0
3800,5009066,M,Y,Y,0,315000.0,Working,Secondary / secondary special,Civil marriage,House / apartment,-10450,-2077,1,0,0,0,Sales staff,2.0,-8,0
3801,5009066,M,Y,Y,0,315000.0,Working,Secondary / secondary special,Civil marriage,House / apartment,-10450,-2077,1,0,0,0,Sales staff,2.0,-9,0
3802,5009066,M,Y,Y,0,315000.0,Working,Secondary / secondary special,Civil marriage,House / apartment,-10450,-2077,1,0,0,0,Sales staff,2.0,-10,0
3803,5009066,M,Y,Y,0,315000.0,Working,Secondary / secondary special,Civil marriage,House / apartment,-10450,-2077,1,0,0,0,Sales staff,2.0,-11,0
3804,5009066,M,Y,Y,0,315000.0,Working,Secondary / secondary special,Civil marriage,House / apartment,-10450,-2077,1,0,0,0,Sales staff,2.0,-12,0
3805,5009066,M,Y,Y,0,315000.0,Working,Secondary / secondary special,Civil marriage,House / apartment,-10450,-2077,1,0,0,0,Sales staff,2.0,-13,0
3806,5009066,M,Y,Y,0,315000.0,Working,Secondary / secondary special,Civil marriage,House / apartment,-10450,-2077,1,0,0,0,Sales staff,2.0,-14,X
3807,5009066,M,Y,Y,0,315000.0,Working,Secondary / secondary special,Civil marriage,House / apartment,-10450,-2077,1,0,0,0,Sales staff,2.0,-15,X
3808,5009067,M,Y,Y,0,315000.0,Working,Secondary / secondary special,Civil marriage,House / apartment,-10450,-2077,1,0,0,0,Sales staff,2.0,-32,X
3809,5009067,M,Y,Y,0,315000.0,Working,Secondary / secondary special,Civil marriage,House / apartment,-10450,-2077,1,0,0,0,Sales staff,2.0,-33,0
3810,5009067,M,Y,Y,0,315000.0,Working,Secondary / secondary special,Civil marriage,House / apartment,-10450,-2077,1,0,0,0,Sales staff,2.0,-34,0
3811,5009067,M,Y,Y,0,315000.0,Working,Secondary / secondary special,Civil marriage,House / apartment,-10450,-2077,1,0,0,0,Sales staff,2.0,-35,0
3812,5009067,M,Y,Y,0,315000.0,Working,Secondary / secondary special,Civil marriage,House / apartment,-10450,-2077,1,0,0,0,Sales staff,2.0,-36,0
3813,5009068,M,Y,Y,0,315000.0,Working,Secondary / secondary special,Civil marriage,House / apartment,-10450,-2077,1,0,0,0,Sales staff,2.0,0,C
3814,5009068,M,Y,Y,0,315000.0,Working,Secondary / secondary special,Civil marriage,House / apartment,-10450,-2077,1,0,0,0,Sales staff,2.0,-1,0
3815,5009068,M,Y,Y,0,315000.0,Working,Secondary / secondary special,Civil marriage,House / apartment,-10450,-2077,1,0,0,0,Sales staff,2.0,-2,0
3816,5009068,M,Y,Y,0,315000.0,Working,Secondary / secondary special,Civil marriage,House / apartment,-10450,-2077,1,0,0,0,Sales staff,2.0,-3,0
3817,5009068,M,Y,Y,0,315000.0,Working,Secondary / secondary special,Civil marriage,House / apartment,-10450,-2077,1,0,0,0,Sales staff,2.0,-4,X
3818,5009068,M,Y,Y,0,315000.0,Working,Secondary / secondary special,Civil marriage,House / apartment,-10450,-2077,1,0,0,0,Sales staff,2.0,-5,X
3819,5009068,M,Y,Y,0,315000.0,Working,Secondary / secondary special,Civil marriage,House / apartment,-10450,-2077,1,0,0,0,Sales staff,2.0,-6,X
3820,5009068,M,Y,Y,0,315000.0,Working,Secondary / secondary special,Civil marriage,House / apartment,-10450,-2077,1,0,0,0,Sales staff,2.0,-7,X
3821,5009068,M,Y,Y,0,315000.0,Working,Secondary / secondary special,Civil marriage,House / apartment,-10450,-2077,1,0,0,0,Sales staff,2.0,-8,X
3822,5009068,M,Y,Y,0,315000.0,Working,Secondary / secondary special,Civil marriage,House / apartment,-10450,-2077,1,0,0,0,Sales staff,2.0,-9,X
3823,5009068,M,Y,Y,0,315000.0,Working,Secondary / secondary special,Civil marriage,House / apartment,-10450,-2077,1,0,0,0,Sales staff,2.0,-10,X
3824,5009068,M,Y,Y,0,315000.0,Working,Secondary / secondary special,Civil marriage,House / apartment,-10450,-2077,1,0,0,0,Sales staff,2.0,-11,X
3825,5009068,M,Y,Y,0,315000.0,Working,Secondary / secondary special,Civil marriage,House / apartment,-10450,-2077,1,0,0,0,Sales staff,2.0,-12,X
3826,5009068,M,Y,Y,0,315000.0,Working,Secondary / secondary special,Civil marriage,House / apartment,-10450,-2077,1,0,0,0,Sales staff,2.0,-13,X
3827,5009068,M,Y,Y,0,315000.0,Working,Secondary / secondary special,Civil marriage,House / apartment,-10450,-2077,1,0,0,0,Sales staff,2.0,-14,X
3828,5009068,M,Y,Y,0,315000.0,Working,Secondary / secondary special,Civil marriage,House / apartment,-10450,-2077,1,0,0,0,Sales staff,2.0,-15,X
3829,5009068,M,Y,Y,0,315000.0,Working,Secondary / secondary special,Civil marriage,House / apartment,-10450,-2077,1,0,0,0,Sales staff,2.0,-16,X
3830,5009068,M,Y,Y,0,315000.0,Working,Secondary / secondary special,Civil marriage,House / apartment,-10450,-2077,1,0,0,0,Sales staff,2.0,-17,X
3831,5009068,M,Y,Y,0,315000.0,Working,Secondary / secondary special,Civil marriage,House / apartment,-10450,-2077,1,0,0,0,Sales staff,2.0,-18,X
3832,5009068,M,Y,Y,0,315000.0,Working,Secondary / secondary special,Civil marriage,House / apartment,-10450,-2077,1,0,0,0,Sales staff,2.0,-19,X
3833,5009068,M,Y,Y,0,315000.0,Working,Secondary / secondary special,Civil marriage,House / apartment,-10450,-2077,1,0,0,0,Sales staff,2.0,-20,X
3834,5009068,M,Y,Y,0,315000.0,Working,Secondary / secondary special,Civil marriage,House / apartment,-10450,-2077,1,0,0,0,Sales staff,2.0,-21,X
3835,5009068,M,Y,Y,0,315000.0,Working,Secondary / secondary special,Civil marriage,House / apartment,-10450,-2077,1,0,0,0,Sales staff,2.0,-22,X
3836,5009069,M,Y,Y,0,315000.0,Working,Secondary / secondary special,Civil marriage,House / apartment,-10450,-2077,1,0,0,0,Sales staff,2.0,0,C
3837,5009069,M,Y,Y,0,315000.0,Working,Secondary / secondary special,Civil marriage,House / apartment,-10450,-2077,1,0,0,0,Sales staff,2.0,-1,C
3838,5009069,M,Y,Y,0,315000.0,Working,Secondary / secondary special,Civil marriage,House / apartment,-10450,-2077,1,0,0,0,Sales staff,2.0,-2,C
3839,5009069,M,Y,Y,0,315000.0,Working,Secondary / secondary special,Civil marriage,House / apartment,-10450,-2077,1,0,0,0,Sales staff,2.0,-3,C
3840,5009069,M,Y,Y,0,315000.0,Working,Secondary / secondary special,Civil marriage,House / apartment,-10450,-2077,1,0,0,0,Sales staff,2.0,-4,C
3841,5009069,M,Y,Y,0,315000.0,Working,Secondary / secondary special,Civil marriage,House / apartment,-10450,-2077,1,0,0,0,Sales staff,2.0,-5,C
3842,5009069,M,Y,Y,0,315000.0,Working,Secondary / secondary special,Civil marriage,House / apartment,-10450,-2077,1,0,0,0,Sales staff,2.0,-6,C
3843,5009069,M,Y,Y,0,315000.0,Working,Secondary / secondary special,Civil marriage,House / apartment,-10450,-2077,1,0,0,0,Sales staff,2.0,-7,C
3844,5009069,M,Y,Y,0,315000.0,Working,Secondary / secondary special,Civil marriage,House / apartment,-10450,-2077,1,0,0,0,Sales staff,2.0,-8,C
3845,5009069,M,Y,Y,0,315000.0,Working,Secondary / secondary special,Civil marriage,House / apartment,-10450,-2077,1,0,0,0,Sales staff,2.0,-9,C
3846,5009069,M,Y,Y,0,315000.0,Working,Secondary / secondary special,Civil marriage,House / apartment,-10450,-2077,1,0,0,0,Sales staff,2.0,-10,C
3847,5009069,M,Y,Y,0,315000.0,Working,Secondary / secondary special,Civil marriage,House / apartment,-10450,-2077,1,0,0,0,Sales staff,2.0,-11,C
3848,5009069,M,Y,Y,0,315000.0,Working,Secondary / secondary special,Civil marriage,House / apartment,-10450,-2077,1,0,0,0,Sales staff,2.0,-12,C
3849,5009069,M,Y,Y,0,315000.0,Working,Secondary / secondary special,Civil marriage,House / apartment,-10450,-2077,1,0,0,0,Sales staff,2.0,-13,C
3850,5009069,M,Y,Y,0,315000.0,Working,Secondary / secondary special,Civil marriage,House / apartment,-10450,-2077,1,0,0,0,Sales staff,2.0,-14,0
3851,5009069,M,Y,Y,0,315000.0,Working,Secondary / secondary special,Civil marriage,House / apartment,-10450,-2077,1,0,0,0,Sales staff,2.0,-15,0
3852,5009069,M,Y,Y,0,315000.0,Working,Secondary / secondary special,Civil marriage,House / apartment,-10450,-2077,1,0,0,0,Sales staff,2.0,-16,0
3853,5009069,M,Y,Y,0,315000.0,Working,Secondary / secondary special,Civil marriage,House / apartment,-10450,-2077,1,0,0,0,Sales staff,2.0,-17,0
3854,5009069,M,Y,Y,0,315000.0,Working,Secondary / secondary special,Civil marriage,House / apartment,-10450,-2077,1,0,0,0,Sales staff,2.0,-18,0
3855,5009069,M,Y,Y,0,315000.0,Working,Secondary / secondary special,Civil marriage,House / apartment,-10450,-2077,1,0,0,0,Sales staff,2.0,-19,0
3856,5009069,M,Y,Y,0,315000.0,Working,Secondary / secondary special,Civil marriage,House / apartment,-10450,-2077,1,0,0,0,Sales staff,2.0,-20,0
3857,5009069,M,Y,Y,0,315000.0,Working,Secondary / secondary special,Civil marriage,House / apartment,-10450,-2077,1,0,0,0,Sales staff,2.0,-21,0
3858,5009069,M,Y,Y,0,315000.0,Working,Secondary / secondary special,Civil marriage,House / apartment,-10450,-2077,1,0,0,0,Sales staff,2.0,-22,0
3859,5009069,M,Y,Y,0,315000.0,Working,Secondary / secondary special,Civil marriage,House / apartment,-10450,-2077,1,0,0,0,Sales staff,2.0,-23,0
3860,5009069,M,Y,Y,0,315000.0,Working,Secondary / secondary special,Civil marriage,House / apartment,-10450,-2077,1,0,0,0,Sales staff,2.0,-24,0
3861,5009069,M,Y,Y,0,315000.0,Working,Secondary / secondary special,Civil marriage,House / apartment,-10450,-2077,1,0,0,0,Sales staff,2.0,-25,0
3862,5009069,M,Y,Y,0,315000.0,Working,Secondary / secondary special,Civil marriage,House / apartment,-10450,-2077,1,0,0,0,Sales staff,2.0,-26,0
3863,5009069,M,Y,Y,0,315000.0,Working,Secondary / secondary special,Civil marriage,House / apartment,-10450,-2077,1,0,0,0,Sales staff,2.0,-27,0
3864,5009069,M,Y,Y,0,315000.0,Working,Secondary / secondary special,Civil marriage,House / apartment,-10450,-2077,1,0,0,0,Sales staff,2.0,-28,0
3865,5009069,M,Y,Y,0,315000.0,Working,Secondary / secondary special,Civil marriage,House / apartment,-10450,-2077,1,0,0,0,Sales staff,2.0,-29,0
3866,5009069,M,Y,Y,0,315000.0,Working,Secondary / secondary special,Civil marriage,House / apartment,-10450,-2077,1,0,0,0,Sales staff,2.0,-30,0
3867,5009069,M,Y,Y,0,315000.0,Working,Secondary / secondary special,Civil marriage,House / apartment,-10450,-2077,1,0,0,0,Sales staff,2.0,-31,0
3868,5009069,M,Y,Y,0,315000.0,Working,Secondary / secondary special,Civil marriage,House / apartment,-10450,-2077,1,0,0,0,Sales staff,2.0,-32,0
3869,5009069,M,Y,Y,0,315000.0,Working,Secondary / secondary special,Civil marriage,House / apartment,-10450,-2077,1,0,0,0,Sales staff,2.0,-33,0
3870,5009069,M,Y,Y,0,315000.0,Working,Secondary / secondary special,Civil marriage,House / apartment,-10450,-2077,1,0,0,0,Sales staff,2.0,-34,X
3871,5009069,M,Y,Y,0,315000.0,Working,Secondary / secondary special,Civil marriage,House / apartment,-10450,-2077,1,0,0,0,Sales staff,2.0,-35,X
3872,5009070,M,Y,Y,0,315000.0,Working,Secondary / secondary special,Civil marriage,House / apartment,-10450,-2077,1,0,0,0,Sales staff,2.0,-2,C
3873,5009070,M,Y,Y,0,315000.0,Working,Secondary / secondary special,Civil marriage,House / apartment,-10450,-2077,1,0,0,0,Sales staff,2.0,-3,C
3874,5009070,M,Y,Y,0,315000.0,Working,Secondary / secondary special,Civil marriage,House / apartment,-10450,-2077,1,0,0,0,Sales staff,2.0,-4,C
3875,5009070,M,Y,Y,0,315000.0,Working,Secondary / secondary special,Civil marriage,House / apartment,-10450,-2077,1,0,0,0,Sales staff,2.0,-5,C
3876,5009070,M,Y,Y,0,315000.0,Working,Secondary / secondary special,Civil marriage,House / apartment,-10450,-2077,1,0,0,0,Sales staff,2.0,-6,C
3877,5009070,M,Y,Y,0,315000.0,Working,Secondary / secondary special,Civil marriage,House / apartment,-10450,-2077,1,0,0,0,Sales staff,2.0,-7,C
3878,5009070,M,Y,Y,0,315000.0,Working,Secondary / secondary special,Civil marriage,House / apartment,-10450,-2077,1,0,0,0,Sales staff,2.0,-8,C
3879,5009070,M,Y,Y,0,315000.0,Working,Secondary / secondary special,Civil marriage,House / apartment,-10450,-2077,1,0,0,0,Sales staff,2.0,-9,C
3880,5009070,M,Y,Y,0,315000.0,Working,Secondary / secondary special,Civil marriage,House / apartment,-10450,-2077,1,0,0,0,Sales staff,2.0,-10,C
3881,5009070,M,Y,Y,0,315000.0,Working,Secondary / secondary special,Civil marriage,House / apartment,-10450,-2077,1,0,0,0,Sales staff,2.0,-11,C
3882,5009070,M,Y,Y,0,315000.0,Working,Secondary / secondary special,Civil marriage,House / apartment,-10450,-2077,1,0,0,0,Sales staff,2.0,-12,C
3883,5009070,M,Y,Y,0,315000.0,Working,Secondary / secondary special,Civil marriage,House / apartment,-10450,-2077,1,0,0,0,Sales staff,2.0,-13,C
3884,5009070,M,Y,Y,0,315000.0,Working,Secondary / secondary special,Civil marriage,House / apartment,-10450,-2077,1,0,0,0,Sales staff,2.0,-14,C
3885,5009070,M,Y,Y,0,315000.0,Working,Secondary / secondary special,Civil marriage,House / apartment,-10450,-2077,1,0,0,0,Sales staff,2.0,-15,C
3886,5009070,M,Y,Y,0,315000.0,Working,Secondary / secondary special,Civil marriage,House / apartment,-10450,-2077,1,0,0,0,Sales staff,2.0,-16,C
3887,5009070,M,Y,Y,0,315000.0,Working,Secondary / secondary special,Civil marriage,House / apartment,-10450,-2077,1,0,0,0,Sales staff,2.0,-17,C
3888,5009070,M,Y,Y,0,315000.0,Working,Secondary / secondary special,Civil marriage,House / apartment,-10450,-2077,1,0,0,0,Sales staff,2.0,-18,0
3889,5009070,M,Y,Y,0,315000.0,Working,Secondary / secondary special,Civil marriage,House / apartment,-10450,-2077,1,0,0,0,Sales staff,2.0,-19,0
3890,5009070,M,Y,Y,0,315000.0,Working,Secondary / secondary special,Civil marriage,House / apartment,-10450,-2077,1,0,0,0,Sales staff,2.0,-20,0
3891,5009070,M,Y,Y,0,315000.0,Working,Secondary / secondary special,Civil marriage,House / apartment,-10450,-2077,1,0,0,0,Sales staff,2.0,-21,X
3892,5009070,M,Y,Y,0,315000.0,Working,Secondary / secondary special,Civil marriage,House / apartment,-10450,-2077,1,0,0,0,Sales staff,2.0,-22,X
3893,5009070,M,Y,Y,0,315000.0,Working,Secondary / secondary special,Civil marriage,House / apartment,-10450,-2077,1,0,0,0,Sales staff,2.0,-23,X
3894,5009070,M,Y,Y,0,315000.0,Working,Secondary / secondary special,Civil marriage,House / apartment,-10450,-2077,1,0,0,0,Sales staff,2.0,-24,X
3895,5009070,M,Y,Y,0,315000.0,Working,Secondary / secondary special,Civil marriage,House / apartment,-10450,-2077,1,0,0,0,Sales staff,2.0,-25,X
3896,5009070,M,Y,Y,0,315000.0,Working,Secondary / secondary special,Civil marriage,House / apartment,-10450,-2077,1,0,0,0,Sales staff,2.0,-26,X
3897,5009070,M,Y,Y,0,315000.0,Working,Secondary / secondary special,Civil marriage,House / apartment,-10450,-2077,1,0,0,0,Sales staff,2.0,-27,X
3898,5009070,M,Y,Y,0,315000.0,Working,Secondary / secondary special,Civil marriage,House / apartment,-10450,-2077,1,0,0,0,Sales staff,2.0,-28,X
3899,5009070,M,Y,Y,0,315000.0,Working,Secondary / secondary special,Civil marriage,House / apartment,-10450,-2077,1,0,0,0,Sales staff,2.0,-29,X
3900,5009070,M,Y,Y,0,315000.0,Working,Secondary / secondary special,Civil marriage,House / apartment,-10450,-2077,1,0,0,0,Sales staff,2.0,-30,X
3901,5009070,M,Y,Y,0,315000.0,Working,Secondary / secondary special,Civil marriage,House / apartment,-10450,-2077,1,0,0,0,Sales staff,2.0,-31,X
3902,5009070,M,Y,Y,0,315000.0,Working,Secondary / secondary special,Civil marriage,House / apartment,-10450,-2077,1,0,0,0,Sales staff,2.0,-32,X
3903,5009070,M,Y,Y,0,315000.0,Working,Secondary / secondary special,Civil marriage,House / apartment,-10450,-2077,1,0,0,0,Sales staff,2.0,-33,X
3904,5009070,M,Y,Y,0,315000.0,Working,Secondary / secondary special,Civil marriage,House / apartment,-10450,-2077,1,0,0,0,Sales staff,2.0,-34,X
3905,5009070,M,Y,Y,0,315000.0,Working,Secondary / secondary special,Civil marriage,House / apartment,-10450,-2077,1,0,0,0,Sales staff,2.0,-35,X
3906,5009070,M,Y,Y,0,315000.0,Working,Secondary / secondary special,Civil marriage,House / apartment,-10450,-2077,1,0,0,0,Sales staff,2.0,-36,X
3907,5009070,M,Y,Y,0,315000.0,Working,Secondary / secondary special,Civil marriage,House / apartment,-10450,-2077,1,0,0,0,Sales staff,2.0,-37,X
3908,5009070,M,Y,Y,0,315000.0,Working,Secondary / secondary special,Civil marriage,House / apartment,-10450,-2077,1,0,0,0,Sales staff,2.0,-38,X
3909,5009070,M,Y,Y,0,315000.0,Working,Secondary / secondary special,Civil marriage,House / apartment,-10450,-2077,1,0,0,0,Sales staff,2.0,-39,X
3910,5009071,F,Y,Y,0,270000.0,Commercial associate,Incomplete higher,Civil marriage,Municipal apartment,-10264,-3173,1,0,1,1,High skill tech staff,2.0,0,C
3911,5009071,F,Y,Y,0,270000.0,Commercial associate,Incomplete higher,Civil marriage,Municipal apartment,-10264,-3173,1,0,1,1,High skill tech staff,2.0,-1,C
3912,5009071,F,Y,Y,0,270000.0,Commercial associate,Incomplete higher,Civil marriage,Municipal apartment,-10264,-3173,1,0,1,1,High skill tech staff,2.0,-2,C
3913,5009071,F,Y,Y,0,270000.0,Commercial associate,Incomplete higher,Civil marriage,Municipal apartment,-10264,-3173,1,0,1,1,High skill tech staff,2.0,-3,C
3914,5009071,F,Y,Y,0,270000.0,Commercial associate,Incomplete higher,Civil marriage,Municipal apartment,-10264,-3173,1,0,1,1,High skill tech staff,2.0,-4,C
3915,5009071,F,Y,Y,0,270000.0,Commercial associate,Incomplete higher,Civil marriage,Municipal apartment,-10264,-3173,1,0,1,1,High skill tech staff,2.0,-5,C
3916,5009071,F,Y,Y,0,270000.0,Commercial associate,Incomplete higher,Civil marriage,Municipal apartment,-10264,-3173,1,0,1,1,High skill tech staff,2.0,-6,C
3917,5009071,F,Y,Y,0,270000.0,Commercial associate,Incomplete higher,Civil marriage,Municipal apartment,-10264,-3173,1,0,1,1,High skill tech staff,2.0,-7,C
3918,5009071,F,Y,Y,0,270000.0,Commercial associate,Incomplete higher,Civil marriage,Municipal apartment,-10264,-3173,1,0,1,1,High skill tech staff,2.0,-8,C
3919,5009071,F,Y,Y,0,270000.0,Commercial associate,Incomplete higher,Civil marriage,Municipal apartment,-10264,-3173,1,0,1,1,High skill tech staff,2.0,-9,0
3920,5009071,F,Y,Y,0,270000.0,Commercial associate,Incomplete higher,Civil marriage,Municipal apartment,-10264,-3173,1,0,1,1,High skill tech staff,2.0,-10,X
3921,5009071,F,Y,Y,0,270000.0,Commercial associate,Incomplete higher,Civil marriage,Municipal apartment,-10264,-3173,1,0,1,1,High skill tech staff,2.0,-11,0
3922,5009071,F,Y,Y,0,270000.0,Commercial associate,Incomplete higher,Civil marriage,Municipal apartment,-10264,-3173,1,0,1,1,High skill tech staff,2.0,-12,0
3923,5009071,F,Y,Y,0,270000.0,Commercial associate,Incomplete higher,Civil marriage,Municipal apartment,-10264,-3173,1,0,1,1,High skill tech staff,2.0,-13,X
3924,5009071,F,Y,Y,0,270000.0,Commercial associate,Incomplete higher,Civil marriage,Municipal apartment,-10264,-3173,1,0,1,1,High skill tech staff,2.0,-14,X
3925,5009071,F,Y,Y,0,270000.0,Commercial associate,Incomplete higher,Civil marriage,Municipal apartment,-10264,-3173,1,0,1,1,High skill tech staff,2.0,-15,0
3926,5009071,F,Y,Y,0,270000.0,Commercial associate,Incomplete higher,Civil marriage,Municipal apartment,-10264,-3173,1,0,1,1,High skill tech staff,2.0,-16,0
3927,5009071,F,Y,Y,0,270000.0,Commercial associate,Incomplete higher,Civil marriage,Municipal apartment,-10264,-3173,1,0,1,1,High skill tech staff,2.0,-17,0
3928,5009071,F,Y,Y,0,270000.0,Commercial associate,Incomplete higher,Civil marriage,Municipal apartment,-10264,-3173,1,0,1,1,High skill tech staff,2.0,-18,X
3929,5009071,F,Y,Y,0,270000.0,Commercial associate,Incomplete higher,Civil marriage,Municipal apartment,-10264,-3173,1,0,1,1,High skill tech staff,2.0,-19,0
3930,5009071,F,Y,Y,0,270000.0,Commercial associate,Incomplete higher,Civil marriage,Municipal apartment,-10264,-3173,1,0,1,1,High skill tech staff,2.0,-20,X
3931,5009072,F,Y,Y,0,270000.0,Commercial associate,Incomplete higher,Civil marriage,Municipal apartment,-10264,-3173,1,0,1,1,High skill tech staff,2.0,-20,C
3932,5009072,F,Y,Y,0,270000.0,Commercial associate,Incomplete higher,Civil marriage,Municipal apartment,-10264,-3173,1,0,1,1,High skill tech staff,2.0,-21,C
3933,5009072,F,Y,Y,0,270000.0,Commercial associate,Incomplete higher,Civil marriage,Municipal apartment,-10264,-3173,1,0,1,1,High skill tech staff,2.0,-22,C
3934,5009072,F,Y,Y,0,270000.0,Commercial associate,Incomplete higher,Civil marriage,Municipal apartment,-10264,-3173,1,0,1,1,High skill tech staff,2.0,-23,C
3935,5009072,F,Y,Y,0,270000.0,Commercial associate,Incomplete higher,Civil marriage,Municipal apartment,-10264,-3173,1,0,1,1,High skill tech staff,2.0,-24,C
3936,5009072,F,Y,Y,0,270000.0,Commercial associate,Incomplete higher,Civil marriage,Municipal apartment,-10264,-3173,1,0,1,1,High skill tech staff,2.0,-25,C
3937,5009072,F,Y,Y,0,270000.0,Commercial associate,Incomplete higher,Civil marriage,Municipal apartment,-10264,-3173,1,0,1,1,High skill tech staff,2.0,-26,C
3938,5009072,F,Y,Y,0,270000.0,Commercial associate,Incomplete higher,Civil marriage,Municipal apartment,-10264,-3173,1,0,1,1,High skill tech staff,2.0,-27,C
3939,5009072,F,Y,Y,0,270000.0,Commercial associate,Incomplete higher,Civil marriage,Municipal apartment,-10264,-3173,1,0,1,1,High skill tech staff,2.0,-28,C
3940,5009072,F,Y,Y,0,270000.0,Commercial associate,Incomplete higher,Civil marriage,Municipal apartment,-10264,-3173,1,0,1,1,High skill tech staff,2.0,-29,C
3941,5009072,F,Y,Y,0,270000.0,Commercial associate,Incomplete higher,Civil marriage,Municipal apartment,-10264,-3173,1,0,1,1,High skill tech staff,2.0,-30,C
3942,5009072,F,Y,Y,0,270000.0,Commercial associate,Incomplete higher,Civil marriage,Municipal apartment,-10264,-3173,1,0,1,1,High skill tech staff,2.0,-31,C
3943,5009072,F,Y,Y,0,270000.0,Commercial associate,Incomplete higher,Civil marriage,Municipal apartment,-10264,-3173,1,0,1,1,High skill tech staff,2.0,-32,0
3944,5009072,F,Y,Y,0,270000.0,Commercial associate,Incomplete higher,Civil marriage,Municipal apartment,-10264,-3173,1,0,1,1,High skill tech staff,2.0,-33,X
3945,5009072,F,Y,Y,0,270000.0,Commercial associate,Incomplete higher,Civil marriage,Municipal apartment,-10264,-3173,1,0,1,1,High skill tech staff,2.0,-34,0
3946,5009072,F,Y,Y,0,270000.0,Commercial associate,Incomplete higher,Civil marriage,Municipal apartment,-10264,-3173,1,0,1,1,High skill tech staff,2.0,-35,0
3947,5009072,F,Y,Y,0,270000.0,Commercial associate,Incomplete higher,Civil marriage,Municipal apartment,-10264,-3173,1,0,1,1,High skill tech staff,2.0,-36,X
3948,5009072,F,Y,Y,0,270000.0,Commercial associate,Incomplete higher,Civil marriage,Municipal apartment,-10264,-3173,1,0,1,1,High skill tech staff,2.0,-37,X
3949,5009072,F,Y,Y,0,270000.0,Commercial associate,Incomplete higher,Civil marriage,Municipal apartment,-10264,-3173,1,0,1,1,High skill tech staff,2.0,-38,0
3950,5009072,F,Y,Y,0,270000.0,Commercial associate,Incomplete higher,Civil marriage,Municipal apartment,-10264,-3173,1,0,1,1,High skill tech staff,2.0,-39,0
3951,5009072,F,Y,Y,0,270000.0,Commercial associate,Incomplete higher,Civil marriage,Municipal apartment,-10264,-3173,1,0,1,1,High skill tech staff,2.0,-40,0
3952,5009072,F,Y,Y,0,270000.0,Commercial associate,Incomplete higher,Civil marriage,Municipal apartment,-10264,-3173,1,0,1,1,High skill tech staff,2.0,-41,X
3953,5009072,F,Y,Y,0,270000.0,Commercial associate,Incomplete higher,Civil marriage,Municipal apartment,-10264,-3173,1,0,1,1,High skill tech staff,2.0,-42,0
3954,5009072,F,Y,Y,0,270000.0,Commercial associate,Incomplete higher,Civil marriage,Municipal apartment,-10264,-3173,1,0,1,1,High skill tech staff,2.0,-43,X
3955,5009074,F,Y,Y,1,450000.0,State servant,Higher education,Married,House / apartment,-17726,-708,1,0,1,1,Core staff,3.0,0,0
3956,5009074,F,Y,Y,1,450000.0,State servant,Higher education,Married,House / apartment,-17726,-708,1,0,1,1,Core staff,3.0,-1,0
3957,5009074,F,Y,Y,1,450000.0,State servant,Higher education,Married,House / apartment,-17726,-708,1,0,1,1,Core staff,3.0,-2,0
3958,5009074,F,Y,Y,1,450000.0,State servant,Higher education,Married,House / apartment,-17726,-708,1,0,1,1,Core staff,3.0,-3,0
3959,5009074,F,Y,Y,1,450000.0,State servant,Higher education,Married,House / apartment,-17726,-708,1,0,1,1,Core staff,3.0,-4,0
3960,5009074,F,Y,Y,1,450000.0,State servant,Higher education,Married,House / apartment,-17726,-708,1,0,1,1,Core staff,3.0,-5,0
3961,5009074,F,Y,Y,1,450000.0,State servant,Higher education,Married,House / apartment,-17726,-708,1,0,1,1,Core staff,3.0,-6,0
3962,5009074,F,Y,Y,1,450000.0,State servant,Higher education,Married,House / apartment,-17726,-708,1,0,1,1,Core staff,3.0,-7,0
3963,5009074,F,Y,Y,1,450000.0,State servant,Higher education,Married,House / apartment,-17726,-708,1,0,1,1,Core staff,3.0,-8,0
3964,5009074,F,Y,Y,1,450000.0,State servant,Higher education,Married,House / apartment,-17726,-708,1,0,1,1,Core staff,3.0,-9,0
3965,5009074,F,Y,Y,1,450000.0,State servant,Higher education,Married,House / apartment,-17726,-708,1,0,1,1,Core staff,3.0,-10,0
3966,5009074,F,Y,Y,1,450000.0,State servant,Higher education,Married,House / apartment,-17726,-708,1,0,1,1,Core staff,3.0,-11,0
3967,5009074,F,Y,Y,1,450000.0,State servant,Higher education,Married,House / apartment,-17726,-708,1,0,1,1,Core staff,3.0,-12,0
3968,5009074,F,Y,Y,1,450000.0,State servant,Higher education,Married,House / apartment,-17726,-708,1,0,1,1,Core staff,3.0,-13,0
3969,5009074,F,Y,Y,1,450000.0,State servant,Higher education,Married,House / apartment,-17726,-708,1,0,1,1,Core staff,3.0,-14,0
3970,5009074,F,Y,Y,1,450000.0,State servant,Higher education,Married,House / apartment,-17726,-708,1,0,1,1,Core staff,3.0,-15,0
3971,5009074,F,Y,Y,1,450000.0,State servant,Higher education,Married,House / apartment,-17726,-708,1,0,1,1,Core staff,3.0,-16,0
3972,5009074,F,Y,Y,1,450000.0,State servant,Higher education,Married,House / apartment,-17726,-708,1,0,1,1,Core staff,3.0,-17,0
3973,5009074,F,Y,Y,1,450000.0,State servant,Higher education,Married,House / apartment,-17726,-708,1,0,1,1,Core staff,3.0,-18,0
3974,5009074,F,Y,Y,1,450000.0,State servant,Higher education,Married,House / apartment,-17726,-708,1,0,1,1,Core staff,3.0,-19,0
3975,5009074,F,Y,Y,1,450000.0,State servant,Higher education,Married,House / apartment,-17726,-708,1,0,1,1,Core staff,3.0,-20,0
3976,5009074,F,Y,Y,1,450000.0,State servant,Higher education,Married,House / apartment,-17726,-708,1,0,1,1,Core staff,3.0,-21,0
3977,5009074,F,Y,Y,1,450000.0,State servant,Higher education,Married,House / apartment,-17726,-708,1,0,1,1,Core staff,3.0,-22,0
3978,5009075,F,Y,Y,1,450000.0,State servant,Higher education,Married,House / apartment,-17726,-708,1,0,1,1,Core staff,3.0,-5,X
3979,5009075,F,Y,Y,1,450000.0,State servant,Higher education,Married,House / apartment,-17726,-708,1,0,1,1,Core staff,3.0,-6,0
3980,5009075,F,Y,Y,1,450000.0,State servant,Higher education,Married,House / apartment,-17726,-708,1,0,1,1,Core staff,3.0,-7,0
3981,5009075,F,Y,Y,1,450000.0,State servant,Higher education,Married,House / apartment,-17726,-708,1,0,1,1,Core staff,3.0,-8,0
3982,5009075,F,Y,Y,1,450000.0,State servant,Higher education,Married,House / apartment,-17726,-708,1,0,1,1,Core staff,3.0,-9,0
3983,5009075,F,Y,Y,1,450000.0,State servant,Higher education,Married,House / apartment,-17726,-708,1,0,1,1,Core staff,3.0,-10,0
3984,5009075,F,Y,Y,1,450000.0,State servant,Higher education,Married,House / apartment,-17726,-708,1,0,1,1,Core staff,3.0,-11,0
3985,5009075,F,Y,Y,1,450000.0,State servant,Higher education,Married,House / apartment,-17726,-708,1,0,1,1,Core staff,3.0,-12,0
3986,5009075,F,Y,Y,1,450000.0,State servant,Higher education,Married,House / apartment,-17726,-708,1,0,1,1,Core staff,3.0,-13,0
3987,5009075,F,Y,Y,1,450000.0,State servant,Higher education,Married,House / apartment,-17726,-708,1,0,1,1,Core staff,3.0,-14,0
3988,5009075,F,Y,Y,1,450000.0,State servant,Higher education,Married,House / apartment,-17726,-708,1,0,1,1,Core staff,3.0,-15,0
3989,5009075,F,Y,Y,1,450000.0,State servant,Higher education,Married,House / apartment,-17726,-708,1,0,1,1,Core staff,3.0,-16,0
3990,5009075,F,Y,Y,1,450000.0,State servant,Higher education,Married,House / apartment,-17726,-708,1,0,1,1,Core staff,3.0,-17,0
3991,5009075,F,Y,Y,1,450000.0,State servant,Higher education,Married,House / apartment,-17726,-708,1,0,1,1,Core staff,3.0,-18,0
3992,5009075,F,Y,Y,1,450000.0,State servant,Higher education,Married,House / apartment,-17726,-708,1,0,1,1,Core staff,3.0,-19,0
3993,5009075,F,Y,Y,1,450000.0,State servant,Higher education,Married,House / apartment,-17726,-708,1,0,1,1,Core staff,3.0,-20,0
3994,5009075,F,Y,Y,1,450000.0,State servant,Higher education,Married,House / apartment,-17726,-708,1,0,1,1,Core staff,3.0,-21,0
3995,5009075,F,Y,Y,1,450000.0,State servant,Higher education,Married,House / apartment,-17726,-708,1,0,1,1,Core staff,3.0,-22,0
3996,5009075,F,Y,Y,1,450000.0,State servant,Higher education,Married,House / apartment,-17726,-708,1,0,1,1,Core staff,3.0,-23,0
3997,5009075,F,Y,Y,1,450000.0,State servant,Higher education,Married,House / apartment,-17726,-708,1,0,1,1,Core staff,3.0,-24,0
3998,5009075,F,Y,Y,1,450000.0,State servant,Higher education,Married,House / apartment,-17726,-708,1,0,1,1,Core staff,3.0,-25,0
3999,5009075,F,Y,Y,1,450000.0,State servant,Higher education,Married,House / apartment,-17726,-708,1,0,1,1,Core staff,3.0,-26,0
4000,5009075,F,Y,Y,1,450000.0,State servant,Higher education,Married,House / apartment,-17726,-708,1,0,1,1,Core staff,3.0,-27,0
4001,5009075,F,Y,Y,1,450000.0,State servant,Higher education,Married,House / apartment,-17726,-708,1,0,1,1,Core staff,3.0,-28,0
4002,5009078,M,N,Y,1,180000.0,Working,Secondary / secondary special,Married,With parents,-14122,-1286,1,0,0,0,Drivers,3.0,0,C
4003,5009078,M,N,Y,1,180000.0,Working,Secondary / secondary special,Married,With parents,-14122,-1286,1,0,0,0,Drivers,3.0,-1,C
4004,5009078,M,N,Y,1,180000.0,Working,Secondary / secondary special,Married,With parents,-14122,-1286,1,0,0,0,Drivers,3.0,-2,C
4005,5009078,M,N,Y,1,180000.0,Working,Secondary / secondary special,Married,With parents,-14122,-1286,1,0,0,0,Drivers,3.0,-3,C
4006,5009078,M,N,Y,1,180000.0,Working,Secondary / secondary special,Married,With parents,-14122,-1286,1,0,0,0,Drivers,3.0,-4,C
4007,5009078,M,N,Y,1,180000.0,Working,Secondary / secondary special,Married,With parents,-14122,-1286,1,0,0,0,Drivers,3.0,-5,C
4008,5009078,M,N,Y,1,180000.0,Working,Secondary / secondary special,Married,With parents,-14122,-1286,1,0,0,0,Drivers,3.0,-6,C
4009,5009078,M,N,Y,1,180000.0,Working,Secondary / secondary special,Married,With parents,-14122,-1286,1,0,0,0,Drivers,3.0,-7,C
4010,5009078,M,N,Y,1,180000.0,Working,Secondary / secondary special,Married,With parents,-14122,-1286,1,0,0,0,Drivers,3.0,-8,C
4011,5009078,M,N,Y,1,180000.0,Working,Secondary / secondary special,Married,With parents,-14122,-1286,1,0,0,0,Drivers,3.0,-9,C
4012,5009078,M,N,Y,1,180000.0,Working,Secondary / secondary special,Married,With parents,-14122,-1286,1,0,0,0,Drivers,3.0,-10,C
4013,5009078,M,N,Y,1,180000.0,Working,Secondary / secondary special,Married,With parents,-14122,-1286,1,0,0,0,Drivers,3.0,-11,C
4014,5009078,M,N,Y,1,180000.0,Working,Secondary / secondary special,Married,With parents,-14122,-1286,1,0,0,0,Drivers,3.0,-12,C
4015,5009078,M,N,Y,1,180000.0,Working,Secondary / secondary special,Married,With parents,-14122,-1286,1,0,0,0,Drivers,3.0,-13,C
4016,5009078,M,N,Y,1,180000.0,Working,Secondary / secondary special,Married,With parents,-14122,-1286,1,0,0,0,Drivers,3.0,-14,C
4017,5009078,M,N,Y,1,180000.0,Working,Secondary / secondary special,Married,With parents,-14122,-1286,1,0,0,0,Drivers,3.0,-15,C
4018,5009078,M,N,Y,1,180000.0,Working,Secondary / secondary special,Married,With parents,-14122,-1286,1,0,0,0,Drivers,3.0,-16,C
4019,5009078,M,N,Y,1,180000.0,Working,Secondary / secondary special,Married,With parents,-14122,-1286,1,0,0,0,Drivers,3.0,-17,C
4020,5009078,M,N,Y,1,180000.0,Working,Secondary / secondary special,Married,With parents,-14122,-1286,1,0,0,0,Drivers,3.0,-18,C
4021,5009078,M,N,Y,1,180000.0,Working,Secondary / secondary special,Married,With parents,-14122,-1286,1,0,0,0,Drivers,3.0,-19,C
4022,5009078,M,N,Y,1,180000.0,Working,Secondary / secondary special,Married,With parents,-14122,-1286,1,0,0,0,Drivers,3.0,-20,C
4023,5009078,M,N,Y,1,180000.0,Working,Secondary / secondary special,Married,With parents,-14122,-1286,1,0,0,0,Drivers,3.0,-21,C
4024,5009078,M,N,Y,1,180000.0,Working,Secondary / secondary special,Married,With parents,-14122,-1286,1,0,0,0,Drivers,3.0,-22,C
4025,5009078,M,N,Y,1,180000.0,Working,Secondary / secondary special,Married,With parents,-14122,-1286,1,0,0,0,Drivers,3.0,-23,C
4026,5009078,M,N,Y,1,180000.0,Working,Secondary / secondary special,Married,With parents,-14122,-1286,1,0,0,0,Drivers,3.0,-24,C
4027,5009078,M,N,Y,1,180000.0,Working,Secondary / secondary special,Married,With parents,-14122,-1286,1,0,0,0,Drivers,3.0,-25,0
4028,5009078,M,N,Y,1,180000.0,Working,Secondary / secondary special,Married,With parents,-14122,-1286,1,0,0,0,Drivers,3.0,-26,0
4029,5009078,M,N,Y,1,180000.0,Working,Secondary / secondary special,Married,With parents,-14122,-1286,1,0,0,0,Drivers,3.0,-27,0
4030,5009078,M,N,Y,1,180000.0,Working,Secondary / secondary special,Married,With parents,-14122,-1286,1,0,0,0,Drivers,3.0,-28,0
4031,5009078,M,N,Y,1,180000.0,Working,Secondary / secondary special,Married,With parents,-14122,-1286,1,0,0,0,Drivers,3.0,-29,0
4032,5009078,M,N,Y,1,180000.0,Working,Secondary / secondary special,Married,With parents,-14122,-1286,1,0,0,0,Drivers,3.0,-30,0
4033,5009079,F,N,Y,0,112500.0,Working,Higher education,Civil marriage,House / apartment,-10064,-3173,1,0,0,1,Laborers,2.0,0,C
4034,5009079,F,N,Y,0,112500.0,Working,Higher education,Civil marriage,House / apartment,-10064,-3173,1,0,0,1,Laborers,2.0,-1,C
4035,5009079,F,N,Y,0,112500.0,Working,Higher education,Civil marriage,House / apartment,-10064,-3173,1,0,0,1,Laborers,2.0,-2,C
4036,5009079,F,N,Y,0,112500.0,Working,Higher education,Civil marriage,House / apartment,-10064,-3173,1,0,0,1,Laborers,2.0,-3,C
4037,5009079,F,N,Y,0,112500.0,Working,Higher education,Civil marriage,House / apartment,-10064,-3173,1,0,0,1,Laborers,2.0,-4,C
4038,5009079,F,N,Y,0,112500.0,Working,Higher education,Civil marriage,House / apartment,-10064,-3173,1,0,0,1,Laborers,2.0,-5,C
4039,5009079,F,N,Y,0,112500.0,Working,Higher education,Civil marriage,House / apartment,-10064,-3173,1,0,0,1,Laborers,2.0,-6,C
4040,5009079,F,N,Y,0,112500.0,Working,Higher education,Civil marriage,House / apartment,-10064,-3173,1,0,0,1,Laborers,2.0,-7,C
4041,5009079,F,N,Y,0,112500.0,Working,Higher education,Civil marriage,House / apartment,-10064,-3173,1,0,0,1,Laborers,2.0,-8,C
4042,5009079,F,N,Y,0,112500.0,Working,Higher education,Civil marriage,House / apartment,-10064,-3173,1,0,0,1,Laborers,2.0,-9,C
4043,5009079,F,N,Y,0,112500.0,Working,Higher education,Civil marriage,House / apartment,-10064,-3173,1,0,0,1,Laborers,2.0,-10,C
4044,5009079,F,N,Y,0,112500.0,Working,Higher education,Civil marriage,House / apartment,-10064,-3173,1,0,0,1,Laborers,2.0,-11,C
4045,5009079,F,N,Y,0,112500.0,Working,Higher education,Civil marriage,House / apartment,-10064,-3173,1,0,0,1,Laborers,2.0,-12,C
4046,5009079,F,N,Y,0,112500.0,Working,Higher education,Civil marriage,House / apartment,-10064,-3173,1,0,0,1,Laborers,2.0,-13,C
4047,5009079,F,N,Y,0,112500.0,Working,Higher education,Civil marriage,House / apartment,-10064,-3173,1,0,0,1,Laborers,2.0,-14,C
4048,5009079,F,N,Y,0,112500.0,Working,Higher education,Civil marriage,House / apartment,-10064,-3173,1,0,0,1,Laborers,2.0,-15,C
4049,5009079,F,N,Y,0,112500.0,Working,Higher education,Civil marriage,House / apartment,-10064,-3173,1,0,0,1,Laborers,2.0,-16,C
4050,5009079,F,N,Y,0,112500.0,Working,Higher education,Civil marriage,House / apartment,-10064,-3173,1,0,0,1,Laborers,2.0,-17,C
4051,5009079,F,N,Y,0,112500.0,Working,Higher education,Civil marriage,House / apartment,-10064,-3173,1,0,0,1,Laborers,2.0,-18,C
4052,5009079,F,N,Y,0,112500.0,Working,Higher education,Civil marriage,House / apartment,-10064,-3173,1,0,0,1,Laborers,2.0,-19,C
4053,5009079,F,N,Y,0,112500.0,Working,Higher education,Civil marriage,House / apartment,-10064,-3173,1,0,0,1,Laborers,2.0,-20,C
4054,5009079,F,N,Y,0,112500.0,Working,Higher education,Civil marriage,House / apartment,-10064,-3173,1,0,0,1,Laborers,2.0,-21,C
4055,5009079,F,N,Y,0,112500.0,Working,Higher education,Civil marriage,House / apartment,-10064,-3173,1,0,0,1,Laborers,2.0,-22,C
4056,5009079,F,N,Y,0,112500.0,Working,Higher education,Civil marriage,House / apartment,-10064,-3173,1,0,0,1,Laborers,2.0,-23,C
4057,5009079,F,N,Y,0,112500.0,Working,Higher education,Civil marriage,House / apartment,-10064,-3173,1,0,0,1,Laborers,2.0,-24,C
4058,5009079,F,N,Y,0,112500.0,Working,Higher education,Civil marriage,House / apartment,-10064,-3173,1,0,0,1,Laborers,2.0,-25,C
4059,5009079,F,N,Y,0,112500.0,Working,Higher education,Civil marriage,House / apartment,-10064,-3173,1,0,0,1,Laborers,2.0,-26,C
4060,5009079,F,N,Y,0,112500.0,Working,Higher education,Civil marriage,House / apartment,-10064,-3173,1,0,0,1,Laborers,2.0,-27,C
4061,5009079,F,N,Y,0,112500.0,Working,Higher education,Civil marriage,House / apartment,-10064,-3173,1,0,0,1,Laborers,2.0,-28,C
4062,5009079,F,N,Y,0,112500.0,Working,Higher education,Civil marriage,House / apartment,-10064,-3173,1,0,0,1,Laborers,2.0,-29,C
4063,5009079,F,N,Y,0,112500.0,Working,Higher education,Civil marriage,House / apartment,-10064,-3173,1,0,0,1,Laborers,2.0,-30,C
4064,5009079,F,N,Y,0,112500.0,Working,Higher education,Civil marriage,House / apartment,-10064,-3173,1,0,0,1,Laborers,2.0,-31,C
4065,5009079,F,N,Y,0,112500.0,Working,Higher education,Civil marriage,House / apartment,-10064,-3173,1,0,0,1,Laborers,2.0,-32,C
4066,5009079,F,N,Y,0,112500.0,Working,Higher education,Civil marriage,House / apartment,-10064,-3173,1,0,0,1,Laborers,2.0,-33,C
4067,5009079,F,N,Y,0,112500.0,Working,Higher education,Civil marriage,House / apartment,-10064,-3173,1,0,0,1,Laborers,2.0,-34,C
4068,5009079,F,N,Y,0,112500.0,Working,Higher education,Civil marriage,House / apartment,-10064,-3173,1,0,0,1,Laborers,2.0,-35,C
4069,5009079,F,N,Y,0,112500.0,Working,Higher education,Civil marriage,House / apartment,-10064,-3173,1,0,0,1,Laborers,2.0,-36,0
4070,5009079,F,N,Y,0,112500.0,Working,Higher education,Civil marriage,House / apartment,-10064,-3173,1,0,0,1,Laborers,2.0,-37,0
4071,5009079,F,N,Y,0,112500.0,Working,Higher education,Civil marriage,House / apartment,-10064,-3173,1,0,0,1,Laborers,2.0,-38,0
4072,5009079,F,N,Y,0,112500.0,Working,Higher education,Civil marriage,House / apartment,-10064,-3173,1,0,0,1,Laborers,2.0,-39,0
4073,5009079,F,N,Y,0,112500.0,Working,Higher education,Civil marriage,House / apartment,-10064,-3173,1,0,0,1,Laborers,2.0,-40,0
4074,5009079,F,N,Y,0,112500.0,Working,Higher education,Civil marriage,House / apartment,-10064,-3173,1,0,0,1,Laborers,2.0,-41,0
4075,5009079,F,N,Y,0,112500.0,Working,Higher education,Civil marriage,House / apartment,-10064,-3173,1,0,0,1,Laborers,2.0,-42,0
4076,5009079,F,N,Y,0,112500.0,Working,Higher education,Civil marriage,House / apartment,-10064,-3173,1,0,0,1,Laborers,2.0,-43,0
4077,5009080,F,N,Y,0,112500.0,Working,Higher education,Civil marriage,House / apartment,-10064,-3173,1,0,0,1,Laborers,2.0,0,C
4078,5009080,F,N,Y,0,112500.0,Working,Higher education,Civil marriage,House / apartment,-10064,-3173,1,0,0,1,Laborers,2.0,-1,C
4079,5009080,F,N,Y,0,112500.0,Working,Higher education,Civil marriage,House / apartment,-10064,-3173,1,0,0,1,Laborers,2.0,-2,C
4080,5009080,F,N,Y,0,112500.0,Working,Higher education,Civil marriage,House / apartment,-10064,-3173,1,0,0,1,Laborers,2.0,-3,C
4081,5009080,F,N,Y,0,112500.0,Working,Higher education,Civil marriage,House / apartment,-10064,-3173,1,0,0,1,Laborers,2.0,-4,0
4082,5009080,F,N,Y,0,112500.0,Working,Higher education,Civil marriage,House / apartment,-10064,-3173,1,0,0,1,Laborers,2.0,-5,0
4083,5009080,F,N,Y,0,112500.0,Working,Higher education,Civil marriage,House / apartment,-10064,-3173,1,0,0,1,Laborers,2.0,-6,0
4084,5009080,F,N,Y,0,112500.0,Working,Higher education,Civil marriage,House / apartment,-10064,-3173,1,0,0,1,Laborers,2.0,-7,0
4085,5009080,F,N,Y,0,112500.0,Working,Higher education,Civil marriage,House / apartment,-10064,-3173,1,0,0,1,Laborers,2.0,-8,0
4086,5009080,F,N,Y,0,112500.0,Working,Higher education,Civil marriage,House / apartment,-10064,-3173,1,0,0,1,Laborers,2.0,-9,0
4087,5009080,F,N,Y,0,112500.0,Working,Higher education,Civil marriage,House / apartment,-10064,-3173,1,0,0,1,Laborers,2.0,-10,1
4088,5009080,F,N,Y,0,112500.0,Working,Higher education,Civil marriage,House / apartment,-10064,-3173,1,0,0,1,Laborers,2.0,-11,1
4089,5009080,F,N,Y,0,112500.0,Working,Higher education,Civil marriage,House / apartment,-10064,-3173,1,0,0,1,Laborers,2.0,-12,1
4090,5009080,F,N,Y,0,112500.0,Working,Higher education,Civil marriage,House / apartment,-10064,-3173,1,0,0,1,Laborers,2.0,-13,1
4091,5009080,F,N,Y,0,112500.0,Working,Higher education,Civil marriage,House / apartment,-10064,-3173,1,0,0,1,Laborers,2.0,-14,0
4092,5009080,F,N,Y,0,112500.0,Working,Higher education,Civil marriage,House / apartment,-10064,-3173,1,0,0,1,Laborers,2.0,-15,0
4093,5009081,F,N,Y,0,112500.0,Working,Higher education,Civil marriage,House / apartment,-10064,-3173,1,0,0,1,Laborers,2.0,-3,X
4094,5009081,F,N,Y,0,112500.0,Working,Higher education,Civil marriage,House / apartment,-10064,-3173,1,0,0,1,Laborers,2.0,-4,0
4095,5009081,F,N,Y,0,112500.0,Working,Higher education,Civil marriage,House / apartment,-10064,-3173,1,0,0,1,Laborers,2.0,-5,0
4096,5009081,F,N,Y,0,112500.0,Working,Higher education,Civil marriage,House / apartment,-10064,-3173,1,0,0,1,Laborers,2.0,-6,0
4097,5009081,F,N,Y,0,112500.0,Working,Higher education,Civil marriage,House / apartment,-10064,-3173,1,0,0,1,Laborers,2.0,-7,0
4098,5009081,F,N,Y,0,112500.0,Working,Higher education,Civil marriage,House / apartment,-10064,-3173,1,0,0,1,Laborers,2.0,-8,0
4099,5009081,F,N,Y,0,112500.0,Working,Higher education,Civil marriage,House / apartment,-10064,-3173,1,0,0,1,Laborers,2.0,-9,0
4100,5009081,F,N,Y,0,112500.0,Working,Higher education,Civil marriage,House / apartment,-10064,-3173,1,0,0,1,Laborers,2.0,-10,X
4101,5009081,F,N,Y,0,112500.0,Working,Higher education,Civil marriage,House / apartment,-10064,-3173,1,0,0,1,Laborers,2.0,-11,0
4102,5009081,F,N,Y,0,112500.0,Working,Higher education,Civil marriage,House / apartment,-10064,-3173,1,0,0,1,Laborers,2.0,-12,X
4103,5009081,F,N,Y,0,112500.0,Working,Higher education,Civil marriage,House / apartment,-10064,-3173,1,0,0,1,Laborers,2.0,-13,0
4104,5009081,F,N,Y,0,112500.0,Working,Higher education,Civil marriage,House / apartment,-10064,-3173,1,0,0,1,Laborers,2.0,-14,X
4105,5009081,F,N,Y,0,112500.0,Working,Higher education,Civil marriage,House / apartment,-10064,-3173,1,0,0,1,Laborers,2.0,-15,0
4106,5009081,F,N,Y,0,112500.0,Working,Higher education,Civil marriage,House / apartment,-10064,-3173,1,0,0,1,Laborers,2.0,-16,0
4107,5009081,F,N,Y,0,112500.0,Working,Higher education,Civil marriage,House / apartment,-10064,-3173,1,0,0,1,Laborers,2.0,-17,X
4108,5009081,F,N,Y,0,112500.0,Working,Higher education,Civil marriage,House / apartment,-10064,-3173,1,0,0,1,Laborers,2.0,-18,X
4109,5009081,F,N,Y,0,112500.0,Working,Higher education,Civil marriage,House / apartment,-10064,-3173,1,0,0,1,Laborers,2.0,-19,0
4110,5009083,M,N,Y,0,90000.0,Working,Secondary / secondary special,Married,House / apartment,-20531,-5730,1,0,0,0,Drivers,2.0,-4,C
4111,5009083,M,N,Y,0,90000.0,Working,Secondary / secondary special,Married,House / apartment,-20531,-5730,1,0,0,0,Drivers,2.0,-5,C
4112,5009083,M,N,Y,0,90000.0,Working,Secondary / secondary special,Married,House / apartment,-20531,-5730,1,0,0,0,Drivers,2.0,-6,C
4113,5009083,M,N,Y,0,90000.0,Working,Secondary / secondary special,Married,House / apartment,-20531,-5730,1,0,0,0,Drivers,2.0,-7,C
4114,5009083,M,N,Y,0,90000.0,Working,Secondary / secondary special,Married,House / apartment,-20531,-5730,1,0,0,0,Drivers,2.0,-8,C
4115,5009083,M,N,Y,0,90000.0,Working,Secondary / secondary special,Married,House / apartment,-20531,-5730,1,0,0,0,Drivers,2.0,-9,C
4116,5009083,M,N,Y,0,90000.0,Working,Secondary / secondary special,Married,House / apartment,-20531,-5730,1,0,0,0,Drivers,2.0,-10,C
4117,5009083,M,N,Y,0,90000.0,Working,Secondary / secondary special,Married,House / apartment,-20531,-5730,1,0,0,0,Drivers,2.0,-11,C
4118,5009083,M,N,Y,0,90000.0,Working,Secondary / secondary special,Married,House / apartment,-20531,-5730,1,0,0,0,Drivers,2.0,-12,C
4119,5009083,M,N,Y,0,90000.0,Working,Secondary / secondary special,Married,House / apartment,-20531,-5730,1,0,0,0,Drivers,2.0,-13,C
4120,5009083,M,N,Y,0,90000.0,Working,Secondary / secondary special,Married,House / apartment,-20531,-5730,1,0,0,0,Drivers,2.0,-14,C
4121,5009083,M,N,Y,0,90000.0,Working,Secondary / secondary special,Married,House / apartment,-20531,-5730,1,0,0,0,Drivers,2.0,-15,C
4122,5009083,M,N,Y,0,90000.0,Working,Secondary / secondary special,Married,House / apartment,-20531,-5730,1,0,0,0,Drivers,2.0,-16,C
4123,5009083,M,N,Y,0,90000.0,Working,Secondary / secondary special,Married,House / apartment,-20531,-5730,1,0,0,0,Drivers,2.0,-17,C
4124,5009083,M,N,Y,0,90000.0,Working,Secondary / secondary special,Married,House / apartment,-20531,-5730,1,0,0,0,Drivers,2.0,-18,C
4125,5009083,M,N,Y,0,90000.0,Working,Secondary / secondary special,Married,House / apartment,-20531,-5730,1,0,0,0,Drivers,2.0,-19,C
4126,5009083,M,N,Y,0,90000.0,Working,Secondary / secondary special,Married,House / apartment,-20531,-5730,1,0,0,0,Drivers,2.0,-20,C
4127,5009083,M,N,Y,0,90000.0,Working,Secondary / secondary special,Married,House / apartment,-20531,-5730,1,0,0,0,Drivers,2.0,-21,C
4128,5009083,M,N,Y,0,90000.0,Working,Secondary / secondary special,Married,House / apartment,-20531,-5730,1,0,0,0,Drivers,2.0,-22,C
4129,5009083,M,N,Y,0,90000.0,Working,Secondary / secondary special,Married,House / apartment,-20531,-5730,1,0,0,0,Drivers,2.0,-23,C
4130,5009083,M,N,Y,0,90000.0,Working,Secondary / secondary special,Married,House / apartment,-20531,-5730,1,0,0,0,Drivers,2.0,-24,C
4131,5009083,M,N,Y,0,90000.0,Working,Secondary / secondary special,Married,House / apartment,-20531,-5730,1,0,0,0,Drivers,2.0,-25,C
4132,5009083,M,N,Y,0,90000.0,Working,Secondary / secondary special,Married,House / apartment,-20531,-5730,1,0,0,0,Drivers,2.0,-26,C
4133,5009083,M,N,Y,0,90000.0,Working,Secondary / secondary special,Married,House / apartment,-20531,-5730,1,0,0,0,Drivers,2.0,-27,C
4134,5009083,M,N,Y,0,90000.0,Working,Secondary / secondary special,Married,House / apartment,-20531,-5730,1,0,0,0,Drivers,2.0,-28,C
4135,5009083,M,N,Y,0,90000.0,Working,Secondary / secondary special,Married,House / apartment,-20531,-5730,1,0,0,0,Drivers,2.0,-29,C
4136,5009083,M,N,Y,0,90000.0,Working,Secondary / secondary special,Married,House / apartment,-20531,-5730,1,0,0,0,Drivers,2.0,-30,C
4137,5009083,M,N,Y,0,90000.0,Working,Secondary / secondary special,Married,House / apartment,-20531,-5730,1,0,0,0,Drivers,2.0,-31,C
4138,5009083,M,N,Y,0,90000.0,Working,Secondary / secondary special,Married,House / apartment,-20531,-5730,1,0,0,0,Drivers,2.0,-32,C
4139,5009083,M,N,Y,0,90000.0,Working,Secondary / secondary special,Married,House / apartment,-20531,-5730,1,0,0,0,Drivers,2.0,-33,C
4140,5009083,M,N,Y,0,90000.0,Working,Secondary / secondary special,Married,House / apartment,-20531,-5730,1,0,0,0,Drivers,2.0,-34,C
4141,5009083,M,N,Y,0,90000.0,Working,Secondary / secondary special,Married,House / apartment,-20531,-5730,1,0,0,0,Drivers,2.0,-35,C
4142,5009083,M,N,Y,0,90000.0,Working,Secondary / secondary special,Married,House / apartment,-20531,-5730,1,0,0,0,Drivers,2.0,-36,C
4143,5009083,M,N,Y,0,90000.0,Working,Secondary / secondary special,Married,House / apartment,-20531,-5730,1,0,0,0,Drivers,2.0,-37,C
4144,5009083,M,N,Y,0,90000.0,Working,Secondary / secondary special,Married,House / apartment,-20531,-5730,1,0,0,0,Drivers,2.0,-38,C
4145,5009083,M,N,Y,0,90000.0,Working,Secondary / secondary special,Married,House / apartment,-20531,-5730,1,0,0,0,Drivers,2.0,-39,C
4146,5009083,M,N,Y,0,90000.0,Working,Secondary / secondary special,Married,House / apartment,-20531,-5730,1,0,0,0,Drivers,2.0,-40,C
4147,5009083,M,N,Y,0,90000.0,Working,Secondary / secondary special,Married,House / apartment,-20531,-5730,1,0,0,0,Drivers,2.0,-41,C
4148,5009083,M,N,Y,0,90000.0,Working,Secondary / secondary special,Married,House / apartment,-20531,-5730,1,0,0,0,Drivers,2.0,-42,C
4149,5009083,M,N,Y,0,90000.0,Working,Secondary / secondary special,Married,House / apartment,-20531,-5730,1,0,0,0,Drivers,2.0,-43,X
4150,5009083,M,N,Y,0,90000.0,Working,Secondary / secondary special,Married,House / apartment,-20531,-5730,1,0,0,0,Drivers,2.0,-44,X
4151,5009083,M,N,Y,0,90000.0,Working,Secondary / secondary special,Married,House / apartment,-20531,-5730,1,0,0,0,Drivers,2.0,-45,X
4152,5009083,M,N,Y,0,90000.0,Working,Secondary / secondary special,Married,House / apartment,-20531,-5730,1,0,0,0,Drivers,2.0,-46,X
4153,5009083,M,N,Y,0,90000.0,Working,Secondary / secondary special,Married,House / apartment,-20531,-5730,1,0,0,0,Drivers,2.0,-47,X
4154,5009083,M,N,Y,0,90000.0,Working,Secondary / secondary special,Married,House / apartment,-20531,-5730,1,0,0,0,Drivers,2.0,-48,X
4155,5009083,M,N,Y,0,90000.0,Working,Secondary / secondary special,Married,House / apartment,-20531,-5730,1,0,0,0,Drivers,2.0,-49,X
4156,5009083,M,N,Y,0,90000.0,Working,Secondary / secondary special,Married,House / apartment,-20531,-5730,1,0,0,0,Drivers,2.0,-50,X
4157,5009083,M,N,Y,0,90000.0,Working,Secondary / secondary special,Married,House / apartment,-20531,-5730,1,0,0,0,Drivers,2.0,-51,X
4158,5009084,M,N,Y,0,90000.0,Working,Secondary / secondary special,Married,House / apartment,-20531,-5730,1,0,0,0,Drivers,2.0,0,0
4159,5009084,M,N,Y,0,90000.0,Working,Secondary / secondary special,Married,House / apartment,-20531,-5730,1,0,0,0,Drivers,2.0,-1,0
4160,5009084,M,N,Y,0,90000.0,Working,Secondary / secondary special,Married,House / apartment,-20531,-5730,1,0,0,0,Drivers,2.0,-2,0
4161,5009088,M,Y,N,2,202500.0,Commercial associate,Higher education,Married,House / apartment,-14730,-2989,1,0,0,0,Laborers,4.0,-6,X
4162,5009088,M,Y,N,2,202500.0,Commercial associate,Higher education,Married,House / apartment,-14730,-2989,1,0,0,0,Laborers,4.0,-7,0
4163,5009088,M,Y,N,2,202500.0,Commercial associate,Higher education,Married,House / apartment,-14730,-2989,1,0,0,0,Laborers,4.0,-8,0
4164,5009088,M,Y,N,2,202500.0,Commercial associate,Higher education,Married,House / apartment,-14730,-2989,1,0,0,0,Laborers,4.0,-9,0
4165,5009088,M,Y,N,2,202500.0,Commercial associate,Higher education,Married,House / apartment,-14730,-2989,1,0,0,0,Laborers,4.0,-10,0
4166,5009088,M,Y,N,2,202500.0,Commercial associate,Higher education,Married,House / apartment,-14730,-2989,1,0,0,0,Laborers,4.0,-11,0
4167,5009088,M,Y,N,2,202500.0,Commercial associate,Higher education,Married,House / apartment,-14730,-2989,1,0,0,0,Laborers,4.0,-12,0
4168,5009088,M,Y,N,2,202500.0,Commercial associate,Higher education,Married,House / apartment,-14730,-2989,1,0,0,0,Laborers,4.0,-13,0
4169,5009088,M,Y,N,2,202500.0,Commercial associate,Higher education,Married,House / apartment,-14730,-2989,1,0,0,0,Laborers,4.0,-14,0
4170,5009088,M,Y,N,2,202500.0,Commercial associate,Higher education,Married,House / apartment,-14730,-2989,1,0,0,0,Laborers,4.0,-15,0
4171,5009088,M,Y,N,2,202500.0,Commercial associate,Higher education,Married,House / apartment,-14730,-2989,1,0,0,0,Laborers,4.0,-16,0
4172,5009088,M,Y,N,2,202500.0,Commercial associate,Higher education,Married,House / apartment,-14730,-2989,1,0,0,0,Laborers,4.0,-17,0
4173,5009088,M,Y,N,2,202500.0,Commercial associate,Higher education,Married,House / apartment,-14730,-2989,1,0,0,0,Laborers,4.0,-18,0
4174,5009088,M,Y,N,2,202500.0,Commercial associate,Higher education,Married,House / apartment,-14730,-2989,1,0,0,0,Laborers,4.0,-19,0
4175,5009088,M,Y,N,2,202500.0,Commercial associate,Higher education,Married,House / apartment,-14730,-2989,1,0,0,0,Laborers,4.0,-20,0
4176,5009088,M,Y,N,2,202500.0,Commercial associate,Higher education,Married,House / apartment,-14730,-2989,1,0,0,0,Laborers,4.0,-21,0
4177,5009088,M,Y,N,2,202500.0,Commercial associate,Higher education,Married,House / apartment,-14730,-2989,1,0,0,0,Laborers,4.0,-22,0
4178,5009088,M,Y,N,2,202500.0,Commercial associate,Higher education,Married,House / apartment,-14730,-2989,1,0,0,0,Laborers,4.0,-23,0
4179,5009088,M,Y,N,2,202500.0,Commercial associate,Higher education,Married,House / apartment,-14730,-2989,1,0,0,0,Laborers,4.0,-24,0
4180,5009088,M,Y,N,2,202500.0,Commercial associate,Higher education,Married,House / apartment,-14730,-2989,1,0,0,0,Laborers,4.0,-25,0
4181,5009088,M,Y,N,2,202500.0,Commercial associate,Higher education,Married,House / apartment,-14730,-2989,1,0,0,0,Laborers,4.0,-26,0
4182,5009088,M,Y,N,2,202500.0,Commercial associate,Higher education,Married,House / apartment,-14730,-2989,1,0,0,0,Laborers,4.0,-27,0
4183,5009088,M,Y,N,2,202500.0,Commercial associate,Higher education,Married,House / apartment,-14730,-2989,1,0,0,0,Laborers,4.0,-28,0
4184,5009088,M,Y,N,2,202500.0,Commercial associate,Higher education,Married,House / apartment,-14730,-2989,1,0,0,0,Laborers,4.0,-29,0
4185,5009088,M,Y,N,2,202500.0,Commercial associate,Higher education,Married,House / apartment,-14730,-2989,1,0,0,0,Laborers,4.0,-30,0
4186,5009088,M,Y,N,2,202500.0,Commercial associate,Higher education,Married,House / apartment,-14730,-2989,1,0,0,0,Laborers,4.0,-31,0
4187,5009088,M,Y,N,2,202500.0,Commercial associate,Higher education,Married,House / apartment,-14730,-2989,1,0,0,0,Laborers,4.0,-32,0
4188,5009088,M,Y,N,2,202500.0,Commercial associate,Higher education,Married,House / apartment,-14730,-2989,1,0,0,0,Laborers,4.0,-33,0
4189,5009088,M,Y,N,2,202500.0,Commercial associate,Higher education,Married,House / apartment,-14730,-2989,1,0,0,0,Laborers,4.0,-34,0
4190,5009088,M,Y,N,2,202500.0,Commercial associate,Higher education,Married,House / apartment,-14730,-2989,1,0,0,0,Laborers,4.0,-35,0
4191,5009088,M,Y,N,2,202500.0,Commercial associate,Higher education,Married,House / apartment,-14730,-2989,1,0,0,0,Laborers,4.0,-36,0
4192,5009088,M,Y,N,2,202500.0,Commercial associate,Higher education,Married,House / apartment,-14730,-2989,1,0,0,0,Laborers,4.0,-37,0
4193,5009088,M,Y,N,2,202500.0,Commercial associate,Higher education,Married,House / apartment,-14730,-2989,1,0,0,0,Laborers,4.0,-38,0
4194,5009088,M,Y,N,2,202500.0,Commercial associate,Higher education,Married,House / apartment,-14730,-2989,1,0,0,0,Laborers,4.0,-39,X
4195,5009088,M,Y,N,2,202500.0,Commercial associate,Higher education,Married,House / apartment,-14730,-2989,1,0,0,0,Laborers,4.0,-40,X
4196,5009088,M,Y,N,2,202500.0,Commercial associate,Higher education,Married,House / apartment,-14730,-2989,1,0,0,0,Laborers,4.0,-41,X
4197,5009088,M,Y,N,2,202500.0,Commercial associate,Higher education,Married,House / apartment,-14730,-2989,1,0,0,0,Laborers,4.0,-42,X
4198,5009088,M,Y,N,2,202500.0,Commercial associate,Higher education,Married,House / apartment,-14730,-2989,1,0,0,0,Laborers,4.0,-43,X
4199,5009088,M,Y,N,2,202500.0,Commercial associate,Higher education,Married,House / apartment,-14730,-2989,1,0,0,0,Laborers,4.0,-44,X
4200,5009088,M,Y,N,2,202500.0,Commercial associate,Higher education,Married,House / apartment,-14730,-2989,1,0,0,0,Laborers,4.0,-45,X
4201,5009088,M,Y,N,2,202500.0,Commercial associate,Higher education,Married,House / apartment,-14730,-2989,1,0,0,0,Laborers,4.0,-46,X
4202,5009089,M,Y,N,2,202500.0,Commercial associate,Higher education,Married,House / apartment,-14730,-2989,1,0,0,0,Laborers,4.0,0,0
4203,5009089,M,Y,N,2,202500.0,Commercial associate,Higher education,Married,House / apartment,-14730,-2989,1,0,0,0,Laborers,4.0,-1,0
4204,5009089,M,Y,N,2,202500.0,Commercial associate,Higher education,Married,House / apartment,-14730,-2989,1,0,0,0,Laborers,4.0,-2,0
4205,5009089,M,Y,N,2,202500.0,Commercial associate,Higher education,Married,House / apartment,-14730,-2989,1,0,0,0,Laborers,4.0,-3,0
4206,5009089,M,Y,N,2,202500.0,Commercial associate,Higher education,Married,House / apartment,-14730,-2989,1,0,0,0,Laborers,4.0,-4,0
4207,5009089,M,Y,N,2,202500.0,Commercial associate,Higher education,Married,House / apartment,-14730,-2989,1,0,0,0,Laborers,4.0,-5,0
4208,5009089,M,Y,N,2,202500.0,Commercial associate,Higher education,Married,House / apartment,-14730,-2989,1,0,0,0,Laborers,4.0,-6,0
4209,5009089,M,Y,N,2,202500.0,Commercial associate,Higher education,Married,House / apartment,-14730,-2989,1,0,0,0,Laborers,4.0,-7,0
4210,5009089,M,Y,N,2,202500.0,Commercial associate,Higher education,Married,House / apartment,-14730,-2989,1,0,0,0,Laborers,4.0,-8,0
4211,5009089,M,Y,N,2,202500.0,Commercial associate,Higher education,Married,House / apartment,-14730,-2989,1,0,0,0,Laborers,4.0,-9,0
4212,5009089,M,Y,N,2,202500.0,Commercial associate,Higher education,Married,House / apartment,-14730,-2989,1,0,0,0,Laborers,4.0,-10,0
4213,5009089,M,Y,N,2,202500.0,Commercial associate,Higher education,Married,House / apartment,-14730,-2989,1,0,0,0,Laborers,4.0,-11,0
4214,5009089,M,Y,N,2,202500.0,Commercial associate,Higher education,Married,House / apartment,-14730,-2989,1,0,0,0,Laborers,4.0,-12,0
4215,5009089,M,Y,N,2,202500.0,Commercial associate,Higher education,Married,House / apartment,-14730,-2989,1,0,0,0,Laborers,4.0,-13,0
4216,5009089,M,Y,N,2,202500.0,Commercial associate,Higher education,Married,House / apartment,-14730,-2989,1,0,0,0,Laborers,4.0,-14,0
4217,5009089,M,Y,N,2,202500.0,Commercial associate,Higher education,Married,House / apartment,-14730,-2989,1,0,0,0,Laborers,4.0,-15,0
4218,5009089,M,Y,N,2,202500.0,Commercial associate,Higher education,Married,House / apartment,-14730,-2989,1,0,0,0,Laborers,4.0,-16,0
4219,5009089,M,Y,N,2,202500.0,Commercial associate,Higher education,Married,House / apartment,-14730,-2989,1,0,0,0,Laborers,4.0,-17,0
4220,5009089,M,Y,N,2,202500.0,Commercial associate,Higher education,Married,House / apartment,-14730,-2989,1,0,0,0,Laborers,4.0,-18,0
4221,5009089,M,Y,N,2,202500.0,Commercial associate,Higher education,Married,House / apartment,-14730,-2989,1,0,0,0,Laborers,4.0,-19,0
4222,5009089,M,Y,N,2,202500.0,Commercial associate,Higher education,Married,House / apartment,-14730,-2989,1,0,0,0,Laborers,4.0,-20,0
4223,5009089,M,Y,N,2,202500.0,Commercial associate,Higher education,Married,House / apartment,-14730,-2989,1,0,0,0,Laborers,4.0,-21,0
4224,5009089,M,Y,N,2,202500.0,Commercial associate,Higher education,Married,House / apartment,-14730,-2989,1,0,0,0,Laborers,4.0,-22,0
4225,5009089,M,Y,N,2,202500.0,Commercial associate,Higher education,Married,House / apartment,-14730,-2989,1,0,0,0,Laborers,4.0,-23,0
4226,5009089,M,Y,N,2,202500.0,Commercial associate,Higher education,Married,House / apartment,-14730,-2989,1,0,0,0,Laborers,4.0,-24,0
4227,5009089,M,Y,N,2,202500.0,Commercial associate,Higher education,Married,House / apartment,-14730,-2989,1,0,0,0,Laborers,4.0,-25,0
4228,5009089,M,Y,N,2,202500.0,Commercial associate,Higher education,Married,House / apartment,-14730,-2989,1,0,0,0,Laborers,4.0,-26,0
4229,5009089,M,Y,N,2,202500.0,Commercial associate,Higher education,Married,House / apartment,-14730,-2989,1,0,0,0,Laborers,4.0,-27,0
4230,5009089,M,Y,N,2,202500.0,Commercial associate,Higher education,Married,House / apartment,-14730,-2989,1,0,0,0,Laborers,4.0,-28,0
4231,5009089,M,Y,N,2,202500.0,Commercial associate,Higher education,Married,House / apartment,-14730,-2989,1,0,0,0,Laborers,4.0,-29,0
4232,5009089,M,Y,N,2,202500.0,Commercial associate,Higher education,Married,House / apartment,-14730,-2989,1,0,0,0,Laborers,4.0,-30,0
4233,5009089,M,Y,N,2,202500.0,Commercial associate,Higher education,Married,House / apartment,-14730,-2989,1,0,0,0,Laborers,4.0,-31,0
4234,5009089,M,Y,N,2,202500.0,Commercial associate,Higher education,Married,House / apartment,-14730,-2989,1,0,0,0,Laborers,4.0,-32,X
4235,5009089,M,Y,N,2,202500.0,Commercial associate,Higher education,Married,House / apartment,-14730,-2989,1,0,0,0,Laborers,4.0,-33,X
4236,5009089,M,Y,N,2,202500.0,Commercial associate,Higher education,Married,House / apartment,-14730,-2989,1,0,0,0,Laborers,4.0,-34,X
4237,5009089,M,Y,N,2,202500.0,Commercial associate,Higher education,Married,House / apartment,-14730,-2989,1,0,0,0,Laborers,4.0,-35,X
4238,5009089,M,Y,N,2,202500.0,Commercial associate,Higher education,Married,House / apartment,-14730,-2989,1,0,0,0,Laborers,4.0,-36,X
4239,5009089,M,Y,N,2,202500.0,Commercial associate,Higher education,Married,House / apartment,-14730,-2989,1,0,0,0,Laborers,4.0,-37,X
4240,5009089,M,Y,N,2,202500.0,Commercial associate,Higher education,Married,House / apartment,-14730,-2989,1,0,0,0,Laborers,4.0,-38,X
4241,5009089,M,Y,N,2,202500.0,Commercial associate,Higher education,Married,House / apartment,-14730,-2989,1,0,0,0,Laborers,4.0,-39,X
4242,5009090,M,Y,Y,0,247500.0,Working,Secondary / secondary special,Married,House / apartment,-12628,-4025,1,0,0,0,Drivers,2.0,0,0
4243,5009090,M,Y,Y,0,247500.0,Working,Secondary / secondary special,Married,House / apartment,-12628,-4025,1,0,0,0,Drivers,2.0,-1,0
4244,5009090,M,Y,Y,0,247500.0,Working,Secondary / secondary special,Married,House / apartment,-12628,-4025,1,0,0,0,Drivers,2.0,-2,0
4245,5009090,M,Y,Y,0,247500.0,Working,Secondary / secondary special,Married,House / apartment,-12628,-4025,1,0,0,0,Drivers,2.0,-3,0
4246,5009090,M,Y,Y,0,247500.0,Working,Secondary / secondary special,Married,House / apartment,-12628,-4025,1,0,0,0,Drivers,2.0,-4,0
4247,5009090,M,Y,Y,0,247500.0,Working,Secondary / secondary special,Married,House / apartment,-12628,-4025,1,0,0,0,Drivers,2.0,-5,0
4248,5009090,M,Y,Y,0,247500.0,Working,Secondary / secondary special,Married,House / apartment,-12628,-4025,1,0,0,0,Drivers,2.0,-6,0
4249,5009090,M,Y,Y,0,247500.0,Working,Secondary / secondary special,Married,House / apartment,-12628,-4025,1,0,0,0,Drivers,2.0,-7,0
4250,5009090,M,Y,Y,0,247500.0,Working,Secondary / secondary special,Married,House / apartment,-12628,-4025,1,0,0,0,Drivers,2.0,-8,0
4251,5009090,M,Y,Y,0,247500.0,Working,Secondary / secondary special,Married,House / apartment,-12628,-4025,1,0,0,0,Drivers,2.0,-9,0
4252,5009090,M,Y,Y,0,247500.0,Working,Secondary / secondary special,Married,House / apartment,-12628,-4025,1,0,0,0,Drivers,2.0,-10,0
4253,5009090,M,Y,Y,0,247500.0,Working,Secondary / secondary special,Married,House / apartment,-12628,-4025,1,0,0,0,Drivers,2.0,-11,0
4254,5009090,M,Y,Y,0,247500.0,Working,Secondary / secondary special,Married,House / apartment,-12628,-4025,1,0,0,0,Drivers,2.0,-12,0
4255,5009090,M,Y,Y,0,247500.0,Working,Secondary / secondary special,Married,House / apartment,-12628,-4025,1,0,0,0,Drivers,2.0,-13,0
4256,5009092,M,Y,Y,1,765000.0,Working,Higher education,Married,House / apartment,-12197,-1194,1,1,0,0,Managers,3.0,0,1
4257,5009092,M,Y,Y,1,765000.0,Working,Higher education,Married,House / apartment,-12197,-1194,1,1,0,0,Managers,3.0,-1,1
4258,5009092,M,Y,Y,1,765000.0,Working,Higher education,Married,House / apartment,-12197,-1194,1,1,0,0,Managers,3.0,-2,0
4259,5009092,M,Y,Y,1,765000.0,Working,Higher education,Married,House / apartment,-12197,-1194,1,1,0,0,Managers,3.0,-3,0
4260,5009094,M,Y,Y,1,765000.0,Working,Higher education,Married,House / apartment,-12197,-1194,1,1,0,0,Managers,3.0,0,0
4261,5009094,M,Y,Y,1,765000.0,Working,Higher education,Married,House / apartment,-12197,-1194,1,1,0,0,Managers,3.0,-1,0
4262,5009094,M,Y,Y,1,765000.0,Working,Higher education,Married,House / apartment,-12197,-1194,1,1,0,0,Managers,3.0,-2,0
4263,5009094,M,Y,Y,1,765000.0,Working,Higher education,Married,House / apartment,-12197,-1194,1,1,0,0,Managers,3.0,-3,0
4264,5009095,M,Y,Y,1,765000.0,Working,Higher education,Married,House / apartment,-12197,-1194,1,1,0,0,Managers,3.0,0,0
4265,5009095,M,Y,Y,1,765000.0,Working,Higher education,Married,House / apartment,-12197,-1194,1,1,0,0,Managers,3.0,-1,0
4266,5009095,M,Y,Y,1,765000.0,Working,Higher education,Married,House / apartment,-12197,-1194,1,1,0,0,Managers,3.0,-2,0
4267,5009095,M,Y,Y,1,765000.0,Working,Higher education,Married,House / apartment,-12197,-1194,1,1,0,0,Managers,3.0,-3,0
4268,5009096,F,N,Y,1,270000.0,Commercial associate,Secondary / secondary special,Married,House / apartment,-13679,-4391,1,0,0,1,Accountants,3.0,0,C
4269,5009096,F,N,Y,1,270000.0,Commercial associate,Secondary / secondary special,Married,House / apartment,-13679,-4391,1,0,0,1,Accountants,3.0,-1,C
4270,5009096,F,N,Y,1,270000.0,Commercial associate,Secondary / secondary special,Married,House / apartment,-13679,-4391,1,0,0,1,Accountants,3.0,-2,C
4271,5009096,F,N,Y,1,270000.0,Commercial associate,Secondary / secondary special,Married,House / apartment,-13679,-4391,1,0,0,1,Accountants,3.0,-3,C
4272,5009096,F,N,Y,1,270000.0,Commercial associate,Secondary / secondary special,Married,House / apartment,-13679,-4391,1,0,0,1,Accountants,3.0,-4,C
4273,5009096,F,N,Y,1,270000.0,Commercial associate,Secondary / secondary special,Married,House / apartment,-13679,-4391,1,0,0,1,Accountants,3.0,-5,C
4274,5009096,F,N,Y,1,270000.0,Commercial associate,Secondary / secondary special,Married,House / apartment,-13679,-4391,1,0,0,1,Accountants,3.0,-6,C
4275,5009096,F,N,Y,1,270000.0,Commercial associate,Secondary / secondary special,Married,House / apartment,-13679,-4391,1,0,0,1,Accountants,3.0,-7,C
4276,5009096,F,N,Y,1,270000.0,Commercial associate,Secondary / secondary special,Married,House / apartment,-13679,-4391,1,0,0,1,Accountants,3.0,-8,C
4277,5009096,F,N,Y,1,270000.0,Commercial associate,Secondary / secondary special,Married,House / apartment,-13679,-4391,1,0,0,1,Accountants,3.0,-9,C
4278,5009096,F,N,Y,1,270000.0,Commercial associate,Secondary / secondary special,Married,House / apartment,-13679,-4391,1,0,0,1,Accountants,3.0,-10,C
4279,5009096,F,N,Y,1,270000.0,Commercial associate,Secondary / secondary special,Married,House / apartment,-13679,-4391,1,0,0,1,Accountants,3.0,-11,C
4280,5009096,F,N,Y,1,270000.0,Commercial associate,Secondary / secondary special,Married,House / apartment,-13679,-4391,1,0,0,1,Accountants,3.0,-12,C
4281,5009096,F,N,Y,1,270000.0,Commercial associate,Secondary / secondary special,Married,House / apartment,-13679,-4391,1,0,0,1,Accountants,3.0,-13,C
4282,5009096,F,N,Y,1,270000.0,Commercial associate,Secondary / secondary special,Married,House / apartment,-13679,-4391,1,0,0,1,Accountants,3.0,-14,C
4283,5009096,F,N,Y,1,270000.0,Commercial associate,Secondary / secondary special,Married,House / apartment,-13679,-4391,1,0,0,1,Accountants,3.0,-15,C
4284,5009096,F,N,Y,1,270000.0,Commercial associate,Secondary / secondary special,Married,House / apartment,-13679,-4391,1,0,0,1,Accountants,3.0,-16,C
4285,5009096,F,N,Y,1,270000.0,Commercial associate,Secondary / secondary special,Married,House / apartment,-13679,-4391,1,0,0,1,Accountants,3.0,-17,C
4286,5009096,F,N,Y,1,270000.0,Commercial associate,Secondary / secondary special,Married,House / apartment,-13679,-4391,1,0,0,1,Accountants,3.0,-18,C
4287,5009096,F,N,Y,1,270000.0,Commercial associate,Secondary / secondary special,Married,House / apartment,-13679,-4391,1,0,0,1,Accountants,3.0,-19,C
4288,5009096,F,N,Y,1,270000.0,Commercial associate,Secondary / secondary special,Married,House / apartment,-13679,-4391,1,0,0,1,Accountants,3.0,-20,0
4289,5009096,F,N,Y,1,270000.0,Commercial associate,Secondary / secondary special,Married,House / apartment,-13679,-4391,1,0,0,1,Accountants,3.0,-21,0
4290,5009096,F,N,Y,1,270000.0,Commercial associate,Secondary / secondary special,Married,House / apartment,-13679,-4391,1,0,0,1,Accountants,3.0,-22,0
4291,5009096,F,N,Y,1,270000.0,Commercial associate,Secondary / secondary special,Married,House / apartment,-13679,-4391,1,0,0,1,Accountants,3.0,-23,0
4292,5009096,F,N,Y,1,270000.0,Commercial associate,Secondary / secondary special,Married,House / apartment,-13679,-4391,1,0,0,1,Accountants,3.0,-24,X
4293,5009097,F,N,Y,1,270000.0,Commercial associate,Secondary / secondary special,Married,House / apartment,-13679,-4391,1,0,0,1,Accountants,3.0,-19,X
4294,5009097,F,N,Y,1,270000.0,Commercial associate,Secondary / secondary special,Married,House / apartment,-13679,-4391,1,0,0,1,Accountants,3.0,-20,0
4295,5009097,F,N,Y,1,270000.0,Commercial associate,Secondary / secondary special,Married,House / apartment,-13679,-4391,1,0,0,1,Accountants,3.0,-21,0
4296,5009097,F,N,Y,1,270000.0,Commercial associate,Secondary / secondary special,Married,House / apartment,-13679,-4391,1,0,0,1,Accountants,3.0,-22,0
4297,5009097,F,N,Y,1,270000.0,Commercial associate,Secondary / secondary special,Married,House / apartment,-13679,-4391,1,0,0,1,Accountants,3.0,-23,0
4298,5009097,F,N,Y,1,270000.0,Commercial associate,Secondary / secondary special,Married,House / apartment,-13679,-4391,1,0,0,1,Accountants,3.0,-24,0
4299,5009097,F,N,Y,1,270000.0,Commercial associate,Secondary / secondary special,Married,House / apartment,-13679,-4391,1,0,0,1,Accountants,3.0,-25,0
4300,5009097,F,N,Y,1,270000.0,Commercial associate,Secondary / secondary special,Married,House / apartment,-13679,-4391,1,0,0,1,Accountants,3.0,-26,0
4301,5009097,F,N,Y,1,270000.0,Commercial associate,Secondary / secondary special,Married,House / apartment,-13679,-4391,1,0,0,1,Accountants,3.0,-27,0
4302,5009097,F,N,Y,1,270000.0,Commercial associate,Secondary / secondary special,Married,House / apartment,-13679,-4391,1,0,0,1,Accountants,3.0,-28,0
4303,5009097,F,N,Y,1,270000.0,Commercial associate,Secondary / secondary special,Married,House / apartment,-13679,-4391,1,0,0,1,Accountants,3.0,-29,0
4304,5009097,F,N,Y,1,270000.0,Commercial associate,Secondary / secondary special,Married,House / apartment,-13679,-4391,1,0,0,1,Accountants,3.0,-30,0
4305,5009097,F,N,Y,1,270000.0,Commercial associate,Secondary / secondary special,Married,House / apartment,-13679,-4391,1,0,0,1,Accountants,3.0,-31,0
4306,5009097,F,N,Y,1,270000.0,Commercial associate,Secondary / secondary special,Married,House / apartment,-13679,-4391,1,0,0,1,Accountants,3.0,-32,0
4307,5009097,F,N,Y,1,270000.0,Commercial associate,Secondary / secondary special,Married,House / apartment,-13679,-4391,1,0,0,1,Accountants,3.0,-33,0
4308,5009098,F,N,Y,1,270000.0,Commercial associate,Secondary / secondary special,Married,House / apartment,-13679,-4391,1,0,0,1,Accountants,3.0,0,C
4309,5009098,F,N,Y,1,270000.0,Commercial associate,Secondary / secondary special,Married,House / apartment,-13679,-4391,1,0,0,1,Accountants,3.0,-1,C
4310,5009098,F,N,Y,1,270000.0,Commercial associate,Secondary / secondary special,Married,House / apartment,-13679,-4391,1,0,0,1,Accountants,3.0,-2,C
4311,5009098,F,N,Y,1,270000.0,Commercial associate,Secondary / secondary special,Married,House / apartment,-13679,-4391,1,0,0,1,Accountants,3.0,-3,C
4312,5009098,F,N,Y,1,270000.0,Commercial associate,Secondary / secondary special,Married,House / apartment,-13679,-4391,1,0,0,1,Accountants,3.0,-4,C
4313,5009098,F,N,Y,1,270000.0,Commercial associate,Secondary / secondary special,Married,House / apartment,-13679,-4391,1,0,0,1,Accountants,3.0,-5,C
4314,5009098,F,N,Y,1,270000.0,Commercial associate,Secondary / secondary special,Married,House / apartment,-13679,-4391,1,0,0,1,Accountants,3.0,-6,C
4315,5009098,F,N,Y,1,270000.0,Commercial associate,Secondary / secondary special,Married,House / apartment,-13679,-4391,1,0,0,1,Accountants,3.0,-7,C
4316,5009098,F,N,Y,1,270000.0,Commercial associate,Secondary / secondary special,Married,House / apartment,-13679,-4391,1,0,0,1,Accountants,3.0,-8,C
4317,5009098,F,N,Y,1,270000.0,Commercial associate,Secondary / secondary special,Married,House / apartment,-13679,-4391,1,0,0,1,Accountants,3.0,-9,C
4318,5009098,F,N,Y,1,270000.0,Commercial associate,Secondary / secondary special,Married,House / apartment,-13679,-4391,1,0,0,1,Accountants,3.0,-10,C
4319,5009098,F,N,Y,1,270000.0,Commercial associate,Secondary / secondary special,Married,House / apartment,-13679,-4391,1,0,0,1,Accountants,3.0,-11,C
4320,5009098,F,N,Y,1,270000.0,Commercial associate,Secondary / secondary special,Married,House / apartment,-13679,-4391,1,0,0,1,Accountants,3.0,-12,C
4321,5009098,F,N,Y,1,270000.0,Commercial associate,Secondary / secondary special,Married,House / apartment,-13679,-4391,1,0,0,1,Accountants,3.0,-13,0
4322,5009098,F,N,Y,1,270000.0,Commercial associate,Secondary / secondary special,Married,House / apartment,-13679,-4391,1,0,0,1,Accountants,3.0,-14,0
4323,5009098,F,N,Y,1,270000.0,Commercial associate,Secondary / secondary special,Married,House / apartment,-13679,-4391,1,0,0,1,Accountants,3.0,-15,0
4324,5009098,F,N,Y,1,270000.0,Commercial associate,Secondary / secondary special,Married,House / apartment,-13679,-4391,1,0,0,1,Accountants,3.0,-16,0
4325,5009098,F,N,Y,1,270000.0,Commercial associate,Secondary / secondary special,Married,House / apartment,-13679,-4391,1,0,0,1,Accountants,3.0,-17,X
4326,5009099,F,N,Y,0,315000.0,Working,Higher education,Separated,House / apartment,-13271,-555,1,0,0,0,Managers,1.0,-28,X
4327,5009099,F,N,Y,0,315000.0,Working,Higher education,Separated,House / apartment,-13271,-555,1,0,0,0,Managers,1.0,-29,X
4328,5009099,F,N,Y,0,315000.0,Working,Higher education,Separated,House / apartment,-13271,-555,1,0,0,0,Managers,1.0,-30,X
4329,5009099,F,N,Y,0,315000.0,Working,Higher education,Separated,House / apartment,-13271,-555,1,0,0,0,Managers,1.0,-31,X
4330,5009099,F,N,Y,0,315000.0,Working,Higher education,Separated,House / apartment,-13271,-555,1,0,0,0,Managers,1.0,-32,X
4331,5009099,F,N,Y,0,315000.0,Working,Higher education,Separated,House / apartment,-13271,-555,1,0,0,0,Managers,1.0,-33,0
4332,5009099,F,N,Y,0,315000.0,Working,Higher education,Separated,House / apartment,-13271,-555,1,0,0,0,Managers,1.0,-34,0
4333,5009099,F,N,Y,0,315000.0,Working,Higher education,Separated,House / apartment,-13271,-555,1,0,0,0,Managers,1.0,-35,X
4334,5009099,F,N,Y,0,315000.0,Working,Higher education,Separated,House / apartment,-13271,-555,1,0,0,0,Managers,1.0,-36,X
4335,5009099,F,N,Y,0,315000.0,Working,Higher education,Separated,House / apartment,-13271,-555,1,0,0,0,Managers,1.0,-37,X
4336,5009099,F,N,Y,0,315000.0,Working,Higher education,Separated,House / apartment,-13271,-555,1,0,0,0,Managers,1.0,-38,X
4337,5009099,F,N,Y,0,315000.0,Working,Higher education,Separated,House / apartment,-13271,-555,1,0,0,0,Managers,1.0,-39,0
4338,5009099,F,N,Y,0,315000.0,Working,Higher education,Separated,House / apartment,-13271,-555,1,0,0,0,Managers,1.0,-40,X
4339,5009099,F,N,Y,0,315000.0,Working,Higher education,Separated,House / apartment,-13271,-555,1,0,0,0,Managers,1.0,-41,0
4340,5009099,F,N,Y,0,315000.0,Working,Higher education,Separated,House / apartment,-13271,-555,1,0,0,0,Managers,1.0,-42,X
4341,5009099,F,N,Y,0,315000.0,Working,Higher education,Separated,House / apartment,-13271,-555,1,0,0,0,Managers,1.0,-43,0
4342,5009099,F,N,Y,0,315000.0,Working,Higher education,Separated,House / apartment,-13271,-555,1,0,0,0,Managers,1.0,-44,0
4343,5009099,F,N,Y,0,315000.0,Working,Higher education,Separated,House / apartment,-13271,-555,1,0,0,0,Managers,1.0,-45,X
4344,5009099,F,N,Y,0,315000.0,Working,Higher education,Separated,House / apartment,-13271,-555,1,0,0,0,Managers,1.0,-46,X
4345,5009099,F,N,Y,0,315000.0,Working,Higher education,Separated,House / apartment,-13271,-555,1,0,0,0,Managers,1.0,-47,0
4346,5009099,F,N,Y,0,315000.0,Working,Higher education,Separated,House / apartment,-13271,-555,1,0,0,0,Managers,1.0,-48,0
4347,5009099,F,N,Y,0,315000.0,Working,Higher education,Separated,House / apartment,-13271,-555,1,0,0,0,Managers,1.0,-49,0
4348,5009099,F,N,Y,0,315000.0,Working,Higher education,Separated,House / apartment,-13271,-555,1,0,0,0,Managers,1.0,-50,X
4349,5009099,F,N,Y,0,315000.0,Working,Higher education,Separated,House / apartment,-13271,-555,1,0,0,0,Managers,1.0,-51,0
4350,5009099,F,N,Y,0,315000.0,Working,Higher education,Separated,House / apartment,-13271,-555,1,0,0,0,Managers,1.0,-52,X
4351,5009099,F,N,Y,0,315000.0,Working,Higher education,Separated,House / apartment,-13271,-555,1,0,0,0,Managers,1.0,-53,X
4352,5009099,F,N,Y,0,315000.0,Working,Higher education,Separated,House / apartment,-13271,-555,1,0,0,0,Managers,1.0,-54,X
4353,5009099,F,N,Y,0,315000.0,Working,Higher education,Separated,House / apartment,-13271,-555,1,0,0,0,Managers,1.0,-55,X
4354,5009099,F,N,Y,0,315000.0,Working,Higher education,Separated,House / apartment,-13271,-555,1,0,0,0,Managers,1.0,-56,X
4355,5009100,F,N,Y,0,315000.0,Working,Higher education,Separated,House / apartment,-13271,-555,1,0,0,0,Managers,1.0,0,X
4356,5009100,F,N,Y,0,315000.0,Working,Higher education,Separated,House / apartment,-13271,-555,1,0,0,0,Managers,1.0,-1,X
4357,5009100,F,N,Y,0,315000.0,Working,Higher education,Separated,House / apartment,-13271,-555,1,0,0,0,Managers,1.0,-2,X
4358,5009100,F,N,Y,0,315000.0,Working,Higher education,Separated,House / apartment,-13271,-555,1,0,0,0,Managers,1.0,-3,X
4359,5009100,F,N,Y,0,315000.0,Working,Higher education,Separated,House / apartment,-13271,-555,1,0,0,0,Managers,1.0,-4,0
4360,5009100,F,N,Y,0,315000.0,Working,Higher education,Separated,House / apartment,-13271,-555,1,0,0,0,Managers,1.0,-5,0
4361,5009100,F,N,Y,0,315000.0,Working,Higher education,Separated,House / apartment,-13271,-555,1,0,0,0,Managers,1.0,-6,X
4362,5009100,F,N,Y,0,315000.0,Working,Higher education,Separated,House / apartment,-13271,-555,1,0,0,0,Managers,1.0,-7,X
4363,5009100,F,N,Y,0,315000.0,Working,Higher education,Separated,House / apartment,-13271,-555,1,0,0,0,Managers,1.0,-8,X
4364,5009100,F,N,Y,0,315000.0,Working,Higher education,Separated,House / apartment,-13271,-555,1,0,0,0,Managers,1.0,-9,X
4365,5009100,F,N,Y,0,315000.0,Working,Higher education,Separated,House / apartment,-13271,-555,1,0,0,0,Managers,1.0,-10,0
4366,5009100,F,N,Y,0,315000.0,Working,Higher education,Separated,House / apartment,-13271,-555,1,0,0,0,Managers,1.0,-11,X
4367,5009100,F,N,Y,0,315000.0,Working,Higher education,Separated,House / apartment,-13271,-555,1,0,0,0,Managers,1.0,-12,0
4368,5009100,F,N,Y,0,315000.0,Working,Higher education,Separated,House / apartment,-13271,-555,1,0,0,0,Managers,1.0,-13,X
4369,5009100,F,N,Y,0,315000.0,Working,Higher education,Separated,House / apartment,-13271,-555,1,0,0,0,Managers,1.0,-14,0
4370,5009100,F,N,Y,0,315000.0,Working,Higher education,Separated,House / apartment,-13271,-555,1,0,0,0,Managers,1.0,-15,0
4371,5009100,F,N,Y,0,315000.0,Working,Higher education,Separated,House / apartment,-13271,-555,1,0,0,0,Managers,1.0,-16,X
4372,5009100,F,N,Y,0,315000.0,Working,Higher education,Separated,House / apartment,-13271,-555,1,0,0,0,Managers,1.0,-17,X
4373,5009100,F,N,Y,0,315000.0,Working,Higher education,Separated,House / apartment,-13271,-555,1,0,0,0,Managers,1.0,-18,0
4374,5009100,F,N,Y,0,315000.0,Working,Higher education,Separated,House / apartment,-13271,-555,1,0,0,0,Managers,1.0,-19,0
4375,5009100,F,N,Y,0,315000.0,Working,Higher education,Separated,House / apartment,-13271,-555,1,0,0,0,Managers,1.0,-20,0
4376,5009100,F,N,Y,0,315000.0,Working,Higher education,Separated,House / apartment,-13271,-555,1,0,0,0,Managers,1.0,-21,X
4377,5009100,F,N,Y,0,315000.0,Working,Higher education,Separated,House / apartment,-13271,-555,1,0,0,0,Managers,1.0,-22,0
4378,5009100,F,N,Y,0,315000.0,Working,Higher education,Separated,House / apartment,-13271,-555,1,0,0,0,Managers,1.0,-23,X
4379,5009100,F,N,Y,0,315000.0,Working,Higher education,Separated,House / apartment,-13271,-555,1,0,0,0,Managers,1.0,-24,X
4380,5009100,F,N,Y,0,315000.0,Working,Higher education,Separated,House / apartment,-13271,-555,1,0,0,0,Managers,1.0,-25,X
4381,5009100,F,N,Y,0,315000.0,Working,Higher education,Separated,House / apartment,-13271,-555,1,0,0,0,Managers,1.0,-26,X
4382,5009100,F,N,Y,0,315000.0,Working,Higher education,Separated,House / apartment,-13271,-555,1,0,0,0,Managers,1.0,-27,X
4383,5009103,M,Y,Y,2,157500.0,Working,Secondary / secondary special,Married,With parents,-12859,-4056,1,0,1,0,Drivers,4.0,0,C
4384,5009103,M,Y,Y,2,157500.0,Working,Secondary / secondary special,Married,With parents,-12859,-4056,1,0,1,0,Drivers,4.0,-1,C
4385,5009103,M,Y,Y,2,157500.0,Working,Secondary / secondary special,Married,With parents,-12859,-4056,1,0,1,0,Drivers,4.0,-2,C
4386,5009103,M,Y,Y,2,157500.0,Working,Secondary / secondary special,Married,With parents,-12859,-4056,1,0,1,0,Drivers,4.0,-3,C
4387,5009103,M,Y,Y,2,157500.0,Working,Secondary / secondary special,Married,With parents,-12859,-4056,1,0,1,0,Drivers,4.0,-4,C
4388,5009103,M,Y,Y,2,157500.0,Working,Secondary / secondary special,Married,With parents,-12859,-4056,1,0,1,0,Drivers,4.0,-5,C
4389,5009103,M,Y,Y,2,157500.0,Working,Secondary / secondary special,Married,With parents,-12859,-4056,1,0,1,0,Drivers,4.0,-6,C
4390,5009103,M,Y,Y,2,157500.0,Working,Secondary / secondary special,Married,With parents,-12859,-4056,1,0,1,0,Drivers,4.0,-7,C
4391,5009103,M,Y,Y,2,157500.0,Working,Secondary / secondary special,Married,With parents,-12859,-4056,1,0,1,0,Drivers,4.0,-8,C
4392,5009103,M,Y,Y,2,157500.0,Working,Secondary / secondary special,Married,With parents,-12859,-4056,1,0,1,0,Drivers,4.0,-9,C
4393,5009103,M,Y,Y,2,157500.0,Working,Secondary / secondary special,Married,With parents,-12859,-4056,1,0,1,0,Drivers,4.0,-10,C
4394,5009103,M,Y,Y,2,157500.0,Working,Secondary / secondary special,Married,With parents,-12859,-4056,1,0,1,0,Drivers,4.0,-11,C
4395,5009103,M,Y,Y,2,157500.0,Working,Secondary / secondary special,Married,With parents,-12859,-4056,1,0,1,0,Drivers,4.0,-12,C
4396,5009103,M,Y,Y,2,157500.0,Working,Secondary / secondary special,Married,With parents,-12859,-4056,1,0,1,0,Drivers,4.0,-13,C
4397,5009103,M,Y,Y,2,157500.0,Working,Secondary / secondary special,Married,With parents,-12859,-4056,1,0,1,0,Drivers,4.0,-14,C
4398,5009103,M,Y,Y,2,157500.0,Working,Secondary / secondary special,Married,With parents,-12859,-4056,1,0,1,0,Drivers,4.0,-15,C
4399,5009103,M,Y,Y,2,157500.0,Working,Secondary / secondary special,Married,With parents,-12859,-4056,1,0,1,0,Drivers,4.0,-16,C
4400,5009103,M,Y,Y,2,157500.0,Working,Secondary / secondary special,Married,With parents,-12859,-4056,1,0,1,0,Drivers,4.0,-17,C
4401,5009103,M,Y,Y,2,157500.0,Working,Secondary / secondary special,Married,With parents,-12859,-4056,1,0,1,0,Drivers,4.0,-18,C
4402,5009103,M,Y,Y,2,157500.0,Working,Secondary / secondary special,Married,With parents,-12859,-4056,1,0,1,0,Drivers,4.0,-19,C
4403,5009103,M,Y,Y,2,157500.0,Working,Secondary / secondary special,Married,With parents,-12859,-4056,1,0,1,0,Drivers,4.0,-20,C
4404,5009103,M,Y,Y,2,157500.0,Working,Secondary / secondary special,Married,With parents,-12859,-4056,1,0,1,0,Drivers,4.0,-21,C
4405,5009103,M,Y,Y,2,157500.0,Working,Secondary / secondary special,Married,With parents,-12859,-4056,1,0,1,0,Drivers,4.0,-22,C
4406,5009103,M,Y,Y,2,157500.0,Working,Secondary / secondary special,Married,With parents,-12859,-4056,1,0,1,0,Drivers,4.0,-23,C
4407,5009103,M,Y,Y,2,157500.0,Working,Secondary / secondary special,Married,With parents,-12859,-4056,1,0,1,0,Drivers,4.0,-24,C
4408,5009103,M,Y,Y,2,157500.0,Working,Secondary / secondary special,Married,With parents,-12859,-4056,1,0,1,0,Drivers,4.0,-25,C
4409,5009103,M,Y,Y,2,157500.0,Working,Secondary / secondary special,Married,With parents,-12859,-4056,1,0,1,0,Drivers,4.0,-26,C
4410,5009103,M,Y,Y,2,157500.0,Working,Secondary / secondary special,Married,With parents,-12859,-4056,1,0,1,0,Drivers,4.0,-27,C
4411,5009103,M,Y,Y,2,157500.0,Working,Secondary / secondary special,Married,With parents,-12859,-4056,1,0,1,0,Drivers,4.0,-28,C
4412,5009103,M,Y,Y,2,157500.0,Working,Secondary / secondary special,Married,With parents,-12859,-4056,1,0,1,0,Drivers,4.0,-29,C
4413,5009103,M,Y,Y,2,157500.0,Working,Secondary / secondary special,Married,With parents,-12859,-4056,1,0,1,0,Drivers,4.0,-30,0
4414,5009103,M,Y,Y,2,157500.0,Working,Secondary / secondary special,Married,With parents,-12859,-4056,1,0,1,0,Drivers,4.0,-31,0
4415,5009103,M,Y,Y,2,157500.0,Working,Secondary / secondary special,Married,With parents,-12859,-4056,1,0,1,0,Drivers,4.0,-32,X
4416,5009103,M,Y,Y,2,157500.0,Working,Secondary / secondary special,Married,With parents,-12859,-4056,1,0,1,0,Drivers,4.0,-33,0
4417,5009103,M,Y,Y,2,157500.0,Working,Secondary / secondary special,Married,With parents,-12859,-4056,1,0,1,0,Drivers,4.0,-34,0
4418,5009103,M,Y,Y,2,157500.0,Working,Secondary / secondary special,Married,With parents,-12859,-4056,1,0,1,0,Drivers,4.0,-35,0
4419,5009103,M,Y,Y,2,157500.0,Working,Secondary / secondary special,Married,With parents,-12859,-4056,1,0,1,0,Drivers,4.0,-36,0
4420,5009103,M,Y,Y,2,157500.0,Working,Secondary / secondary special,Married,With parents,-12859,-4056,1,0,1,0,Drivers,4.0,-37,0
4421,5009103,M,Y,Y,2,157500.0,Working,Secondary / secondary special,Married,With parents,-12859,-4056,1,0,1,0,Drivers,4.0,-38,X
4422,5009104,M,Y,Y,2,157500.0,Working,Secondary / secondary special,Married,With parents,-12859,-4056,1,0,1,0,Drivers,4.0,0,X
4423,5009104,M,Y,Y,2,157500.0,Working,Secondary / secondary special,Married,With parents,-12859,-4056,1,0,1,0,Drivers,4.0,-1,X
4424,5009104,M,Y,Y,2,157500.0,Working,Secondary / secondary special,Married,With parents,-12859,-4056,1,0,1,0,Drivers,4.0,-2,X
4425,5009104,M,Y,Y,2,157500.0,Working,Secondary / secondary special,Married,With parents,-12859,-4056,1,0,1,0,Drivers,4.0,-3,X
4426,5009104,M,Y,Y,2,157500.0,Working,Secondary / secondary special,Married,With parents,-12859,-4056,1,0,1,0,Drivers,4.0,-4,X
4427,5009104,M,Y,Y,2,157500.0,Working,Secondary / secondary special,Married,With parents,-12859,-4056,1,0,1,0,Drivers,4.0,-5,X
4428,5009104,M,Y,Y,2,157500.0,Working,Secondary / secondary special,Married,With parents,-12859,-4056,1,0,1,0,Drivers,4.0,-6,X
4429,5009104,M,Y,Y,2,157500.0,Working,Secondary / secondary special,Married,With parents,-12859,-4056,1,0,1,0,Drivers,4.0,-7,X
4430,5009104,M,Y,Y,2,157500.0,Working,Secondary / secondary special,Married,With parents,-12859,-4056,1,0,1,0,Drivers,4.0,-8,X
4431,5009104,M,Y,Y,2,157500.0,Working,Secondary / secondary special,Married,With parents,-12859,-4056,1,0,1,0,Drivers,4.0,-9,X
4432,5009104,M,Y,Y,2,157500.0,Working,Secondary / secondary special,Married,With parents,-12859,-4056,1,0,1,0,Drivers,4.0,-10,X
4433,5009104,M,Y,Y,2,157500.0,Working,Secondary / secondary special,Married,With parents,-12859,-4056,1,0,1,0,Drivers,4.0,-11,X
4434,5009104,M,Y,Y,2,157500.0,Working,Secondary / secondary special,Married,With parents,-12859,-4056,1,0,1,0,Drivers,4.0,-12,X
4435,5009104,M,Y,Y,2,157500.0,Working,Secondary / secondary special,Married,With parents,-12859,-4056,1,0,1,0,Drivers,4.0,-13,X
4436,5009104,M,Y,Y,2,157500.0,Working,Secondary / secondary special,Married,With parents,-12859,-4056,1,0,1,0,Drivers,4.0,-14,X
4437,5009104,M,Y,Y,2,157500.0,Working,Secondary / secondary special,Married,With parents,-12859,-4056,1,0,1,0,Drivers,4.0,-15,X
4438,5009104,M,Y,Y,2,157500.0,Working,Secondary / secondary special,Married,With parents,-12859,-4056,1,0,1,0,Drivers,4.0,-16,X
4439,5009104,M,Y,Y,2,157500.0,Working,Secondary / secondary special,Married,With parents,-12859,-4056,1,0,1,0,Drivers,4.0,-17,X
4440,5009104,M,Y,Y,2,157500.0,Working,Secondary / secondary special,Married,With parents,-12859,-4056,1,0,1,0,Drivers,4.0,-18,X
4441,5009104,M,Y,Y,2,157500.0,Working,Secondary / secondary special,Married,With parents,-12859,-4056,1,0,1,0,Drivers,4.0,-19,X
4442,5009104,M,Y,Y,2,157500.0,Working,Secondary / secondary special,Married,With parents,-12859,-4056,1,0,1,0,Drivers,4.0,-20,X
4443,5009104,M,Y,Y,2,157500.0,Working,Secondary / secondary special,Married,With parents,-12859,-4056,1,0,1,0,Drivers,4.0,-21,X
4444,5009104,M,Y,Y,2,157500.0,Working,Secondary / secondary special,Married,With parents,-12859,-4056,1,0,1,0,Drivers,4.0,-22,X
4445,5009104,M,Y,Y,2,157500.0,Working,Secondary / secondary special,Married,With parents,-12859,-4056,1,0,1,0,Drivers,4.0,-23,X
4446,5009104,M,Y,Y,2,157500.0,Working,Secondary / secondary special,Married,With parents,-12859,-4056,1,0,1,0,Drivers,4.0,-24,X
4447,5009104,M,Y,Y,2,157500.0,Working,Secondary / secondary special,Married,With parents,-12859,-4056,1,0,1,0,Drivers,4.0,-25,X
4448,5009104,M,Y,Y,2,157500.0,Working,Secondary / secondary special,Married,With parents,-12859,-4056,1,0,1,0,Drivers,4.0,-26,X
4449,5009104,M,Y,Y,2,157500.0,Working,Secondary / secondary special,Married,With parents,-12859,-4056,1,0,1,0,Drivers,4.0,-27,X
4450,5009105,M,Y,Y,2,157500.0,Working,Secondary / secondary special,Married,With parents,-12859,-4056,1,0,1,0,Drivers,4.0,0,X
4451,5009105,M,Y,Y,2,157500.0,Working,Secondary / secondary special,Married,With parents,-12859,-4056,1,0,1,0,Drivers,4.0,-1,X
4452,5009105,M,Y,Y,2,157500.0,Working,Secondary / secondary special,Married,With parents,-12859,-4056,1,0,1,0,Drivers,4.0,-2,X
4453,5009105,M,Y,Y,2,157500.0,Working,Secondary / secondary special,Married,With parents,-12859,-4056,1,0,1,0,Drivers,4.0,-3,X
4454,5009105,M,Y,Y,2,157500.0,Working,Secondary / secondary special,Married,With parents,-12859,-4056,1,0,1,0,Drivers,4.0,-4,X
4455,5009105,M,Y,Y,2,157500.0,Working,Secondary / secondary special,Married,With parents,-12859,-4056,1,0,1,0,Drivers,4.0,-5,X
4456,5009105,M,Y,Y,2,157500.0,Working,Secondary / secondary special,Married,With parents,-12859,-4056,1,0,1,0,Drivers,4.0,-6,X
4457,5009105,M,Y,Y,2,157500.0,Working,Secondary / secondary special,Married,With parents,-12859,-4056,1,0,1,0,Drivers,4.0,-7,X
4458,5009105,M,Y,Y,2,157500.0,Working,Secondary / secondary special,Married,With parents,-12859,-4056,1,0,1,0,Drivers,4.0,-8,X
4459,5009105,M,Y,Y,2,157500.0,Working,Secondary / secondary special,Married,With parents,-12859,-4056,1,0,1,0,Drivers,4.0,-9,X
4460,5009105,M,Y,Y,2,157500.0,Working,Secondary / secondary special,Married,With parents,-12859,-4056,1,0,1,0,Drivers,4.0,-10,X
4461,5009105,M,Y,Y,2,157500.0,Working,Secondary / secondary special,Married,With parents,-12859,-4056,1,0,1,0,Drivers,4.0,-11,X
4462,5009105,M,Y,Y,2,157500.0,Working,Secondary / secondary special,Married,With parents,-12859,-4056,1,0,1,0,Drivers,4.0,-12,X
4463,5009105,M,Y,Y,2,157500.0,Working,Secondary / secondary special,Married,With parents,-12859,-4056,1,0,1,0,Drivers,4.0,-13,X
4464,5009105,M,Y,Y,2,157500.0,Working,Secondary / secondary special,Married,With parents,-12859,-4056,1,0,1,0,Drivers,4.0,-14,X
4465,5009105,M,Y,Y,2,157500.0,Working,Secondary / secondary special,Married,With parents,-12859,-4056,1,0,1,0,Drivers,4.0,-15,X
4466,5009105,M,Y,Y,2,157500.0,Working,Secondary / secondary special,Married,With parents,-12859,-4056,1,0,1,0,Drivers,4.0,-16,X
4467,5009105,M,Y,Y,2,157500.0,Working,Secondary / secondary special,Married,With parents,-12859,-4056,1,0,1,0,Drivers,4.0,-17,X
4468,5009105,M,Y,Y,2,157500.0,Working,Secondary / secondary special,Married,With parents,-12859,-4056,1,0,1,0,Drivers,4.0,-18,X
4469,5009105,M,Y,Y,2,157500.0,Working,Secondary / secondary special,Married,With parents,-12859,-4056,1,0,1,0,Drivers,4.0,-19,X
4470,5009105,M,Y,Y,2,157500.0,Working,Secondary / secondary special,Married,With parents,-12859,-4056,1,0,1,0,Drivers,4.0,-20,X
4471,5009105,M,Y,Y,2,157500.0,Working,Secondary / secondary special,Married,With parents,-12859,-4056,1,0,1,0,Drivers,4.0,-21,X
4472,5009105,M,Y,Y,2,157500.0,Working,Secondary / secondary special,Married,With parents,-12859,-4056,1,0,1,0,Drivers,4.0,-22,X
4473,5009105,M,Y,Y,2,157500.0,Working,Secondary / secondary special,Married,With parents,-12859,-4056,1,0,1,0,Drivers,4.0,-23,X
4474,5009105,M,Y,Y,2,157500.0,Working,Secondary / secondary special,Married,With parents,-12859,-4056,1,0,1,0,Drivers,4.0,-24,X
4475,5009105,M,Y,Y,2,157500.0,Working,Secondary / secondary special,Married,With parents,-12859,-4056,1,0,1,0,Drivers,4.0,-25,X
4476,5009105,M,Y,Y,2,157500.0,Working,Secondary / secondary special,Married,With parents,-12859,-4056,1,0,1,0,Drivers,4.0,-26,X
4477,5009105,M,Y,Y,2,157500.0,Working,Secondary / secondary special,Married,With parents,-12859,-4056,1,0,1,0,Drivers,4.0,-27,X
4478,5009105,M,Y,Y,2,157500.0,Working,Secondary / secondary special,Married,With parents,-12859,-4056,1,0,1,0,Drivers,4.0,-28,X
4479,5009105,M,Y,Y,2,157500.0,Working,Secondary / secondary special,Married,With parents,-12859,-4056,1,0,1,0,Drivers,4.0,-29,X
4480,5009105,M,Y,Y,2,157500.0,Working,Secondary / secondary special,Married,With parents,-12859,-4056,1,0,1,0,Drivers,4.0,-30,X
4481,5009106,M,Y,Y,2,157500.0,Working,Secondary / secondary special,Married,With parents,-12859,-4056,1,0,1,0,Drivers,4.0,0,X
4482,5009106,M,Y,Y,2,157500.0,Working,Secondary / secondary special,Married,With parents,-12859,-4056,1,0,1,0,Drivers,4.0,-1,X
4483,5009106,M,Y,Y,2,157500.0,Working,Secondary / secondary special,Married,With parents,-12859,-4056,1,0,1,0,Drivers,4.0,-2,X
4484,5009106,M,Y,Y,2,157500.0,Working,Secondary / secondary special,Married,With parents,-12859,-4056,1,0,1,0,Drivers,4.0,-3,X
4485,5009106,M,Y,Y,2,157500.0,Working,Secondary / secondary special,Married,With parents,-12859,-4056,1,0,1,0,Drivers,4.0,-4,X
4486,5009106,M,Y,Y,2,157500.0,Working,Secondary / secondary special,Married,With parents,-12859,-4056,1,0,1,0,Drivers,4.0,-5,X
4487,5009106,M,Y,Y,2,157500.0,Working,Secondary / secondary special,Married,With parents,-12859,-4056,1,0,1,0,Drivers,4.0,-6,X
4488,5009106,M,Y,Y,2,157500.0,Working,Secondary / secondary special,Married,With parents,-12859,-4056,1,0,1,0,Drivers,4.0,-7,X
4489,5009106,M,Y,Y,2,157500.0,Working,Secondary / secondary special,Married,With parents,-12859,-4056,1,0,1,0,Drivers,4.0,-8,X
4490,5009106,M,Y,Y,2,157500.0,Working,Secondary / secondary special,Married,With parents,-12859,-4056,1,0,1,0,Drivers,4.0,-9,X
4491,5009106,M,Y,Y,2,157500.0,Working,Secondary / secondary special,Married,With parents,-12859,-4056,1,0,1,0,Drivers,4.0,-10,X
4492,5009106,M,Y,Y,2,157500.0,Working,Secondary / secondary special,Married,With parents,-12859,-4056,1,0,1,0,Drivers,4.0,-11,X
4493,5009106,M,Y,Y,2,157500.0,Working,Secondary / secondary special,Married,With parents,-12859,-4056,1,0,1,0,Drivers,4.0,-12,X
4494,5009106,M,Y,Y,2,157500.0,Working,Secondary / secondary special,Married,With parents,-12859,-4056,1,0,1,0,Drivers,4.0,-13,X
4495,5009106,M,Y,Y,2,157500.0,Working,Secondary / secondary special,Married,With parents,-12859,-4056,1,0,1,0,Drivers,4.0,-14,X
4496,5009106,M,Y,Y,2,157500.0,Working,Secondary / secondary special,Married,With parents,-12859,-4056,1,0,1,0,Drivers,4.0,-15,X
4497,5009106,M,Y,Y,2,157500.0,Working,Secondary / secondary special,Married,With parents,-12859,-4056,1,0,1,0,Drivers,4.0,-16,X
4498,5009106,M,Y,Y,2,157500.0,Working,Secondary / secondary special,Married,With parents,-12859,-4056,1,0,1,0,Drivers,4.0,-17,X
4499,5009106,M,Y,Y,2,157500.0,Working,Secondary / secondary special,Married,With parents,-12859,-4056,1,0,1,0,Drivers,4.0,-18,X
4500,5009106,M,Y,Y,2,157500.0,Working,Secondary / secondary special,Married,With parents,-12859,-4056,1,0,1,0,Drivers,4.0,-19,X
4501,5009106,M,Y,Y,2,157500.0,Working,Secondary / secondary special,Married,With parents,-12859,-4056,1,0,1,0,Drivers,4.0,-20,X
4502,5009106,M,Y,Y,2,157500.0,Working,Secondary / secondary special,Married,With parents,-12859,-4056,1,0,1,0,Drivers,4.0,-21,X
4503,5009106,M,Y,Y,2,157500.0,Working,Secondary / secondary special,Married,With parents,-12859,-4056,1,0,1,0,Drivers,4.0,-22,X
4504,5009106,M,Y,Y,2,157500.0,Working,Secondary / secondary special,Married,With parents,-12859,-4056,1,0,1,0,Drivers,4.0,-23,X
4505,5009106,M,Y,Y,2,157500.0,Working,Secondary / secondary special,Married,With parents,-12859,-4056,1,0,1,0,Drivers,4.0,-24,X
4506,5009106,M,Y,Y,2,157500.0,Working,Secondary / secondary special,Married,With parents,-12859,-4056,1,0,1,0,Drivers,4.0,-25,X
4507,5009106,M,Y,Y,2,157500.0,Working,Secondary / secondary special,Married,With parents,-12859,-4056,1,0,1,0,Drivers,4.0,-26,X
4508,5009106,M,Y,Y,2,157500.0,Working,Secondary / secondary special,Married,With parents,-12859,-4056,1,0,1,0,Drivers,4.0,-27,X
4509,5009106,M,Y,Y,2,157500.0,Working,Secondary / secondary special,Married,With parents,-12859,-4056,1,0,1,0,Drivers,4.0,-28,X
4510,5009106,M,Y,Y,2,157500.0,Working,Secondary / secondary special,Married,With parents,-12859,-4056,1,0,1,0,Drivers,4.0,-29,X
4511,5009106,M,Y,Y,2,157500.0,Working,Secondary / secondary special,Married,With parents,-12859,-4056,1,0,1,0,Drivers,4.0,-30,X
4512,5009106,M,Y,Y,2,157500.0,Working,Secondary / secondary special,Married,With parents,-12859,-4056,1,0,1,0,Drivers,4.0,-31,X
4513,5009106,M,Y,Y,2,157500.0,Working,Secondary / secondary special,Married,With parents,-12859,-4056,1,0,1,0,Drivers,4.0,-32,X
4514,5009106,M,Y,Y,2,157500.0,Working,Secondary / secondary special,Married,With parents,-12859,-4056,1,0,1,0,Drivers,4.0,-33,X
4515,5009106,M,Y,Y,2,157500.0,Working,Secondary / secondary special,Married,With parents,-12859,-4056,1,0,1,0,Drivers,4.0,-34,X
4516,5009106,M,Y,Y,2,157500.0,Working,Secondary / secondary special,Married,With parents,-12859,-4056,1,0,1,0,Drivers,4.0,-35,X
4517,5009106,M,Y,Y,2,157500.0,Working,Secondary / secondary special,Married,With parents,-12859,-4056,1,0,1,0,Drivers,4.0,-36,X
4518,5009106,M,Y,Y,2,157500.0,Working,Secondary / secondary special,Married,With parents,-12859,-4056,1,0,1,0,Drivers,4.0,-37,X
4519,5009106,M,Y,Y,2,157500.0,Working,Secondary / secondary special,Married,With parents,-12859,-4056,1,0,1,0,Drivers,4.0,-38,X
4520,5009106,M,Y,Y,2,157500.0,Working,Secondary / secondary special,Married,With parents,-12859,-4056,1,0,1,0,Drivers,4.0,-39,X
4521,5009106,M,Y,Y,2,157500.0,Working,Secondary / secondary special,Married,With parents,-12859,-4056,1,0,1,0,Drivers,4.0,-40,X
4522,5009106,M,Y,Y,2,157500.0,Working,Secondary / secondary special,Married,With parents,-12859,-4056,1,0,1,0,Drivers,4.0,-41,X
4523,5009106,M,Y,Y,2,157500.0,Working,Secondary / secondary special,Married,With parents,-12859,-4056,1,0,1,0,Drivers,4.0,-42,X
4524,5009106,M,Y,Y,2,157500.0,Working,Secondary / secondary special,Married,With parents,-12859,-4056,1,0,1,0,Drivers,4.0,-43,X
4525,5009106,M,Y,Y,2,157500.0,Working,Secondary / secondary special,Married,With parents,-12859,-4056,1,0,1,0,Drivers,4.0,-44,X
4526,5009106,M,Y,Y,2,157500.0,Working,Secondary / secondary special,Married,With parents,-12859,-4056,1,0,1,0,Drivers,4.0,-45,X
4527,5009106,M,Y,Y,2,157500.0,Working,Secondary / secondary special,Married,With parents,-12859,-4056,1,0,1,0,Drivers,4.0,-46,X
4528,5009106,M,Y,Y,2,157500.0,Working,Secondary / secondary special,Married,With parents,-12859,-4056,1,0,1,0,Drivers,4.0,-47,X
4529,5009106,M,Y,Y,2,157500.0,Working,Secondary / secondary special,Married,With parents,-12859,-4056,1,0,1,0,Drivers,4.0,-48,X
4530,5009106,M,Y,Y,2,157500.0,Working,Secondary / secondary special,Married,With parents,-12859,-4056,1,0,1,0,Drivers,4.0,-49,X
4531,5009106,M,Y,Y,2,157500.0,Working,Secondary / secondary special,Married,With parents,-12859,-4056,1,0,1,0,Drivers,4.0,-50,X
4532,5009106,M,Y,Y,2,157500.0,Working,Secondary / secondary special,Married,With parents,-12859,-4056,1,0,1,0,Drivers,4.0,-51,X
4533,5009106,M,Y,Y,2,157500.0,Working,Secondary / secondary special,Married,With parents,-12859,-4056,1,0,1,0,Drivers,4.0,-52,X
4534,5009106,M,Y,Y,2,157500.0,Working,Secondary / secondary special,Married,With parents,-12859,-4056,1,0,1,0,Drivers,4.0,-53,X
4535,5009106,M,Y,Y,2,157500.0,Working,Secondary / secondary special,Married,With parents,-12859,-4056,1,0,1,0,Drivers,4.0,-54,X
4536,5009106,M,Y,Y,2,157500.0,Working,Secondary / secondary special,Married,With parents,-12859,-4056,1,0,1,0,Drivers,4.0,-55,X
4537,5009106,M,Y,Y,2,157500.0,Working,Secondary / secondary special,Married,With parents,-12859,-4056,1,0,1,0,Drivers,4.0,-56,X
4538,5009106,M,Y,Y,2,157500.0,Working,Secondary / secondary special,Married,With parents,-12859,-4056,1,0,1,0,Drivers,4.0,-57,X
4539,5009106,M,Y,Y,2,157500.0,Working,Secondary / secondary special,Married,With parents,-12859,-4056,1,0,1,0,Drivers,4.0,-58,X
4540,5009106,M,Y,Y,2,157500.0,Working,Secondary / secondary special,Married,With parents,-12859,-4056,1,0,1,0,Drivers,4.0,-59,X
4541,5009106,M,Y,Y,2,157500.0,Working,Secondary / secondary special,Married,With parents,-12859,-4056,1,0,1,0,Drivers,4.0,-60,X
4542,5112876,M,Y,Y,2,157500.0,Working,Secondary / secondary special,Married,With parents,-12859,-4056,1,0,1,0,Drivers,4.0,0,C
4543,5112876,M,Y,Y,2,157500.0,Working,Secondary / secondary special,Married,With parents,-12859,-4056,1,0,1,0,Drivers,4.0,-1,C
4544,5112876,M,Y,Y,2,157500.0,Working,Secondary / secondary special,Married,With parents,-12859,-4056,1,0,1,0,Drivers,4.0,-2,C
4545,5112876,M,Y,Y,2,157500.0,Working,Secondary / secondary special,Married,With parents,-12859,-4056,1,0,1,0,Drivers,4.0,-3,C
4546,5112876,M,Y,Y,2,157500.0,Working,Secondary / secondary special,Married,With parents,-12859,-4056,1,0,1,0,Drivers,4.0,-4,C
4547,5112876,M,Y,Y,2,157500.0,Working,Secondary / secondary special,Married,With parents,-12859,-4056,1,0,1,0,Drivers,4.0,-5,C
4548,5112876,M,Y,Y,2,157500.0,Working,Secondary / secondary special,Married,With parents,-12859,-4056,1,0,1,0,Drivers,4.0,-6,C
4549,5112876,M,Y,Y,2,157500.0,Working,Secondary / secondary special,Married,With parents,-12859,-4056,1,0,1,0,Drivers,4.0,-7,C
4550,5112876,M,Y,Y,2,157500.0,Working,Secondary / secondary special,Married,With parents,-12859,-4056,1,0,1,0,Drivers,4.0,-8,C
4551,5112876,M,Y,Y,2,157500.0,Working,Secondary / secondary special,Married,With parents,-12859,-4056,1,0,1,0,Drivers,4.0,-9,C
4552,5112876,M,Y,Y,2,157500.0,Working,Secondary / secondary special,Married,With parents,-12859,-4056,1,0,1,0,Drivers,4.0,-10,C
4553,5112876,M,Y,Y,2,157500.0,Working,Secondary / secondary special,Married,With parents,-12859,-4056,1,0,1,0,Drivers,4.0,-11,C
4554,5112876,M,Y,Y,2,157500.0,Working,Secondary / secondary special,Married,With parents,-12859,-4056,1,0,1,0,Drivers,4.0,-12,C
4555,5112876,M,Y,Y,2,157500.0,Working,Secondary / secondary special,Married,With parents,-12859,-4056,1,0,1,0,Drivers,4.0,-13,C
4556,5112876,M,Y,Y,2,157500.0,Working,Secondary / secondary special,Married,With parents,-12859,-4056,1,0,1,0,Drivers,4.0,-14,C
4557,5112876,M,Y,Y,2,157500.0,Working,Secondary / secondary special,Married,With parents,-12859,-4056,1,0,1,0,Drivers,4.0,-15,C
4558,5112876,M,Y,Y,2,157500.0,Working,Secondary / secondary special,Married,With parents,-12859,-4056,1,0,1,0,Drivers,4.0,-16,C
4559,5112876,M,Y,Y,2,157500.0,Working,Secondary / secondary special,Married,With parents,-12859,-4056,1,0,1,0,Drivers,4.0,-17,0
4560,5112876,M,Y,Y,2,157500.0,Working,Secondary / secondary special,Married,With parents,-12859,-4056,1,0,1,0,Drivers,4.0,-18,0
4561,5112876,M,Y,Y,2,157500.0,Working,Secondary / secondary special,Married,With parents,-12859,-4056,1,0,1,0,Drivers,4.0,-19,X
4562,5112876,M,Y,Y,2,157500.0,Working,Secondary / secondary special,Married,With parents,-12859,-4056,1,0,1,0,Drivers,4.0,-20,0
4563,5112876,M,Y,Y,2,157500.0,Working,Secondary / secondary special,Married,With parents,-12859,-4056,1,0,1,0,Drivers,4.0,-21,0
4564,5112876,M,Y,Y,2,157500.0,Working,Secondary / secondary special,Married,With parents,-12859,-4056,1,0,1,0,Drivers,4.0,-22,0
4565,5112876,M,Y,Y,2,157500.0,Working,Secondary / secondary special,Married,With parents,-12859,-4056,1,0,1,0,Drivers,4.0,-23,0
4566,5112876,M,Y,Y,2,157500.0,Working,Secondary / secondary special,Married,With parents,-12859,-4056,1,0,1,0,Drivers,4.0,-24,0
4567,5112876,M,Y,Y,2,157500.0,Working,Secondary / secondary special,Married,With parents,-12859,-4056,1,0,1,0,Drivers,4.0,-25,X
4568,5009108,M,N,Y,0,360000.0,Commercial associate,Secondary / secondary special,Married,House / apartment,-15321,-2747,1,0,0,0,Security staff,2.0,0,0
4569,5009108,M,N,Y,0,360000.0,Commercial associate,Secondary / secondary special,Married,House / apartment,-15321,-2747,1,0,0,0,Security staff,2.0,-1,0
4570,5009108,M,N,Y,0,360000.0,Commercial associate,Secondary / secondary special,Married,House / apartment,-15321,-2747,1,0,0,0,Security staff,2.0,-2,0
4571,5009108,M,N,Y,0,360000.0,Commercial associate,Secondary / secondary special,Married,House / apartment,-15321,-2747,1,0,0,0,Security staff,2.0,-3,0
4572,5009108,M,N,Y,0,360000.0,Commercial associate,Secondary / secondary special,Married,House / apartment,-15321,-2747,1,0,0,0,Security staff,2.0,-4,0
4573,5009108,M,N,Y,0,360000.0,Commercial associate,Secondary / secondary special,Married,House / apartment,-15321,-2747,1,0,0,0,Security staff,2.0,-5,0
4574,5009108,M,N,Y,0,360000.0,Commercial associate,Secondary / secondary special,Married,House / apartment,-15321,-2747,1,0,0,0,Security staff,2.0,-6,0
4575,5009108,M,N,Y,0,360000.0,Commercial associate,Secondary / secondary special,Married,House / apartment,-15321,-2747,1,0,0,0,Security staff,2.0,-7,0
4576,5009109,M,N,Y,0,360000.0,Commercial associate,Secondary / secondary special,Married,House / apartment,-15321,-2747,1,0,0,0,Security staff,2.0,0,C
4577,5009109,M,N,Y,0,360000.0,Commercial associate,Secondary / secondary special,Married,House / apartment,-15321,-2747,1,0,0,0,Security staff,2.0,-1,C
4578,5009109,M,N,Y,0,360000.0,Commercial associate,Secondary / secondary special,Married,House / apartment,-15321,-2747,1,0,0,0,Security staff,2.0,-2,C
4579,5009109,M,N,Y,0,360000.0,Commercial associate,Secondary / secondary special,Married,House / apartment,-15321,-2747,1,0,0,0,Security staff,2.0,-3,C
4580,5009109,M,N,Y,0,360000.0,Commercial associate,Secondary / secondary special,Married,House / apartment,-15321,-2747,1,0,0,0,Security staff,2.0,-4,C
4581,5009109,M,N,Y,0,360000.0,Commercial associate,Secondary / secondary special,Married,House / apartment,-15321,-2747,1,0,0,0,Security staff,2.0,-5,C
4582,5009109,M,N,Y,0,360000.0,Commercial associate,Secondary / secondary special,Married,House / apartment,-15321,-2747,1,0,0,0,Security staff,2.0,-6,C
4583,5009109,M,N,Y,0,360000.0,Commercial associate,Secondary / secondary special,Married,House / apartment,-15321,-2747,1,0,0,0,Security staff,2.0,-7,C
4584,5009109,M,N,Y,0,360000.0,Commercial associate,Secondary / secondary special,Married,House / apartment,-15321,-2747,1,0,0,0,Security staff,2.0,-8,C
4585,5009109,M,N,Y,0,360000.0,Commercial associate,Secondary / secondary special,Married,House / apartment,-15321,-2747,1,0,0,0,Security staff,2.0,-9,C
4586,5009109,M,N,Y,0,360000.0,Commercial associate,Secondary / secondary special,Married,House / apartment,-15321,-2747,1,0,0,0,Security staff,2.0,-10,C
4587,5009109,M,N,Y,0,360000.0,Commercial associate,Secondary / secondary special,Married,House / apartment,-15321,-2747,1,0,0,0,Security staff,2.0,-11,0
4588,5009109,M,N,Y,0,360000.0,Commercial associate,Secondary / secondary special,Married,House / apartment,-15321,-2747,1,0,0,0,Security staff,2.0,-12,0
4589,5009109,M,N,Y,0,360000.0,Commercial associate,Secondary / secondary special,Married,House / apartment,-15321,-2747,1,0,0,0,Security staff,2.0,-13,0
4590,5009109,M,N,Y,0,360000.0,Commercial associate,Secondary / secondary special,Married,House / apartment,-15321,-2747,1,0,0,0,Security staff,2.0,-14,0
4591,5009109,M,N,Y,0,360000.0,Commercial associate,Secondary / secondary special,Married,House / apartment,-15321,-2747,1,0,0,0,Security staff,2.0,-15,0
4592,5009109,M,N,Y,0,360000.0,Commercial associate,Secondary / secondary special,Married,House / apartment,-15321,-2747,1,0,0,0,Security staff,2.0,-16,0
4593,5009109,M,N,Y,0,360000.0,Commercial associate,Secondary / secondary special,Married,House / apartment,-15321,-2747,1,0,0,0,Security staff,2.0,-17,0
4594,5009109,M,N,Y,0,360000.0,Commercial associate,Secondary / secondary special,Married,House / apartment,-15321,-2747,1,0,0,0,Security staff,2.0,-18,0
4595,5009109,M,N,Y,0,360000.0,Commercial associate,Secondary / secondary special,Married,House / apartment,-15321,-2747,1,0,0,0,Security staff,2.0,-19,0
4596,5009109,M,N,Y,0,360000.0,Commercial associate,Secondary / secondary special,Married,House / apartment,-15321,-2747,1,0,0,0,Security staff,2.0,-20,0
4597,5009110,F,N,Y,0,112500.0,Commercial associate,Higher education,Married,House / apartment,-8842,-312,1,0,0,1,High skill tech staff,2.0,0,0
4598,5009110,F,N,Y,0,112500.0,Commercial associate,Higher education,Married,House / apartment,-8842,-312,1,0,0,1,High skill tech staff,2.0,-1,0
4599,5009110,F,N,Y,0,112500.0,Commercial associate,Higher education,Married,House / apartment,-8842,-312,1,0,0,1,High skill tech staff,2.0,-2,1
4600,5009110,F,N,Y,0,112500.0,Commercial associate,Higher education,Married,House / apartment,-8842,-312,1,0,0,1,High skill tech staff,2.0,-3,0
4601,5009116,F,N,N,0,157500.0,Commercial associate,Higher education,Separated,With parents,-15737,-432,1,0,0,0,,1.0,-23,C
4602,5009116,F,N,N,0,157500.0,Commercial associate,Higher education,Separated,With parents,-15737,-432,1,0,0,0,,1.0,-24,C
4603,5009116,F,N,N,0,157500.0,Commercial associate,Higher education,Separated,With parents,-15737,-432,1,0,0,0,,1.0,-25,C
4604,5009116,F,N,N,0,157500.0,Commercial associate,Higher education,Separated,With parents,-15737,-432,1,0,0,0,,1.0,-26,C
4605,5009116,F,N,N,0,157500.0,Commercial associate,Higher education,Separated,With parents,-15737,-432,1,0,0,0,,1.0,-27,C
4606,5009116,F,N,N,0,157500.0,Commercial associate,Higher education,Separated,With parents,-15737,-432,1,0,0,0,,1.0,-28,C
4607,5009116,F,N,N,0,157500.0,Commercial associate,Higher education,Separated,With parents,-15737,-432,1,0,0,0,,1.0,-29,C
4608,5009116,F,N,N,0,157500.0,Commercial associate,Higher education,Separated,With parents,-15737,-432,1,0,0,0,,1.0,-30,C
4609,5009116,F,N,N,0,157500.0,Commercial associate,Higher education,Separated,With parents,-15737,-432,1,0,0,0,,1.0,-31,C
4610,5009116,F,N,N,0,157500.0,Commercial associate,Higher education,Separated,With parents,-15737,-432,1,0,0,0,,1.0,-32,0
4611,5009116,F,N,N,0,157500.0,Commercial associate,Higher education,Separated,With parents,-15737,-432,1,0,0,0,,1.0,-33,0
4612,5009116,F,N,N,0,157500.0,Commercial associate,Higher education,Separated,With parents,-15737,-432,1,0,0,0,,1.0,-34,0
4613,5009116,F,N,N,0,157500.0,Commercial associate,Higher education,Separated,With parents,-15737,-432,1,0,0,0,,1.0,-35,0
4614,5009117,F,N,N,0,157500.0,Commercial associate,Higher education,Separated,With parents,-15737,-432,1,0,0,0,,1.0,0,C
4615,5009117,F,N,N,0,157500.0,Commercial associate,Higher education,Separated,With parents,-15737,-432,1,0,0,0,,1.0,-1,C
4616,5009117,F,N,N,0,157500.0,Commercial associate,Higher education,Separated,With parents,-15737,-432,1,0,0,0,,1.0,-2,C
4617,5009117,F,N,N,0,157500.0,Commercial associate,Higher education,Separated,With parents,-15737,-432,1,0,0,0,,1.0,-3,C
4618,5009117,F,N,N,0,157500.0,Commercial associate,Higher education,Separated,With parents,-15737,-432,1,0,0,0,,1.0,-4,C
4619,5009117,F,N,N,0,157500.0,Commercial associate,Higher education,Separated,With parents,-15737,-432,1,0,0,0,,1.0,-5,C
4620,5009117,F,N,N,0,157500.0,Commercial associate,Higher education,Separated,With parents,-15737,-432,1,0,0,0,,1.0,-6,C
4621,5009117,F,N,N,0,157500.0,Commercial associate,Higher education,Separated,With parents,-15737,-432,1,0,0,0,,1.0,-7,C
4622,5009117,F,N,N,0,157500.0,Commercial associate,Higher education,Separated,With parents,-15737,-432,1,0,0,0,,1.0,-8,C
4623,5009117,F,N,N,0,157500.0,Commercial associate,Higher education,Separated,With parents,-15737,-432,1,0,0,0,,1.0,-9,C
4624,5009117,F,N,N,0,157500.0,Commercial associate,Higher education,Separated,With parents,-15737,-432,1,0,0,0,,1.0,-10,C
4625,5009117,F,N,N,0,157500.0,Commercial associate,Higher education,Separated,With parents,-15737,-432,1,0,0,0,,1.0,-11,C
4626,5009117,F,N,N,0,157500.0,Commercial associate,Higher education,Separated,With parents,-15737,-432,1,0,0,0,,1.0,-12,C
4627,5009117,F,N,N,0,157500.0,Commercial associate,Higher education,Separated,With parents,-15737,-432,1,0,0,0,,1.0,-13,C
4628,5009117,F,N,N,0,157500.0,Commercial associate,Higher education,Separated,With parents,-15737,-432,1,0,0,0,,1.0,-14,C
4629,5009117,F,N,N,0,157500.0,Commercial associate,Higher education,Separated,With parents,-15737,-432,1,0,0,0,,1.0,-15,C
4630,5009117,F,N,N,0,157500.0,Commercial associate,Higher education,Separated,With parents,-15737,-432,1,0,0,0,,1.0,-16,C
4631,5009117,F,N,N,0,157500.0,Commercial associate,Higher education,Separated,With parents,-15737,-432,1,0,0,0,,1.0,-17,C
4632,5009117,F,N,N,0,157500.0,Commercial associate,Higher education,Separated,With parents,-15737,-432,1,0,0,0,,1.0,-18,C
4633,5009117,F,N,N,0,157500.0,Commercial associate,Higher education,Separated,With parents,-15737,-432,1,0,0,0,,1.0,-19,C
4634,5009117,F,N,N,0,157500.0,Commercial associate,Higher education,Separated,With parents,-15737,-432,1,0,0,0,,1.0,-20,C
4635,5009117,F,N,N,0,157500.0,Commercial associate,Higher education,Separated,With parents,-15737,-432,1,0,0,0,,1.0,-21,C
4636,5009117,F,N,N,0,157500.0,Commercial associate,Higher education,Separated,With parents,-15737,-432,1,0,0,0,,1.0,-22,C
4637,5009117,F,N,N,0,157500.0,Commercial associate,Higher education,Separated,With parents,-15737,-432,1,0,0,0,,1.0,-23,C
4638,5009117,F,N,N,0,157500.0,Commercial associate,Higher education,Separated,With parents,-15737,-432,1,0,0,0,,1.0,-24,C
4639,5009117,F,N,N,0,157500.0,Commercial associate,Higher education,Separated,With parents,-15737,-432,1,0,0,0,,1.0,-25,C
4640,5009117,F,N,N,0,157500.0,Commercial associate,Higher education,Separated,With parents,-15737,-432,1,0,0,0,,1.0,-26,C
4641,5009117,F,N,N,0,157500.0,Commercial associate,Higher education,Separated,With parents,-15737,-432,1,0,0,0,,1.0,-27,C
4642,5009117,F,N,N,0,157500.0,Commercial associate,Higher education,Separated,With parents,-15737,-432,1,0,0,0,,1.0,-28,C
4643,5009117,F,N,N,0,157500.0,Commercial associate,Higher education,Separated,With parents,-15737,-432,1,0,0,0,,1.0,-29,C
4644,5009117,F,N,N,0,157500.0,Commercial associate,Higher education,Separated,With parents,-15737,-432,1,0,0,0,,1.0,-30,C
4645,5009117,F,N,N,0,157500.0,Commercial associate,Higher education,Separated,With parents,-15737,-432,1,0,0,0,,1.0,-31,C
4646,5009117,F,N,N,0,157500.0,Commercial associate,Higher education,Separated,With parents,-15737,-432,1,0,0,0,,1.0,-32,C
4647,5009117,F,N,N,0,157500.0,Commercial associate,Higher education,Separated,With parents,-15737,-432,1,0,0,0,,1.0,-33,C
4648,5009117,F,N,N,0,157500.0,Commercial associate,Higher education,Separated,With parents,-15737,-432,1,0,0,0,,1.0,-34,C
4649,5009117,F,N,N,0,157500.0,Commercial associate,Higher education,Separated,With parents,-15737,-432,1,0,0,0,,1.0,-35,C
4650,5009117,F,N,N,0,157500.0,Commercial associate,Higher education,Separated,With parents,-15737,-432,1,0,0,0,,1.0,-36,C
4651,5009117,F,N,N,0,157500.0,Commercial associate,Higher education,Separated,With parents,-15737,-432,1,0,0,0,,1.0,-37,C
4652,5009117,F,N,N,0,157500.0,Commercial associate,Higher education,Separated,With parents,-15737,-432,1,0,0,0,,1.0,-38,C
4653,5009117,F,N,N,0,157500.0,Commercial associate,Higher education,Separated,With parents,-15737,-432,1,0,0,0,,1.0,-39,C
4654,5009117,F,N,N,0,157500.0,Commercial associate,Higher education,Separated,With parents,-15737,-432,1,0,0,0,,1.0,-40,C
4655,5009117,F,N,N,0,157500.0,Commercial associate,Higher education,Separated,With parents,-15737,-432,1,0,0,0,,1.0,-41,C
4656,5009117,F,N,N,0,157500.0,Commercial associate,Higher education,Separated,With parents,-15737,-432,1,0,0,0,,1.0,-42,C
4657,5009117,F,N,N,0,157500.0,Commercial associate,Higher education,Separated,With parents,-15737,-432,1,0,0,0,,1.0,-43,C
4658,5009117,F,N,N,0,157500.0,Commercial associate,Higher education,Separated,With parents,-15737,-432,1,0,0,0,,1.0,-44,C
4659,5009117,F,N,N,0,157500.0,Commercial associate,Higher education,Separated,With parents,-15737,-432,1,0,0,0,,1.0,-45,0
4660,5009117,F,N,N,0,157500.0,Commercial associate,Higher education,Separated,With parents,-15737,-432,1,0,0,0,,1.0,-46,0
4661,5009117,F,N,N,0,157500.0,Commercial associate,Higher education,Separated,With parents,-15737,-432,1,0,0,0,,1.0,-47,0
4662,5009117,F,N,N,0,157500.0,Commercial associate,Higher education,Separated,With parents,-15737,-432,1,0,0,0,,1.0,-48,0
4663,5009117,F,N,N,0,157500.0,Commercial associate,Higher education,Separated,With parents,-15737,-432,1,0,0,0,,1.0,-49,X
4664,5009118,F,N,N,0,157500.0,Commercial associate,Higher education,Separated,With parents,-15737,-432,1,0,0,0,,1.0,-31,C
4665,5009118,F,N,N,0,157500.0,Commercial associate,Higher education,Separated,With parents,-15737,-432,1,0,0,0,,1.0,-32,C
4666,5009118,F,N,N,0,157500.0,Commercial associate,Higher education,Separated,With parents,-15737,-432,1,0,0,0,,1.0,-33,C
4667,5009118,F,N,N,0,157500.0,Commercial associate,Higher education,Separated,With parents,-15737,-432,1,0,0,0,,1.0,-34,C
4668,5009118,F,N,N,0,157500.0,Commercial associate,Higher education,Separated,With parents,-15737,-432,1,0,0,0,,1.0,-35,C
4669,5009118,F,N,N,0,157500.0,Commercial associate,Higher education,Separated,With parents,-15737,-432,1,0,0,0,,1.0,-36,C
4670,5009118,F,N,N,0,157500.0,Commercial associate,Higher education,Separated,With parents,-15737,-432,1,0,0,0,,1.0,-37,C
4671,5009118,F,N,N,0,157500.0,Commercial associate,Higher education,Separated,With parents,-15737,-432,1,0,0,0,,1.0,-38,C
4672,5009118,F,N,N,0,157500.0,Commercial associate,Higher education,Separated,With parents,-15737,-432,1,0,0,0,,1.0,-39,C
4673,5009118,F,N,N,0,157500.0,Commercial associate,Higher education,Separated,With parents,-15737,-432,1,0,0,0,,1.0,-40,0
4674,5009118,F,N,N,0,157500.0,Commercial associate,Higher education,Separated,With parents,-15737,-432,1,0,0,0,,1.0,-41,0
4675,5009118,F,N,N,0,157500.0,Commercial associate,Higher education,Separated,With parents,-15737,-432,1,0,0,0,,1.0,-42,0
4676,5009118,F,N,N,0,157500.0,Commercial associate,Higher education,Separated,With parents,-15737,-432,1,0,0,0,,1.0,-43,0
4677,5009120,F,N,N,0,157500.0,Commercial associate,Higher education,Separated,With parents,-15737,-432,1,0,0,0,,1.0,-44,C
4678,5009120,F,N,N,0,157500.0,Commercial associate,Higher education,Separated,With parents,-15737,-432,1,0,0,0,,1.0,-45,C
4679,5009120,F,N,N,0,157500.0,Commercial associate,Higher education,Separated,With parents,-15737,-432,1,0,0,0,,1.0,-46,C
4680,5009120,F,N,N,0,157500.0,Commercial associate,Higher education,Separated,With parents,-15737,-432,1,0,0,0,,1.0,-47,C
4681,5009120,F,N,N,0,157500.0,Commercial associate,Higher education,Separated,With parents,-15737,-432,1,0,0,0,,1.0,-48,C
4682,5009120,F,N,N,0,157500.0,Commercial associate,Higher education,Separated,With parents,-15737,-432,1,0,0,0,,1.0,-49,C
4683,5009120,F,N,N,0,157500.0,Commercial associate,Higher education,Separated,With parents,-15737,-432,1,0,0,0,,1.0,-50,C
4684,5009120,F,N,N,0,157500.0,Commercial associate,Higher education,Separated,With parents,-15737,-432,1,0,0,0,,1.0,-51,C
4685,5009120,F,N,N,0,157500.0,Commercial associate,Higher education,Separated,With parents,-15737,-432,1,0,0,0,,1.0,-52,C
4686,5009120,F,N,N,0,157500.0,Commercial associate,Higher education,Separated,With parents,-15737,-432,1,0,0,0,,1.0,-53,0
4687,5009120,F,N,N,0,157500.0,Commercial associate,Higher education,Separated,With parents,-15737,-432,1,0,0,0,,1.0,-54,0
4688,5009120,F,N,N,0,157500.0,Commercial associate,Higher education,Separated,With parents,-15737,-432,1,0,0,0,,1.0,-55,0
4689,5009120,F,N,N,0,157500.0,Commercial associate,Higher education,Separated,With parents,-15737,-432,1,0,0,0,,1.0,-56,0
4690,5009122,F,N,N,0,157500.0,Commercial associate,Higher education,Separated,With parents,-15737,-432,1,0,0,0,,1.0,-37,C
4691,5009122,F,N,N,0,157500.0,Commercial associate,Higher education,Separated,With parents,-15737,-432,1,0,0,0,,1.0,-38,C
4692,5009122,F,N,N,0,157500.0,Commercial associate,Higher education,Separated,With parents,-15737,-432,1,0,0,0,,1.0,-39,C
4693,5009122,F,N,N,0,157500.0,Commercial associate,Higher education,Separated,With parents,-15737,-432,1,0,0,0,,1.0,-40,C
4694,5009122,F,N,N,0,157500.0,Commercial associate,Higher education,Separated,With parents,-15737,-432,1,0,0,0,,1.0,-41,C
4695,5009122,F,N,N,0,157500.0,Commercial associate,Higher education,Separated,With parents,-15737,-432,1,0,0,0,,1.0,-42,C
4696,5009122,F,N,N,0,157500.0,Commercial associate,Higher education,Separated,With parents,-15737,-432,1,0,0,0,,1.0,-43,C
4697,5009122,F,N,N,0,157500.0,Commercial associate,Higher education,Separated,With parents,-15737,-432,1,0,0,0,,1.0,-44,C
4698,5009122,F,N,N,0,157500.0,Commercial associate,Higher education,Separated,With parents,-15737,-432,1,0,0,0,,1.0,-45,C
4699,5009122,F,N,N,0,157500.0,Commercial associate,Higher education,Separated,With parents,-15737,-432,1,0,0,0,,1.0,-46,0
4700,5009122,F,N,N,0,157500.0,Commercial associate,Higher education,Separated,With parents,-15737,-432,1,0,0,0,,1.0,-47,0
4701,5009122,F,N,N,0,157500.0,Commercial associate,Higher education,Separated,With parents,-15737,-432,1,0,0,0,,1.0,-48,0
4702,5009122,F,N,N,0,157500.0,Commercial associate,Higher education,Separated,With parents,-15737,-432,1,0,0,0,,1.0,-49,0
4703,5009123,F,N,N,0,157500.0,Commercial associate,Higher education,Separated,With parents,-15737,-432,1,0,0,0,,1.0,0,C
4704,5009123,F,N,N,0,157500.0,Commercial associate,Higher education,Separated,With parents,-15737,-432,1,0,0,0,,1.0,-1,C
4705,5009123,F,N,N,0,157500.0,Commercial associate,Higher education,Separated,With parents,-15737,-432,1,0,0,0,,1.0,-2,C
4706,5009123,F,N,N,0,157500.0,Commercial associate,Higher education,Separated,With parents,-15737,-432,1,0,0,0,,1.0,-3,C
4707,5009123,F,N,N,0,157500.0,Commercial associate,Higher education,Separated,With parents,-15737,-432,1,0,0,0,,1.0,-4,C
4708,5009123,F,N,N,0,157500.0,Commercial associate,Higher education,Separated,With parents,-15737,-432,1,0,0,0,,1.0,-5,C
4709,5009123,F,N,N,0,157500.0,Commercial associate,Higher education,Separated,With parents,-15737,-432,1,0,0,0,,1.0,-6,C
4710,5009123,F,N,N,0,157500.0,Commercial associate,Higher education,Separated,With parents,-15737,-432,1,0,0,0,,1.0,-7,C
4711,5009123,F,N,N,0,157500.0,Commercial associate,Higher education,Separated,With parents,-15737,-432,1,0,0,0,,1.0,-8,C
4712,5009123,F,N,N,0,157500.0,Commercial associate,Higher education,Separated,With parents,-15737,-432,1,0,0,0,,1.0,-9,C
4713,5009123,F,N,N,0,157500.0,Commercial associate,Higher education,Separated,With parents,-15737,-432,1,0,0,0,,1.0,-10,C
4714,5009123,F,N,N,0,157500.0,Commercial associate,Higher education,Separated,With parents,-15737,-432,1,0,0,0,,1.0,-11,C
4715,5009123,F,N,N,0,157500.0,Commercial associate,Higher education,Separated,With parents,-15737,-432,1,0,0,0,,1.0,-12,C
4716,5009123,F,N,N,0,157500.0,Commercial associate,Higher education,Separated,With parents,-15737,-432,1,0,0,0,,1.0,-13,C
4717,5009123,F,N,N,0,157500.0,Commercial associate,Higher education,Separated,With parents,-15737,-432,1,0,0,0,,1.0,-14,C
4718,5009123,F,N,N,0,157500.0,Commercial associate,Higher education,Separated,With parents,-15737,-432,1,0,0,0,,1.0,-15,C
4719,5009123,F,N,N,0,157500.0,Commercial associate,Higher education,Separated,With parents,-15737,-432,1,0,0,0,,1.0,-16,C
4720,5009123,F,N,N,0,157500.0,Commercial associate,Higher education,Separated,With parents,-15737,-432,1,0,0,0,,1.0,-17,C
4721,5009123,F,N,N,0,157500.0,Commercial associate,Higher education,Separated,With parents,-15737,-432,1,0,0,0,,1.0,-18,C
4722,5009123,F,N,N,0,157500.0,Commercial associate,Higher education,Separated,With parents,-15737,-432,1,0,0,0,,1.0,-19,C
4723,5009123,F,N,N,0,157500.0,Commercial associate,Higher education,Separated,With parents,-15737,-432,1,0,0,0,,1.0,-20,C
4724,5009123,F,N,N,0,157500.0,Commercial associate,Higher education,Separated,With parents,-15737,-432,1,0,0,0,,1.0,-21,C
4725,5009123,F,N,N,0,157500.0,Commercial associate,Higher education,Separated,With parents,-15737,-432,1,0,0,0,,1.0,-22,C
4726,5009123,F,N,N,0,157500.0,Commercial associate,Higher education,Separated,With parents,-15737,-432,1,0,0,0,,1.0,-23,C
4727,5009123,F,N,N,0,157500.0,Commercial associate,Higher education,Separated,With parents,-15737,-432,1,0,0,0,,1.0,-24,C
4728,5009123,F,N,N,0,157500.0,Commercial associate,Higher education,Separated,With parents,-15737,-432,1,0,0,0,,1.0,-25,C
4729,5009123,F,N,N,0,157500.0,Commercial associate,Higher education,Separated,With parents,-15737,-432,1,0,0,0,,1.0,-26,C
4730,5009123,F,N,N,0,157500.0,Commercial associate,Higher education,Separated,With parents,-15737,-432,1,0,0,0,,1.0,-27,C
4731,5009123,F,N,N,0,157500.0,Commercial associate,Higher education,Separated,With parents,-15737,-432,1,0,0,0,,1.0,-28,C
4732,5009123,F,N,N,0,157500.0,Commercial associate,Higher education,Separated,With parents,-15737,-432,1,0,0,0,,1.0,-29,C
4733,5009123,F,N,N,0,157500.0,Commercial associate,Higher education,Separated,With parents,-15737,-432,1,0,0,0,,1.0,-30,C
4734,5009123,F,N,N,0,157500.0,Commercial associate,Higher education,Separated,With parents,-15737,-432,1,0,0,0,,1.0,-31,C
4735,5009123,F,N,N,0,157500.0,Commercial associate,Higher education,Separated,With parents,-15737,-432,1,0,0,0,,1.0,-32,C
4736,5009123,F,N,N,0,157500.0,Commercial associate,Higher education,Separated,With parents,-15737,-432,1,0,0,0,,1.0,-33,C
4737,5009123,F,N,N,0,157500.0,Commercial associate,Higher education,Separated,With parents,-15737,-432,1,0,0,0,,1.0,-34,C
4738,5009123,F,N,N,0,157500.0,Commercial associate,Higher education,Separated,With parents,-15737,-432,1,0,0,0,,1.0,-35,C
4739,5009123,F,N,N,0,157500.0,Commercial associate,Higher education,Separated,With parents,-15737,-432,1,0,0,0,,1.0,-36,C
4740,5009123,F,N,N,0,157500.0,Commercial associate,Higher education,Separated,With parents,-15737,-432,1,0,0,0,,1.0,-37,C
4741,5009123,F,N,N,0,157500.0,Commercial associate,Higher education,Separated,With parents,-15737,-432,1,0,0,0,,1.0,-38,C
4742,5009123,F,N,N,0,157500.0,Commercial associate,Higher education,Separated,With parents,-15737,-432,1,0,0,0,,1.0,-39,0
4743,5009123,F,N,N,0,157500.0,Commercial associate,Higher education,Separated,With parents,-15737,-432,1,0,0,0,,1.0,-40,0
4744,5009123,F,N,N,0,157500.0,Commercial associate,Higher education,Separated,With parents,-15737,-432,1,0,0,0,,1.0,-41,0
4745,5009123,F,N,N,0,157500.0,Commercial associate,Higher education,Separated,With parents,-15737,-432,1,0,0,0,,1.0,-42,0
4746,5009123,F,N,N,0,157500.0,Commercial associate,Higher education,Separated,With parents,-15737,-432,1,0,0,0,,1.0,-43,X
4747,5009124,F,N,N,0,157500.0,Commercial associate,Higher education,Separated,With parents,-15737,-432,1,0,0,0,,1.0,-13,C
4748,5009124,F,N,N,0,157500.0,Commercial associate,Higher education,Separated,With parents,-15737,-432,1,0,0,0,,1.0,-14,C
4749,5009124,F,N,N,0,157500.0,Commercial associate,Higher education,Separated,With parents,-15737,-432,1,0,0,0,,1.0,-15,C
4750,5009124,F,N,N,0,157500.0,Commercial associate,Higher education,Separated,With parents,-15737,-432,1,0,0,0,,1.0,-16,C
4751,5009124,F,N,N,0,157500.0,Commercial associate,Higher education,Separated,With parents,-15737,-432,1,0,0,0,,1.0,-17,C
4752,5009124,F,N,N,0,157500.0,Commercial associate,Higher education,Separated,With parents,-15737,-432,1,0,0,0,,1.0,-18,C
4753,5009124,F,N,N,0,157500.0,Commercial associate,Higher education,Separated,With parents,-15737,-432,1,0,0,0,,1.0,-19,C
4754,5009124,F,N,N,0,157500.0,Commercial associate,Higher education,Separated,With parents,-15737,-432,1,0,0,0,,1.0,-20,C
4755,5009124,F,N,N,0,157500.0,Commercial associate,Higher education,Separated,With parents,-15737,-432,1,0,0,0,,1.0,-21,C
4756,5009124,F,N,N,0,157500.0,Commercial associate,Higher education,Separated,With parents,-15737,-432,1,0,0,0,,1.0,-22,0
4757,5009124,F,N,N,0,157500.0,Commercial associate,Higher education,Separated,With parents,-15737,-432,1,0,0,0,,1.0,-23,0
4758,5009124,F,N,N,0,157500.0,Commercial associate,Higher education,Separated,With parents,-15737,-432,1,0,0,0,,1.0,-24,0
4759,5009124,F,N,N,0,157500.0,Commercial associate,Higher education,Separated,With parents,-15737,-432,1,0,0,0,,1.0,-25,0
4760,5009125,F,N,N,0,157500.0,Commercial associate,Higher education,Separated,With parents,-15737,-432,1,0,0,0,,1.0,0,C
4761,5009125,F,N,N,0,157500.0,Commercial associate,Higher education,Separated,With parents,-15737,-432,1,0,0,0,,1.0,-1,C
4762,5009125,F,N,N,0,157500.0,Commercial associate,Higher education,Separated,With parents,-15737,-432,1,0,0,0,,1.0,-2,C
4763,5009125,F,N,N,0,157500.0,Commercial associate,Higher education,Separated,With parents,-15737,-432,1,0,0,0,,1.0,-3,C
4764,5009125,F,N,N,0,157500.0,Commercial associate,Higher education,Separated,With parents,-15737,-432,1,0,0,0,,1.0,-4,C
4765,5009125,F,N,N,0,157500.0,Commercial associate,Higher education,Separated,With parents,-15737,-432,1,0,0,0,,1.0,-5,C
4766,5009125,F,N,N,0,157500.0,Commercial associate,Higher education,Separated,With parents,-15737,-432,1,0,0,0,,1.0,-6,C
4767,5009125,F,N,N,0,157500.0,Commercial associate,Higher education,Separated,With parents,-15737,-432,1,0,0,0,,1.0,-7,C
4768,5009125,F,N,N,0,157500.0,Commercial associate,Higher education,Separated,With parents,-15737,-432,1,0,0,0,,1.0,-8,C
4769,5009125,F,N,N,0,157500.0,Commercial associate,Higher education,Separated,With parents,-15737,-432,1,0,0,0,,1.0,-9,C
4770,5009125,F,N,N,0,157500.0,Commercial associate,Higher education,Separated,With parents,-15737,-432,1,0,0,0,,1.0,-10,C
4771,5009125,F,N,N,0,157500.0,Commercial associate,Higher education,Separated,With parents,-15737,-432,1,0,0,0,,1.0,-11,C
4772,5009125,F,N,N,0,157500.0,Commercial associate,Higher education,Separated,With parents,-15737,-432,1,0,0,0,,1.0,-12,C
4773,5009125,F,N,N,0,157500.0,Commercial associate,Higher education,Separated,With parents,-15737,-432,1,0,0,0,,1.0,-13,C
4774,5009125,F,N,N,0,157500.0,Commercial associate,Higher education,Separated,With parents,-15737,-432,1,0,0,0,,1.0,-14,C
4775,5009125,F,N,N,0,157500.0,Commercial associate,Higher education,Separated,With parents,-15737,-432,1,0,0,0,,1.0,-15,C
4776,5009125,F,N,N,0,157500.0,Commercial associate,Higher education,Separated,With parents,-15737,-432,1,0,0,0,,1.0,-16,C
4777,5009125,F,N,N,0,157500.0,Commercial associate,Higher education,Separated,With parents,-15737,-432,1,0,0,0,,1.0,-17,C
4778,5009125,F,N,N,0,157500.0,Commercial associate,Higher education,Separated,With parents,-15737,-432,1,0,0,0,,1.0,-18,C
4779,5009125,F,N,N,0,157500.0,Commercial associate,Higher education,Separated,With parents,-15737,-432,1,0,0,0,,1.0,-19,C
4780,5009125,F,N,N,0,157500.0,Commercial associate,Higher education,Separated,With parents,-15737,-432,1,0,0,0,,1.0,-20,C
4781,5009125,F,N,N,0,157500.0,Commercial associate,Higher education,Separated,With parents,-15737,-432,1,0,0,0,,1.0,-21,C
4782,5009125,F,N,N,0,157500.0,Commercial associate,Higher education,Separated,With parents,-15737,-432,1,0,0,0,,1.0,-22,C
4783,5009125,F,N,N,0,157500.0,Commercial associate,Higher education,Separated,With parents,-15737,-432,1,0,0,0,,1.0,-23,C
4784,5009125,F,N,N,0,157500.0,Commercial associate,Higher education,Separated,With parents,-15737,-432,1,0,0,0,,1.0,-24,C
4785,5009125,F,N,N,0,157500.0,Commercial associate,Higher education,Separated,With parents,-15737,-432,1,0,0,0,,1.0,-25,C
4786,5009125,F,N,N,0,157500.0,Commercial associate,Higher education,Separated,With parents,-15737,-432,1,0,0,0,,1.0,-26,C
4787,5009125,F,N,N,0,157500.0,Commercial associate,Higher education,Separated,With parents,-15737,-432,1,0,0,0,,1.0,-27,C
4788,5009125,F,N,N,0,157500.0,Commercial associate,Higher education,Separated,With parents,-15737,-432,1,0,0,0,,1.0,-28,C
4789,5009125,F,N,N,0,157500.0,Commercial associate,Higher education,Separated,With parents,-15737,-432,1,0,0,0,,1.0,-29,C
4790,5009125,F,N,N,0,157500.0,Commercial associate,Higher education,Separated,With parents,-15737,-432,1,0,0,0,,1.0,-30,C
4791,5009125,F,N,N,0,157500.0,Commercial associate,Higher education,Separated,With parents,-15737,-432,1,0,0,0,,1.0,-31,C
4792,5009125,F,N,N,0,157500.0,Commercial associate,Higher education,Separated,With parents,-15737,-432,1,0,0,0,,1.0,-32,C
4793,5009125,F,N,N,0,157500.0,Commercial associate,Higher education,Separated,With parents,-15737,-432,1,0,0,0,,1.0,-33,C
4794,5009125,F,N,N,0,157500.0,Commercial associate,Higher education,Separated,With parents,-15737,-432,1,0,0,0,,1.0,-34,C
4795,5009125,F,N,N,0,157500.0,Commercial associate,Higher education,Separated,With parents,-15737,-432,1,0,0,0,,1.0,-35,C
4796,5009125,F,N,N,0,157500.0,Commercial associate,Higher education,Separated,With parents,-15737,-432,1,0,0,0,,1.0,-36,C
4797,5009125,F,N,N,0,157500.0,Commercial associate,Higher education,Separated,With parents,-15737,-432,1,0,0,0,,1.0,-37,C
4798,5009125,F,N,N,0,157500.0,Commercial associate,Higher education,Separated,With parents,-15737,-432,1,0,0,0,,1.0,-38,C
4799,5009125,F,N,N,0,157500.0,Commercial associate,Higher education,Separated,With parents,-15737,-432,1,0,0,0,,1.0,-39,C
4800,5009125,F,N,N,0,157500.0,Commercial associate,Higher education,Separated,With parents,-15737,-432,1,0,0,0,,1.0,-40,C
4801,5009125,F,N,N,0,157500.0,Commercial associate,Higher education,Separated,With parents,-15737,-432,1,0,0,0,,1.0,-41,C
4802,5009125,F,N,N,0,157500.0,Commercial associate,Higher education,Separated,With parents,-15737,-432,1,0,0,0,,1.0,-42,0
4803,5009125,F,N,N,0,157500.0,Commercial associate,Higher education,Separated,With parents,-15737,-432,1,0,0,0,,1.0,-43,0
4804,5009125,F,N,N,0,157500.0,Commercial associate,Higher education,Separated,With parents,-15737,-432,1,0,0,0,,1.0,-44,0
4805,5009125,F,N,N,0,157500.0,Commercial associate,Higher education,Separated,With parents,-15737,-432,1,0,0,0,,1.0,-45,0
4806,5009125,F,N,N,0,157500.0,Commercial associate,Higher education,Separated,With parents,-15737,-432,1,0,0,0,,1.0,-46,X
4807,5009126,F,N,N,0,157500.0,Commercial associate,Higher education,Separated,With parents,-15737,-432,1,0,0,0,,1.0,-23,C
4808,5009126,F,N,N,0,157500.0,Commercial associate,Higher education,Separated,With parents,-15737,-432,1,0,0,0,,1.0,-24,C
4809,5009126,F,N,N,0,157500.0,Commercial associate,Higher education,Separated,With parents,-15737,-432,1,0,0,0,,1.0,-25,C
4810,5009126,F,N,N,0,157500.0,Commercial associate,Higher education,Separated,With parents,-15737,-432,1,0,0,0,,1.0,-26,C
4811,5009126,F,N,N,0,157500.0,Commercial associate,Higher education,Separated,With parents,-15737,-432,1,0,0,0,,1.0,-27,C
4812,5009126,F,N,N,0,157500.0,Commercial associate,Higher education,Separated,With parents,-15737,-432,1,0,0,0,,1.0,-28,C
4813,5009126,F,N,N,0,157500.0,Commercial associate,Higher education,Separated,With parents,-15737,-432,1,0,0,0,,1.0,-29,C
4814,5009126,F,N,N,0,157500.0,Commercial associate,Higher education,Separated,With parents,-15737,-432,1,0,0,0,,1.0,-30,C
4815,5009126,F,N,N,0,157500.0,Commercial associate,Higher education,Separated,With parents,-15737,-432,1,0,0,0,,1.0,-31,C
4816,5009126,F,N,N,0,157500.0,Commercial associate,Higher education,Separated,With parents,-15737,-432,1,0,0,0,,1.0,-32,0
4817,5009126,F,N,N,0,157500.0,Commercial associate,Higher education,Separated,With parents,-15737,-432,1,0,0,0,,1.0,-33,0
4818,5009126,F,N,N,0,157500.0,Commercial associate,Higher education,Separated,With parents,-15737,-432,1,0,0,0,,1.0,-34,0
4819,5009126,F,N,N,0,157500.0,Commercial associate,Higher education,Separated,With parents,-15737,-432,1,0,0,0,,1.0,-35,0
4820,5009127,F,N,N,0,157500.0,Commercial associate,Higher education,Separated,With parents,-15737,-432,1,0,0,0,,1.0,0,C
4821,5009127,F,N,N,0,157500.0,Commercial associate,Higher education,Separated,With parents,-15737,-432,1,0,0,0,,1.0,-1,C
4822,5009127,F,N,N,0,157500.0,Commercial associate,Higher education,Separated,With parents,-15737,-432,1,0,0,0,,1.0,-2,C
4823,5009127,F,N,N,0,157500.0,Commercial associate,Higher education,Separated,With parents,-15737,-432,1,0,0,0,,1.0,-3,C
4824,5009127,F,N,N,0,157500.0,Commercial associate,Higher education,Separated,With parents,-15737,-432,1,0,0,0,,1.0,-4,C
4825,5009127,F,N,N,0,157500.0,Commercial associate,Higher education,Separated,With parents,-15737,-432,1,0,0,0,,1.0,-5,C
4826,5009127,F,N,N,0,157500.0,Commercial associate,Higher education,Separated,With parents,-15737,-432,1,0,0,0,,1.0,-6,C
4827,5009127,F,N,N,0,157500.0,Commercial associate,Higher education,Separated,With parents,-15737,-432,1,0,0,0,,1.0,-7,C
4828,5009127,F,N,N,0,157500.0,Commercial associate,Higher education,Separated,With parents,-15737,-432,1,0,0,0,,1.0,-8,C
4829,5009127,F,N,N,0,157500.0,Commercial associate,Higher education,Separated,With parents,-15737,-432,1,0,0,0,,1.0,-9,C
4830,5009127,F,N,N,0,157500.0,Commercial associate,Higher education,Separated,With parents,-15737,-432,1,0,0,0,,1.0,-10,C
4831,5009127,F,N,N,0,157500.0,Commercial associate,Higher education,Separated,With parents,-15737,-432,1,0,0,0,,1.0,-11,C
4832,5009127,F,N,N,0,157500.0,Commercial associate,Higher education,Separated,With parents,-15737,-432,1,0,0,0,,1.0,-12,C
4833,5009127,F,N,N,0,157500.0,Commercial associate,Higher education,Separated,With parents,-15737,-432,1,0,0,0,,1.0,-13,C
4834,5009127,F,N,N,0,157500.0,Commercial associate,Higher education,Separated,With parents,-15737,-432,1,0,0,0,,1.0,-14,C
4835,5009127,F,N,N,0,157500.0,Commercial associate,Higher education,Separated,With parents,-15737,-432,1,0,0,0,,1.0,-15,C
4836,5009127,F,N,N,0,157500.0,Commercial associate,Higher education,Separated,With parents,-15737,-432,1,0,0,0,,1.0,-16,C
4837,5009127,F,N,N,0,157500.0,Commercial associate,Higher education,Separated,With parents,-15737,-432,1,0,0,0,,1.0,-17,C
4838,5009127,F,N,N,0,157500.0,Commercial associate,Higher education,Separated,With parents,-15737,-432,1,0,0,0,,1.0,-18,0
4839,5009127,F,N,N,0,157500.0,Commercial associate,Higher education,Separated,With parents,-15737,-432,1,0,0,0,,1.0,-19,0
4840,5009127,F,N,N,0,157500.0,Commercial associate,Higher education,Separated,With parents,-15737,-432,1,0,0,0,,1.0,-20,0
4841,5009127,F,N,N,0,157500.0,Commercial associate,Higher education,Separated,With parents,-15737,-432,1,0,0,0,,1.0,-21,0
4842,5009127,F,N,N,0,157500.0,Commercial associate,Higher education,Separated,With parents,-15737,-432,1,0,0,0,,1.0,-22,X
4843,5009128,F,N,N,0,157500.0,Commercial associate,Higher education,Separated,With parents,-15737,-432,1,0,0,0,,1.0,-2,C
4844,5009128,F,N,N,0,157500.0,Commercial associate,Higher education,Separated,With parents,-15737,-432,1,0,0,0,,1.0,-3,C
4845,5009128,F,N,N,0,157500.0,Commercial associate,Higher education,Separated,With parents,-15737,-432,1,0,0,0,,1.0,-4,C
4846,5009128,F,N,N,0,157500.0,Commercial associate,Higher education,Separated,With parents,-15737,-432,1,0,0,0,,1.0,-5,C
4847,5009128,F,N,N,0,157500.0,Commercial associate,Higher education,Separated,With parents,-15737,-432,1,0,0,0,,1.0,-6,C
4848,5009128,F,N,N,0,157500.0,Commercial associate,Higher education,Separated,With parents,-15737,-432,1,0,0,0,,1.0,-7,C
4849,5009128,F,N,N,0,157500.0,Commercial associate,Higher education,Separated,With parents,-15737,-432,1,0,0,0,,1.0,-8,C
4850,5009128,F,N,N,0,157500.0,Commercial associate,Higher education,Separated,With parents,-15737,-432,1,0,0,0,,1.0,-9,C
4851,5009128,F,N,N,0,157500.0,Commercial associate,Higher education,Separated,With parents,-15737,-432,1,0,0,0,,1.0,-10,C
4852,5009128,F,N,N,0,157500.0,Commercial associate,Higher education,Separated,With parents,-15737,-432,1,0,0,0,,1.0,-11,0
4853,5009128,F,N,N,0,157500.0,Commercial associate,Higher education,Separated,With parents,-15737,-432,1,0,0,0,,1.0,-12,0
4854,5009128,F,N,N,0,157500.0,Commercial associate,Higher education,Separated,With parents,-15737,-432,1,0,0,0,,1.0,-13,0
4855,5009128,F,N,N,0,157500.0,Commercial associate,Higher education,Separated,With parents,-15737,-432,1,0,0,0,,1.0,-14,0
4856,5009129,F,N,N,0,157500.0,Commercial associate,Higher education,Separated,With parents,-15737,-432,1,0,0,0,,1.0,0,C
4857,5009129,F,N,N,0,157500.0,Commercial associate,Higher education,Separated,With parents,-15737,-432,1,0,0,0,,1.0,-1,C
4858,5009129,F,N,N,0,157500.0,Commercial associate,Higher education,Separated,With parents,-15737,-432,1,0,0,0,,1.0,-2,C
4859,5009129,F,N,N,0,157500.0,Commercial associate,Higher education,Separated,With parents,-15737,-432,1,0,0,0,,1.0,-3,C
4860,5009129,F,N,N,0,157500.0,Commercial associate,Higher education,Separated,With parents,-15737,-432,1,0,0,0,,1.0,-4,C
4861,5009129,F,N,N,0,157500.0,Commercial associate,Higher education,Separated,With parents,-15737,-432,1,0,0,0,,1.0,-5,C
4862,5009129,F,N,N,0,157500.0,Commercial associate,Higher education,Separated,With parents,-15737,-432,1,0,0,0,,1.0,-6,C
4863,5009129,F,N,N,0,157500.0,Commercial associate,Higher education,Separated,With parents,-15737,-432,1,0,0,0,,1.0,-7,C
4864,5009129,F,N,N,0,157500.0,Commercial associate,Higher education,Separated,With parents,-15737,-432,1,0,0,0,,1.0,-8,0
4865,5009129,F,N,N,0,157500.0,Commercial associate,Higher education,Separated,With parents,-15737,-432,1,0,0,0,,1.0,-9,0
4866,5009129,F,N,N,0,157500.0,Commercial associate,Higher education,Separated,With parents,-15737,-432,1,0,0,0,,1.0,-10,0
4867,5009129,F,N,N,0,157500.0,Commercial associate,Higher education,Separated,With parents,-15737,-432,1,0,0,0,,1.0,-11,0
4868,5009130,F,N,N,0,157500.0,Commercial associate,Higher education,Separated,With parents,-15737,-432,1,0,0,0,,1.0,0,C
4869,5009130,F,N,N,0,157500.0,Commercial associate,Higher education,Separated,With parents,-15737,-432,1,0,0,0,,1.0,-1,C
4870,5009130,F,N,N,0,157500.0,Commercial associate,Higher education,Separated,With parents,-15737,-432,1,0,0,0,,1.0,-2,C
4871,5009130,F,N,N,0,157500.0,Commercial associate,Higher education,Separated,With parents,-15737,-432,1,0,0,0,,1.0,-3,C
4872,5009130,F,N,N,0,157500.0,Commercial associate,Higher education,Separated,With parents,-15737,-432,1,0,0,0,,1.0,-4,C
4873,5009130,F,N,N,0,157500.0,Commercial associate,Higher education,Separated,With parents,-15737,-432,1,0,0,0,,1.0,-5,C
4874,5009130,F,N,N,0,157500.0,Commercial associate,Higher education,Separated,With parents,-15737,-432,1,0,0,0,,1.0,-6,C
4875,5009130,F,N,N,0,157500.0,Commercial associate,Higher education,Separated,With parents,-15737,-432,1,0,0,0,,1.0,-7,C
4876,5009130,F,N,N,0,157500.0,Commercial associate,Higher education,Separated,With parents,-15737,-432,1,0,0,0,,1.0,-8,C
4877,5009130,F,N,N,0,157500.0,Commercial associate,Higher education,Separated,With parents,-15737,-432,1,0,0,0,,1.0,-9,C
4878,5009130,F,N,N,0,157500.0,Commercial associate,Higher education,Separated,With parents,-15737,-432,1,0,0,0,,1.0,-10,C
4879,5009130,F,N,N,0,157500.0,Commercial associate,Higher education,Separated,With parents,-15737,-432,1,0,0,0,,1.0,-11,C
4880,5009130,F,N,N,0,157500.0,Commercial associate,Higher education,Separated,With parents,-15737,-432,1,0,0,0,,1.0,-12,C
4881,5009130,F,N,N,0,157500.0,Commercial associate,Higher education,Separated,With parents,-15737,-432,1,0,0,0,,1.0,-13,C
4882,5009130,F,N,N,0,157500.0,Commercial associate,Higher education,Separated,With parents,-15737,-432,1,0,0,0,,1.0,-14,C
4883,5009130,F,N,N,0,157500.0,Commercial associate,Higher education,Separated,With parents,-15737,-432,1,0,0,0,,1.0,-15,C
4884,5009130,F,N,N,0,157500.0,Commercial associate,Higher education,Separated,With parents,-15737,-432,1,0,0,0,,1.0,-16,C
4885,5009130,F,N,N,0,157500.0,Commercial associate,Higher education,Separated,With parents,-15737,-432,1,0,0,0,,1.0,-17,C
4886,5009130,F,N,N,0,157500.0,Commercial associate,Higher education,Separated,With parents,-15737,-432,1,0,0,0,,1.0,-18,0
4887,5009130,F,N,N,0,157500.0,Commercial associate,Higher education,Separated,With parents,-15737,-432,1,0,0,0,,1.0,-19,0
4888,5009130,F,N,N,0,157500.0,Commercial associate,Higher education,Separated,With parents,-15737,-432,1,0,0,0,,1.0,-20,0
4889,5009130,F,N,N,0,157500.0,Commercial associate,Higher education,Separated,With parents,-15737,-432,1,0,0,0,,1.0,-21,0
4890,5009130,F,N,N,0,157500.0,Commercial associate,Higher education,Separated,With parents,-15737,-432,1,0,0,0,,1.0,-22,X
4891,5009131,F,N,N,0,157500.0,Commercial associate,Higher education,Separated,With parents,-15737,-432,1,0,0,0,,1.0,-11,C
4892,5009131,F,N,N,0,157500.0,Commercial associate,Higher education,Separated,With parents,-15737,-432,1,0,0,0,,1.0,-12,C
4893,5009131,F,N,N,0,157500.0,Commercial associate,Higher education,Separated,With parents,-15737,-432,1,0,0,0,,1.0,-13,C
4894,5009131,F,N,N,0,157500.0,Commercial associate,Higher education,Separated,With parents,-15737,-432,1,0,0,0,,1.0,-14,C
4895,5009131,F,N,N,0,157500.0,Commercial associate,Higher education,Separated,With parents,-15737,-432,1,0,0,0,,1.0,-15,C
4896,5009131,F,N,N,0,157500.0,Commercial associate,Higher education,Separated,With parents,-15737,-432,1,0,0,0,,1.0,-16,C
4897,5009131,F,N,N,0,157500.0,Commercial associate,Higher education,Separated,With parents,-15737,-432,1,0,0,0,,1.0,-17,C
4898,5009131,F,N,N,0,157500.0,Commercial associate,Higher education,Separated,With parents,-15737,-432,1,0,0,0,,1.0,-18,C
4899,5009131,F,N,N,0,157500.0,Commercial associate,Higher education,Separated,With parents,-15737,-432,1,0,0,0,,1.0,-19,C
4900,5009131,F,N,N,0,157500.0,Commercial associate,Higher education,Separated,With parents,-15737,-432,1,0,0,0,,1.0,-20,0
4901,5009131,F,N,N,0,157500.0,Commercial associate,Higher education,Separated,With parents,-15737,-432,1,0,0,0,,1.0,-21,0
4902,5009131,F,N,N,0,157500.0,Commercial associate,Higher education,Separated,With parents,-15737,-432,1,0,0,0,,1.0,-22,0
4903,5009131,F,N,N,0,157500.0,Commercial associate,Higher education,Separated,With parents,-15737,-432,1,0,0,0,,1.0,-23,0
4904,5009133,M,N,Y,0,382500.0,Pensioner,Secondary / secondary special,Widow,House / apartment,-21673,365243,1,0,0,0,,1.0,0,C
4905,5009133,M,N,Y,0,382500.0,Pensioner,Secondary / secondary special,Widow,House / apartment,-21673,365243,1,0,0,0,,1.0,-1,C
4906,5009133,M,N,Y,0,382500.0,Pensioner,Secondary / secondary special,Widow,House / apartment,-21673,365243,1,0,0,0,,1.0,-2,C
4907,5009133,M,N,Y,0,382500.0,Pensioner,Secondary / secondary special,Widow,House / apartment,-21673,365243,1,0,0,0,,1.0,-3,C
4908,5009133,M,N,Y,0,382500.0,Pensioner,Secondary / secondary special,Widow,House / apartment,-21673,365243,1,0,0,0,,1.0,-4,C
4909,5009133,M,N,Y,0,382500.0,Pensioner,Secondary / secondary special,Widow,House / apartment,-21673,365243,1,0,0,0,,1.0,-5,C
4910,5009133,M,N,Y,0,382500.0,Pensioner,Secondary / secondary special,Widow,House / apartment,-21673,365243,1,0,0,0,,1.0,-6,C
4911,5009133,M,N,Y,0,382500.0,Pensioner,Secondary / secondary special,Widow,House / apartment,-21673,365243,1,0,0,0,,1.0,-7,C
4912,5009133,M,N,Y,0,382500.0,Pensioner,Secondary / secondary special,Widow,House / apartment,-21673,365243,1,0,0,0,,1.0,-8,C
4913,5009133,M,N,Y,0,382500.0,Pensioner,Secondary / secondary special,Widow,House / apartment,-21673,365243,1,0,0,0,,1.0,-9,0
4914,5009133,M,N,Y,0,382500.0,Pensioner,Secondary / secondary special,Widow,House / apartment,-21673,365243,1,0,0,0,,1.0,-10,X
4915,5009133,M,N,Y,0,382500.0,Pensioner,Secondary / secondary special,Widow,House / apartment,-21673,365243,1,0,0,0,,1.0,-11,0
4916,5009133,M,N,Y,0,382500.0,Pensioner,Secondary / secondary special,Widow,House / apartment,-21673,365243,1,0,0,0,,1.0,-12,X
4917,5009133,M,N,Y,0,382500.0,Pensioner,Secondary / secondary special,Widow,House / apartment,-21673,365243,1,0,0,0,,1.0,-13,X
4918,5009133,M,N,Y,0,382500.0,Pensioner,Secondary / secondary special,Widow,House / apartment,-21673,365243,1,0,0,0,,1.0,-14,X
4919,5009133,M,N,Y,0,382500.0,Pensioner,Secondary / secondary special,Widow,House / apartment,-21673,365243,1,0,0,0,,1.0,-15,0
4920,5009133,M,N,Y,0,382500.0,Pensioner,Secondary / secondary special,Widow,House / apartment,-21673,365243,1,0,0,0,,1.0,-16,X
4921,5009134,M,N,Y,0,382500.0,Pensioner,Secondary / secondary special,Widow,House / apartment,-21673,365243,1,0,0,0,,1.0,0,C
4922,5009134,M,N,Y,0,382500.0,Pensioner,Secondary / secondary special,Widow,House / apartment,-21673,365243,1,0,0,0,,1.0,-1,C
4923,5009134,M,N,Y,0,382500.0,Pensioner,Secondary / secondary special,Widow,House / apartment,-21673,365243,1,0,0,0,,1.0,-2,C
4924,5009134,M,N,Y,0,382500.0,Pensioner,Secondary / secondary special,Widow,House / apartment,-21673,365243,1,0,0,0,,1.0,-3,C
4925,5009134,M,N,Y,0,382500.0,Pensioner,Secondary / secondary special,Widow,House / apartment,-21673,365243,1,0,0,0,,1.0,-4,C
4926,5009134,M,N,Y,0,382500.0,Pensioner,Secondary / secondary special,Widow,House / apartment,-21673,365243,1,0,0,0,,1.0,-5,C
4927,5009134,M,N,Y,0,382500.0,Pensioner,Secondary / secondary special,Widow,House / apartment,-21673,365243,1,0,0,0,,1.0,-6,C
4928,5009134,M,N,Y,0,382500.0,Pensioner,Secondary / secondary special,Widow,House / apartment,-21673,365243,1,0,0,0,,1.0,-7,C
4929,5009134,M,N,Y,0,382500.0,Pensioner,Secondary / secondary special,Widow,House / apartment,-21673,365243,1,0,0,0,,1.0,-8,C
4930,5009134,M,N,Y,0,382500.0,Pensioner,Secondary / secondary special,Widow,House / apartment,-21673,365243,1,0,0,0,,1.0,-9,C
4931,5009134,M,N,Y,0,382500.0,Pensioner,Secondary / secondary special,Widow,House / apartment,-21673,365243,1,0,0,0,,1.0,-10,C
4932,5009134,M,N,Y,0,382500.0,Pensioner,Secondary / secondary special,Widow,House / apartment,-21673,365243,1,0,0,0,,1.0,-11,C
4933,5009134,M,N,Y,0,382500.0,Pensioner,Secondary / secondary special,Widow,House / apartment,-21673,365243,1,0,0,0,,1.0,-12,0
4934,5009134,M,N,Y,0,382500.0,Pensioner,Secondary / secondary special,Widow,House / apartment,-21673,365243,1,0,0,0,,1.0,-13,0
4935,5009134,M,N,Y,0,382500.0,Pensioner,Secondary / secondary special,Widow,House / apartment,-21673,365243,1,0,0,0,,1.0,-14,0
4936,5009134,M,N,Y,0,382500.0,Pensioner,Secondary / secondary special,Widow,House / apartment,-21673,365243,1,0,0,0,,1.0,-15,0
4937,5009134,M,N,Y,0,382500.0,Pensioner,Secondary / secondary special,Widow,House / apartment,-21673,365243,1,0,0,0,,1.0,-16,0
4938,5009135,M,N,Y,0,382500.0,Pensioner,Secondary / secondary special,Widow,House / apartment,-21673,365243,1,0,0,0,,1.0,-46,X
4939,5009135,M,N,Y,0,382500.0,Pensioner,Secondary / secondary special,Widow,House / apartment,-21673,365243,1,0,0,0,,1.0,-47,X
4940,5009135,M,N,Y,0,382500.0,Pensioner,Secondary / secondary special,Widow,House / apartment,-21673,365243,1,0,0,0,,1.0,-48,0
4941,5009135,M,N,Y,0,382500.0,Pensioner,Secondary / secondary special,Widow,House / apartment,-21673,365243,1,0,0,0,,1.0,-49,0
4942,5009135,M,N,Y,0,382500.0,Pensioner,Secondary / secondary special,Widow,House / apartment,-21673,365243,1,0,0,0,,1.0,-50,0
4943,5009135,M,N,Y,0,382500.0,Pensioner,Secondary / secondary special,Widow,House / apartment,-21673,365243,1,0,0,0,,1.0,-51,0
4944,5009135,M,N,Y,0,382500.0,Pensioner,Secondary / secondary special,Widow,House / apartment,-21673,365243,1,0,0,0,,1.0,-52,0
4945,5009135,M,N,Y,0,382500.0,Pensioner,Secondary / secondary special,Widow,House / apartment,-21673,365243,1,0,0,0,,1.0,-53,0
4946,5009135,M,N,Y,0,382500.0,Pensioner,Secondary / secondary special,Widow,House / apartment,-21673,365243,1,0,0,0,,1.0,-54,0
4947,5009135,M,N,Y,0,382500.0,Pensioner,Secondary / secondary special,Widow,House / apartment,-21673,365243,1,0,0,0,,1.0,-55,0
4948,5009136,M,N,Y,0,382500.0,Pensioner,Secondary / secondary special,Widow,House / apartment,-21673,365243,1,0,0,0,,1.0,0,C
4949,5009136,M,N,Y,0,382500.0,Pensioner,Secondary / secondary special,Widow,House / apartment,-21673,365243,1,0,0,0,,1.0,-1,C
4950,5009136,M,N,Y,0,382500.0,Pensioner,Secondary / secondary special,Widow,House / apartment,-21673,365243,1,0,0,0,,1.0,-2,C
4951,5009136,M,N,Y,0,382500.0,Pensioner,Secondary / secondary special,Widow,House / apartment,-21673,365243,1,0,0,0,,1.0,-3,C
4952,5009136,M,N,Y,0,382500.0,Pensioner,Secondary / secondary special,Widow,House / apartment,-21673,365243,1,0,0,0,,1.0,-4,C
4953,5009136,M,N,Y,0,382500.0,Pensioner,Secondary / secondary special,Widow,House / apartment,-21673,365243,1,0,0,0,,1.0,-5,C
4954,5009136,M,N,Y,0,382500.0,Pensioner,Secondary / secondary special,Widow,House / apartment,-21673,365243,1,0,0,0,,1.0,-6,C
4955,5009136,M,N,Y,0,382500.0,Pensioner,Secondary / secondary special,Widow,House / apartment,-21673,365243,1,0,0,0,,1.0,-7,C
4956,5009136,M,N,Y,0,382500.0,Pensioner,Secondary / secondary special,Widow,House / apartment,-21673,365243,1,0,0,0,,1.0,-8,C
4957,5009136,M,N,Y,0,382500.0,Pensioner,Secondary / secondary special,Widow,House / apartment,-21673,365243,1,0,0,0,,1.0,-9,C
4958,5009136,M,N,Y,0,382500.0,Pensioner,Secondary / secondary special,Widow,House / apartment,-21673,365243,1,0,0,0,,1.0,-10,0
4959,5009136,M,N,Y,0,382500.0,Pensioner,Secondary / secondary special,Widow,House / apartment,-21673,365243,1,0,0,0,,1.0,-11,0
4960,5009136,M,N,Y,0,382500.0,Pensioner,Secondary / secondary special,Widow,House / apartment,-21673,365243,1,0,0,0,,1.0,-12,0
4961,5009136,M,N,Y,0,382500.0,Pensioner,Secondary / secondary special,Widow,House / apartment,-21673,365243,1,0,0,0,,1.0,-13,0
4962,5009136,M,N,Y,0,382500.0,Pensioner,Secondary / secondary special,Widow,House / apartment,-21673,365243,1,0,0,0,,1.0,-14,0
4963,5009136,M,N,Y,0,382500.0,Pensioner,Secondary / secondary special,Widow,House / apartment,-21673,365243,1,0,0,0,,1.0,-15,0
4964,5009137,M,N,Y,0,382500.0,Pensioner,Secondary / secondary special,Widow,House / apartment,-21673,365243,1,0,0,0,,1.0,-2,X
4965,5009137,M,N,Y,0,382500.0,Pensioner,Secondary / secondary special,Widow,House / apartment,-21673,365243,1,0,0,0,,1.0,-3,X
4966,5009137,M,N,Y,0,382500.0,Pensioner,Secondary / secondary special,Widow,House / apartment,-21673,365243,1,0,0,0,,1.0,-4,0
4967,5009137,M,N,Y,0,382500.0,Pensioner,Secondary / secondary special,Widow,House / apartment,-21673,365243,1,0,0,0,,1.0,-5,0
4968,5009137,M,N,Y,0,382500.0,Pensioner,Secondary / secondary special,Widow,House / apartment,-21673,365243,1,0,0,0,,1.0,-6,0
4969,5009137,M,N,Y,0,382500.0,Pensioner,Secondary / secondary special,Widow,House / apartment,-21673,365243,1,0,0,0,,1.0,-7,0
4970,5009137,M,N,Y,0,382500.0,Pensioner,Secondary / secondary special,Widow,House / apartment,-21673,365243,1,0,0,0,,1.0,-8,0
4971,5009137,M,N,Y,0,382500.0,Pensioner,Secondary / secondary special,Widow,House / apartment,-21673,365243,1,0,0,0,,1.0,-9,0
4972,5009137,M,N,Y,0,382500.0,Pensioner,Secondary / secondary special,Widow,House / apartment,-21673,365243,1,0,0,0,,1.0,-10,0
4973,5009137,M,N,Y,0,382500.0,Pensioner,Secondary / secondary special,Widow,House / apartment,-21673,365243,1,0,0,0,,1.0,-11,0
4974,5009138,M,N,Y,0,382500.0,Pensioner,Secondary / secondary special,Widow,House / apartment,-21673,365243,1,0,0,0,,1.0,-6,X
4975,5009138,M,N,Y,0,382500.0,Pensioner,Secondary / secondary special,Widow,House / apartment,-21673,365243,1,0,0,0,,1.0,-7,X
4976,5009138,M,N,Y,0,382500.0,Pensioner,Secondary / secondary special,Widow,House / apartment,-21673,365243,1,0,0,0,,1.0,-8,X
4977,5009138,M,N,Y,0,382500.0,Pensioner,Secondary / secondary special,Widow,House / apartment,-21673,365243,1,0,0,0,,1.0,-9,X
4978,5009138,M,N,Y,0,382500.0,Pensioner,Secondary / secondary special,Widow,House / apartment,-21673,365243,1,0,0,0,,1.0,-10,X
4979,5009138,M,N,Y,0,382500.0,Pensioner,Secondary / secondary special,Widow,House / apartment,-21673,365243,1,0,0,0,,1.0,-11,0
4980,5009138,M,N,Y,0,382500.0,Pensioner,Secondary / secondary special,Widow,House / apartment,-21673,365243,1,0,0,0,,1.0,-12,1
4981,5009138,M,N,Y,0,382500.0,Pensioner,Secondary / secondary special,Widow,House / apartment,-21673,365243,1,0,0,0,,1.0,-13,X
4982,5009138,M,N,Y,0,382500.0,Pensioner,Secondary / secondary special,Widow,House / apartment,-21673,365243,1,0,0,0,,1.0,-14,0
4983,5009138,M,N,Y,0,382500.0,Pensioner,Secondary / secondary special,Widow,House / apartment,-21673,365243,1,0,0,0,,1.0,-15,X
4984,5009138,M,N,Y,0,382500.0,Pensioner,Secondary / secondary special,Widow,House / apartment,-21673,365243,1,0,0,0,,1.0,-16,0
4985,5009138,M,N,Y,0,382500.0,Pensioner,Secondary / secondary special,Widow,House / apartment,-21673,365243,1,0,0,0,,1.0,-17,X
4986,5009138,M,N,Y,0,382500.0,Pensioner,Secondary / secondary special,Widow,House / apartment,-21673,365243,1,0,0,0,,1.0,-18,0
4987,5009138,M,N,Y,0,382500.0,Pensioner,Secondary / secondary special,Widow,House / apartment,-21673,365243,1,0,0,0,,1.0,-19,X
4988,5009138,M,N,Y,0,382500.0,Pensioner,Secondary / secondary special,Widow,House / apartment,-21673,365243,1,0,0,0,,1.0,-20,X
4989,5009138,M,N,Y,0,382500.0,Pensioner,Secondary / secondary special,Widow,House / apartment,-21673,365243,1,0,0,0,,1.0,-21,X
4990,5009138,M,N,Y,0,382500.0,Pensioner,Secondary / secondary special,Widow,House / apartment,-21673,365243,1,0,0,0,,1.0,-22,0
4991,5009139,M,N,Y,0,382500.0,Pensioner,Secondary / secondary special,Widow,House / apartment,-21673,365243,1,0,0,0,,1.0,0,X
4992,5009139,M,N,Y,0,382500.0,Pensioner,Secondary / secondary special,Widow,House / apartment,-21673,365243,1,0,0,0,,1.0,-1,0
4993,5009139,M,N,Y,0,382500.0,Pensioner,Secondary / secondary special,Widow,House / apartment,-21673,365243,1,0,0,0,,1.0,-2,0
4994,5009139,M,N,Y,0,382500.0,Pensioner,Secondary / secondary special,Widow,House / apartment,-21673,365243,1,0,0,0,,1.0,-3,0
4995,5009139,M,N,Y,0,382500.0,Pensioner,Secondary / secondary special,Widow,House / apartment,-21673,365243,1,0,0,0,,1.0,-4,0
4996,5009139,M,N,Y,0,382500.0,Pensioner,Secondary / secondary special,Widow,House / apartment,-21673,365243,1,0,0,0,,1.0,-5,0
4997,5009139,M,N,Y,0,382500.0,Pensioner,Secondary / secondary special,Widow,House / apartment,-21673,365243,1,0,0,0,,1.0,-6,0
4998,5009139,M,N,Y,0,382500.0,Pensioner,Secondary / secondary special,Widow,House / apartment,-21673,365243,1,0,0,0,,1.0,-7,0
4999,5009139,M,N,Y,0,382500.0,Pensioner,Secondary / secondary special,Widow,House / apartment,-21673,365243,1,0,0,0,,1.0,-8,0
5000,5009140,M,N,Y,0,382500.0,Pensioner,Secondary / secondary special,Widow,House / apartment,-21673,365243,1,0,0,0,,1.0,-9,X
5001,5009140,M,N,Y,0,382500.0,Pensioner,Secondary / secondary special,Widow,House / apartment,-21673,365243,1,0,0,0,,1.0,-10,X
5002,5009140,M,N,Y,0,382500.0,Pensioner,Secondary / secondary special,Widow,House / apartment,-21673,365243,1,0,0,0,,1.0,-11,0
5003,5009140,M,N,Y,0,382500.0,Pensioner,Secondary / secondary special,Widow,House / apartment,-21673,365243,1,0,0,0,,1.0,-12,0
5004,5009140,M,N,Y,0,382500.0,Pensioner,Secondary / secondary special,Widow,House / apartment,-21673,365243,1,0,0,0,,1.0,-13,0
5005,5009140,M,N,Y,0,382500.0,Pensioner,Secondary / secondary special,Widow,House / apartment,-21673,365243,1,0,0,0,,1.0,-14,0
5006,5009140,M,N,Y,0,382500.0,Pensioner,Secondary / secondary special,Widow,House / apartment,-21673,365243,1,0,0,0,,1.0,-15,0
5007,5009140,M,N,Y,0,382500.0,Pensioner,Secondary / secondary special,Widow,House / apartment,-21673,365243,1,0,0,0,,1.0,-16,0
5008,5009140,M,N,Y,0,382500.0,Pensioner,Secondary / secondary special,Widow,House / apartment,-21673,365243,1,0,0,0,,1.0,-17,0
5009,5009140,M,N,Y,0,382500.0,Pensioner,Secondary / secondary special,Widow,House / apartment,-21673,365243,1,0,0,0,,1.0,-18,0
5010,5009141,F,N,N,0,135000.0,Working,Secondary / secondary special,Civil marriage,House / apartment,-9657,-1560,1,1,1,0,Managers,2.0,0,C
5011,5009141,F,N,N,0,135000.0,Working,Secondary / secondary special,Civil marriage,House / apartment,-9657,-1560,1,1,1,0,Managers,2.0,-1,C
5012,5009141,F,N,N,0,135000.0,Working,Secondary / secondary special,Civil marriage,House / apartment,-9657,-1560,1,1,1,0,Managers,2.0,-2,C
5013,5009141,F,N,N,0,135000.0,Working,Secondary / secondary special,Civil marriage,House / apartment,-9657,-1560,1,1,1,0,Managers,2.0,-3,C
5014,5009141,F,N,N,0,135000.0,Working,Secondary / secondary special,Civil marriage,House / apartment,-9657,-1560,1,1,1,0,Managers,2.0,-4,C
5015,5009141,F,N,N,0,135000.0,Working,Secondary / secondary special,Civil marriage,House / apartment,-9657,-1560,1,1,1,0,Managers,2.0,-5,C
5016,5009141,F,N,N,0,135000.0,Working,Secondary / secondary special,Civil marriage,House / apartment,-9657,-1560,1,1,1,0,Managers,2.0,-6,C
5017,5009141,F,N,N,0,135000.0,Working,Secondary / secondary special,Civil marriage,House / apartment,-9657,-1560,1,1,1,0,Managers,2.0,-7,C
5018,5009141,F,N,N,0,135000.0,Working,Secondary / secondary special,Civil marriage,House / apartment,-9657,-1560,1,1,1,0,Managers,2.0,-8,C
5019,5009141,F,N,N,0,135000.0,Working,Secondary / secondary special,Civil marriage,House / apartment,-9657,-1560,1,1,1,0,Managers,2.0,-9,C
5020,5009141,F,N,N,0,135000.0,Working,Secondary / secondary special,Civil marriage,House / apartment,-9657,-1560,1,1,1,0,Managers,2.0,-10,C
5021,5009141,F,N,N,0,135000.0,Working,Secondary / secondary special,Civil marriage,House / apartment,-9657,-1560,1,1,1,0,Managers,2.0,-11,C
5022,5009141,F,N,N,0,135000.0,Working,Secondary / secondary special,Civil marriage,House / apartment,-9657,-1560,1,1,1,0,Managers,2.0,-12,C
5023,5009141,F,N,N,0,135000.0,Working,Secondary / secondary special,Civil marriage,House / apartment,-9657,-1560,1,1,1,0,Managers,2.0,-13,C
5024,5009141,F,N,N,0,135000.0,Working,Secondary / secondary special,Civil marriage,House / apartment,-9657,-1560,1,1,1,0,Managers,2.0,-14,C
5025,5009141,F,N,N,0,135000.0,Working,Secondary / secondary special,Civil marriage,House / apartment,-9657,-1560,1,1,1,0,Managers,2.0,-15,C
5026,5009141,F,N,N,0,135000.0,Working,Secondary / secondary special,Civil marriage,House / apartment,-9657,-1560,1,1,1,0,Managers,2.0,-16,C
5027,5009141,F,N,N,0,135000.0,Working,Secondary / secondary special,Civil marriage,House / apartment,-9657,-1560,1,1,1,0,Managers,2.0,-17,C
5028,5009141,F,N,N,0,135000.0,Working,Secondary / secondary special,Civil marriage,House / apartment,-9657,-1560,1,1,1,0,Managers,2.0,-18,C
5029,5009141,F,N,N,0,135000.0,Working,Secondary / secondary special,Civil marriage,House / apartment,-9657,-1560,1,1,1,0,Managers,2.0,-19,C
5030,5009141,F,N,N,0,135000.0,Working,Secondary / secondary special,Civil marriage,House / apartment,-9657,-1560,1,1,1,0,Managers,2.0,-20,C
5031,5009141,F,N,N,0,135000.0,Working,Secondary / secondary special,Civil marriage,House / apartment,-9657,-1560,1,1,1,0,Managers,2.0,-21,C
5032,5009141,F,N,N,0,135000.0,Working,Secondary / secondary special,Civil marriage,House / apartment,-9657,-1560,1,1,1,0,Managers,2.0,-22,C
5033,5009141,F,N,N,0,135000.0,Working,Secondary / secondary special,Civil marriage,House / apartment,-9657,-1560,1,1,1,0,Managers,2.0,-23,C
5034,5009141,F,N,N,0,135000.0,Working,Secondary / secondary special,Civil marriage,House / apartment,-9657,-1560,1,1,1,0,Managers,2.0,-24,C
5035,5009141,F,N,N,0,135000.0,Working,Secondary / secondary special,Civil marriage,House / apartment,-9657,-1560,1,1,1,0,Managers,2.0,-25,C
5036,5009141,F,N,N,0,135000.0,Working,Secondary / secondary special,Civil marriage,House / apartment,-9657,-1560,1,1,1,0,Managers,2.0,-26,0
5037,5009141,F,N,N,0,135000.0,Working,Secondary / secondary special,Civil marriage,House / apartment,-9657,-1560,1,1,1,0,Managers,2.0,-27,0
5038,5009141,F,N,N,0,135000.0,Working,Secondary / secondary special,Civil marriage,House / apartment,-9657,-1560,1,1,1,0,Managers,2.0,-28,0
5039,5009141,F,N,N,0,135000.0,Working,Secondary / secondary special,Civil marriage,House / apartment,-9657,-1560,1,1,1,0,Managers,2.0,-29,0
5040,5009141,F,N,N,0,135000.0,Working,Secondary / secondary special,Civil marriage,House / apartment,-9657,-1560,1,1,1,0,Managers,2.0,-30,0
5041,5009141,F,N,N,0,135000.0,Working,Secondary / secondary special,Civil marriage,House / apartment,-9657,-1560,1,1,1,0,Managers,2.0,-31,0
5042,5009141,F,N,N,0,135000.0,Working,Secondary / secondary special,Civil marriage,House / apartment,-9657,-1560,1,1,1,0,Managers,2.0,-32,0
5043,5009141,F,N,N,0,135000.0,Working,Secondary / secondary special,Civil marriage,House / apartment,-9657,-1560,1,1,1,0,Managers,2.0,-33,0
5044,5009142,F,N,N,0,135000.0,Working,Secondary / secondary special,Civil marriage,House / apartment,-9657,-1560,1,1,1,0,Managers,2.0,0,C
5045,5009142,F,N,N,0,135000.0,Working,Secondary / secondary special,Civil marriage,House / apartment,-9657,-1560,1,1,1,0,Managers,2.0,-1,C
5046,5009142,F,N,N,0,135000.0,Working,Secondary / secondary special,Civil marriage,House / apartment,-9657,-1560,1,1,1,0,Managers,2.0,-2,C
5047,5009142,F,N,N,0,135000.0,Working,Secondary / secondary special,Civil marriage,House / apartment,-9657,-1560,1,1,1,0,Managers,2.0,-3,C
5048,5009142,F,N,N,0,135000.0,Working,Secondary / secondary special,Civil marriage,House / apartment,-9657,-1560,1,1,1,0,Managers,2.0,-4,0
5049,5009142,F,N,N,0,135000.0,Working,Secondary / secondary special,Civil marriage,House / apartment,-9657,-1560,1,1,1,0,Managers,2.0,-5,0
5050,5009142,F,N,N,0,135000.0,Working,Secondary / secondary special,Civil marriage,House / apartment,-9657,-1560,1,1,1,0,Managers,2.0,-6,0
5051,5009142,F,N,N,0,135000.0,Working,Secondary / secondary special,Civil marriage,House / apartment,-9657,-1560,1,1,1,0,Managers,2.0,-7,0
5052,5009142,F,N,N,0,135000.0,Working,Secondary / secondary special,Civil marriage,House / apartment,-9657,-1560,1,1,1,0,Managers,2.0,-8,0
5053,5009142,F,N,N,0,135000.0,Working,Secondary / secondary special,Civil marriage,House / apartment,-9657,-1560,1,1,1,0,Managers,2.0,-9,0
5054,5009142,F,N,N,0,135000.0,Working,Secondary / secondary special,Civil marriage,House / apartment,-9657,-1560,1,1,1,0,Managers,2.0,-10,0
5055,5009142,F,N,N,0,135000.0,Working,Secondary / secondary special,Civil marriage,House / apartment,-9657,-1560,1,1,1,0,Managers,2.0,-11,0
5056,5009143,M,Y,N,0,225000.0,Pensioner,Secondary / secondary special,Civil marriage,House / apartment,-18289,365243,1,0,0,0,,2.0,0,C
5057,5009143,M,Y,N,0,225000.0,Pensioner,Secondary / secondary special,Civil marriage,House / apartment,-18289,365243,1,0,0,0,,2.0,-1,C
5058,5009143,M,Y,N,0,225000.0,Pensioner,Secondary / secondary special,Civil marriage,House / apartment,-18289,365243,1,0,0,0,,2.0,-2,0
5059,5009143,M,Y,N,0,225000.0,Pensioner,Secondary / secondary special,Civil marriage,House / apartment,-18289,365243,1,0,0,0,,2.0,-3,0
5060,5009143,M,Y,N,0,225000.0,Pensioner,Secondary / secondary special,Civil marriage,House / apartment,-18289,365243,1,0,0,0,,2.0,-4,1
5061,5009143,M,Y,N,0,225000.0,Pensioner,Secondary / secondary special,Civil marriage,House / apartment,-18289,365243,1,0,0,0,,2.0,-5,0
5062,5009143,M,Y,N,0,225000.0,Pensioner,Secondary / secondary special,Civil marriage,House / apartment,-18289,365243,1,0,0,0,,2.0,-6,0
5063,5009143,M,Y,N,0,225000.0,Pensioner,Secondary / secondary special,Civil marriage,House / apartment,-18289,365243,1,0,0,0,,2.0,-7,0
5064,5009143,M,Y,N,0,225000.0,Pensioner,Secondary / secondary special,Civil marriage,House / apartment,-18289,365243,1,0,0,0,,2.0,-8,0
5065,5009143,M,Y,N,0,225000.0,Pensioner,Secondary / secondary special,Civil marriage,House / apartment,-18289,365243,1,0,0,0,,2.0,-9,0
5066,5009143,M,Y,N,0,225000.0,Pensioner,Secondary / secondary special,Civil marriage,House / apartment,-18289,365243,1,0,0,0,,2.0,-10,0
5067,5009143,M,Y,N,0,225000.0,Pensioner,Secondary / secondary special,Civil marriage,House / apartment,-18289,365243,1,0,0,0,,2.0,-11,0
5068,5009144,M,Y,N,0,225000.0,Pensioner,Secondary / secondary special,Civil marriage,House / apartment,-18289,365243,1,0,0,0,,2.0,-5,0
5069,5009144,M,Y,N,0,225000.0,Pensioner,Secondary / secondary special,Civil marriage,House / apartment,-18289,365243,1,0,0,0,,2.0,-6,0
5070,5009144,M,Y,N,0,225000.0,Pensioner,Secondary / secondary special,Civil marriage,House / apartment,-18289,365243,1,0,0,0,,2.0,-7,0
5071,5009144,M,Y,N,0,225000.0,Pensioner,Secondary / secondary special,Civil marriage,House / apartment,-18289,365243,1,0,0,0,,2.0,-8,0
5072,5009144,M,Y,N,0,225000.0,Pensioner,Secondary / secondary special,Civil marriage,House / apartment,-18289,365243,1,0,0,0,,2.0,-9,0
5073,5009144,M,Y,N,0,225000.0,Pensioner,Secondary / secondary special,Civil marriage,House / apartment,-18289,365243,1,0,0,0,,2.0,-10,0
5074,5009144,M,Y,N,0,225000.0,Pensioner,Secondary / secondary special,Civil marriage,House / apartment,-18289,365243,1,0,0,0,,2.0,-11,X
5075,5009144,M,Y,N,0,225000.0,Pensioner,Secondary / secondary special,Civil marriage,House / apartment,-18289,365243,1,0,0,0,,2.0,-12,X
5076,5009144,M,Y,N,0,225000.0,Pensioner,Secondary / secondary special,Civil marriage,House / apartment,-18289,365243,1,0,0,0,,2.0,-13,X
5077,5009144,M,Y,N,0,225000.0,Pensioner,Secondary / secondary special,Civil marriage,House / apartment,-18289,365243,1,0,0,0,,2.0,-14,X
5078,5009144,M,Y,N,0,225000.0,Pensioner,Secondary / secondary special,Civil marriage,House / apartment,-18289,365243,1,0,0,0,,2.0,-15,X
5079,5009145,M,Y,N,0,315000.0,Working,Higher education,Married,House / apartment,-15825,-3720,1,1,1,0,Managers,2.0,-1,C
5080,5009145,M,Y,N,0,315000.0,Working,Higher education,Married,House / apartment,-15825,-3720,1,1,1,0,Managers,2.0,-2,C
5081,5009145,M,Y,N,0,315000.0,Working,Higher education,Married,House / apartment,-15825,-3720,1,1,1,0,Managers,2.0,-3,C
5082,5009145,M,Y,N,0,315000.0,Working,Higher education,Married,House / apartment,-15825,-3720,1,1,1,0,Managers,2.0,-4,C
5083,5009145,M,Y,N,0,315000.0,Working,Higher education,Married,House / apartment,-15825,-3720,1,1,1,0,Managers,2.0,-5,C
5084,5009145,M,Y,N,0,315000.0,Working,Higher education,Married,House / apartment,-15825,-3720,1,1,1,0,Managers,2.0,-6,C
5085,5009145,M,Y,N,0,315000.0,Working,Higher education,Married,House / apartment,-15825,-3720,1,1,1,0,Managers,2.0,-7,C
5086,5009145,M,Y,N,0,315000.0,Working,Higher education,Married,House / apartment,-15825,-3720,1,1,1,0,Managers,2.0,-8,C
5087,5009145,M,Y,N,0,315000.0,Working,Higher education,Married,House / apartment,-15825,-3720,1,1,1,0,Managers,2.0,-9,C
5088,5009145,M,Y,N,0,315000.0,Working,Higher education,Married,House / apartment,-15825,-3720,1,1,1,0,Managers,2.0,-10,C
5089,5009145,M,Y,N,0,315000.0,Working,Higher education,Married,House / apartment,-15825,-3720,1,1,1,0,Managers,2.0,-11,C
5090,5009145,M,Y,N,0,315000.0,Working,Higher education,Married,House / apartment,-15825,-3720,1,1,1,0,Managers,2.0,-12,C
5091,5009145,M,Y,N,0,315000.0,Working,Higher education,Married,House / apartment,-15825,-3720,1,1,1,0,Managers,2.0,-13,C
5092,5009145,M,Y,N,0,315000.0,Working,Higher education,Married,House / apartment,-15825,-3720,1,1,1,0,Managers,2.0,-14,C
5093,5009145,M,Y,N,0,315000.0,Working,Higher education,Married,House / apartment,-15825,-3720,1,1,1,0,Managers,2.0,-15,C
5094,5009145,M,Y,N,0,315000.0,Working,Higher education,Married,House / apartment,-15825,-3720,1,1,1,0,Managers,2.0,-16,C
5095,5009145,M,Y,N,0,315000.0,Working,Higher education,Married,House / apartment,-15825,-3720,1,1,1,0,Managers,2.0,-17,C
5096,5009145,M,Y,N,0,315000.0,Working,Higher education,Married,House / apartment,-15825,-3720,1,1,1,0,Managers,2.0,-18,C
5097,5009145,M,Y,N,0,315000.0,Working,Higher education,Married,House / apartment,-15825,-3720,1,1,1,0,Managers,2.0,-19,C
5098,5009145,M,Y,N,0,315000.0,Working,Higher education,Married,House / apartment,-15825,-3720,1,1,1,0,Managers,2.0,-20,C
5099,5009145,M,Y,N,0,315000.0,Working,Higher education,Married,House / apartment,-15825,-3720,1,1,1,0,Managers,2.0,-21,C
5100,5009145,M,Y,N,0,315000.0,Working,Higher education,Married,House / apartment,-15825,-3720,1,1,1,0,Managers,2.0,-22,C
5101,5009145,M,Y,N,0,315000.0,Working,Higher education,Married,House / apartment,-15825,-3720,1,1,1,0,Managers,2.0,-23,C
5102,5009145,M,Y,N,0,315000.0,Working,Higher education,Married,House / apartment,-15825,-3720,1,1,1,0,Managers,2.0,-24,C
5103,5009145,M,Y,N,0,315000.0,Working,Higher education,Married,House / apartment,-15825,-3720,1,1,1,0,Managers,2.0,-25,C
5104,5009145,M,Y,N,0,315000.0,Working,Higher education,Married,House / apartment,-15825,-3720,1,1,1,0,Managers,2.0,-26,C
5105,5009145,M,Y,N,0,315000.0,Working,Higher education,Married,House / apartment,-15825,-3720,1,1,1,0,Managers,2.0,-27,C
5106,5009145,M,Y,N,0,315000.0,Working,Higher education,Married,House / apartment,-15825,-3720,1,1,1,0,Managers,2.0,-28,C
5107,5009145,M,Y,N,0,315000.0,Working,Higher education,Married,House / apartment,-15825,-3720,1,1,1,0,Managers,2.0,-29,C
5108,5009145,M,Y,N,0,315000.0,Working,Higher education,Married,House / apartment,-15825,-3720,1,1,1,0,Managers,2.0,-30,C
5109,5009145,M,Y,N,0,315000.0,Working,Higher education,Married,House / apartment,-15825,-3720,1,1,1,0,Managers,2.0,-31,C
5110,5009145,M,Y,N,0,315000.0,Working,Higher education,Married,House / apartment,-15825,-3720,1,1,1,0,Managers,2.0,-32,C
5111,5009145,M,Y,N,0,315000.0,Working,Higher education,Married,House / apartment,-15825,-3720,1,1,1,0,Managers,2.0,-33,0
5112,5009145,M,Y,N,0,315000.0,Working,Higher education,Married,House / apartment,-15825,-3720,1,1,1,0,Managers,2.0,-34,0
5113,5009145,M,Y,N,0,315000.0,Working,Higher education,Married,House / apartment,-15825,-3720,1,1,1,0,Managers,2.0,-35,0
5114,5009145,M,Y,N,0,315000.0,Working,Higher education,Married,House / apartment,-15825,-3720,1,1,1,0,Managers,2.0,-36,0
5115,5009146,M,Y,N,0,315000.0,Working,Higher education,Married,House / apartment,-15825,-3720,1,1,1,0,Managers,2.0,-11,C
5116,5009146,M,Y,N,0,315000.0,Working,Higher education,Married,House / apartment,-15825,-3720,1,1,1,0,Managers,2.0,-12,C
5117,5009146,M,Y,N,0,315000.0,Working,Higher education,Married,House / apartment,-15825,-3720,1,1,1,0,Managers,2.0,-13,C
5118,5009146,M,Y,N,0,315000.0,Working,Higher education,Married,House / apartment,-15825,-3720,1,1,1,0,Managers,2.0,-14,C
5119,5009146,M,Y,N,0,315000.0,Working,Higher education,Married,House / apartment,-15825,-3720,1,1,1,0,Managers,2.0,-15,C
5120,5009146,M,Y,N,0,315000.0,Working,Higher education,Married,House / apartment,-15825,-3720,1,1,1,0,Managers,2.0,-16,C
5121,5009146,M,Y,N,0,315000.0,Working,Higher education,Married,House / apartment,-15825,-3720,1,1,1,0,Managers,2.0,-17,C
5122,5009146,M,Y,N,0,315000.0,Working,Higher education,Married,House / apartment,-15825,-3720,1,1,1,0,Managers,2.0,-18,C
5123,5009146,M,Y,N,0,315000.0,Working,Higher education,Married,House / apartment,-15825,-3720,1,1,1,0,Managers,2.0,-19,C
5124,5009146,M,Y,N,0,315000.0,Working,Higher education,Married,House / apartment,-15825,-3720,1,1,1,0,Managers,2.0,-20,C
5125,5009146,M,Y,N,0,315000.0,Working,Higher education,Married,House / apartment,-15825,-3720,1,1,1,0,Managers,2.0,-21,C
5126,5009146,M,Y,N,0,315000.0,Working,Higher education,Married,House / apartment,-15825,-3720,1,1,1,0,Managers,2.0,-22,C
5127,5009146,M,Y,N,0,315000.0,Working,Higher education,Married,House / apartment,-15825,-3720,1,1,1,0,Managers,2.0,-23,C
5128,5009146,M,Y,N,0,315000.0,Working,Higher education,Married,House / apartment,-15825,-3720,1,1,1,0,Managers,2.0,-24,C
5129,5009146,M,Y,N,0,315000.0,Working,Higher education,Married,House / apartment,-15825,-3720,1,1,1,0,Managers,2.0,-25,C
5130,5009146,M,Y,N,0,315000.0,Working,Higher education,Married,House / apartment,-15825,-3720,1,1,1,0,Managers,2.0,-26,C
5131,5009146,M,Y,N,0,315000.0,Working,Higher education,Married,House / apartment,-15825,-3720,1,1,1,0,Managers,2.0,-27,C
5132,5009146,M,Y,N,0,315000.0,Working,Higher education,Married,House / apartment,-15825,-3720,1,1,1,0,Managers,2.0,-28,C
5133,5009146,M,Y,N,0,315000.0,Working,Higher education,Married,House / apartment,-15825,-3720,1,1,1,0,Managers,2.0,-29,C
5134,5009146,M,Y,N,0,315000.0,Working,Higher education,Married,House / apartment,-15825,-3720,1,1,1,0,Managers,2.0,-30,C
5135,5009146,M,Y,N,0,315000.0,Working,Higher education,Married,House / apartment,-15825,-3720,1,1,1,0,Managers,2.0,-31,C
5136,5009146,M,Y,N,0,315000.0,Working,Higher education,Married,House / apartment,-15825,-3720,1,1,1,0,Managers,2.0,-32,C
5137,5009146,M,Y,N,0,315000.0,Working,Higher education,Married,House / apartment,-15825,-3720,1,1,1,0,Managers,2.0,-33,0
5138,5009146,M,Y,N,0,315000.0,Working,Higher education,Married,House / apartment,-15825,-3720,1,1,1,0,Managers,2.0,-34,1
5139,5009146,M,Y,N,0,315000.0,Working,Higher education,Married,House / apartment,-15825,-3720,1,1,1,0,Managers,2.0,-35,0
5140,5009146,M,Y,N,0,315000.0,Working,Higher education,Married,House / apartment,-15825,-3720,1,1,1,0,Managers,2.0,-36,0
5141,5009147,M,Y,N,0,315000.0,Working,Higher education,Married,House / apartment,-15825,-3720,1,1,1,0,Managers,2.0,0,C
5142,5009147,M,Y,N,0,315000.0,Working,Higher education,Married,House / apartment,-15825,-3720,1,1,1,0,Managers,2.0,-1,C
5143,5009147,M,Y,N,0,315000.0,Working,Higher education,Married,House / apartment,-15825,-3720,1,1,1,0,Managers,2.0,-2,C
5144,5009147,M,Y,N,0,315000.0,Working,Higher education,Married,House / apartment,-15825,-3720,1,1,1,0,Managers,2.0,-3,C
5145,5009147,M,Y,N,0,315000.0,Working,Higher education,Married,House / apartment,-15825,-3720,1,1,1,0,Managers,2.0,-4,C
5146,5009147,M,Y,N,0,315000.0,Working,Higher education,Married,House / apartment,-15825,-3720,1,1,1,0,Managers,2.0,-5,C
5147,5009147,M,Y,N,0,315000.0,Working,Higher education,Married,House / apartment,-15825,-3720,1,1,1,0,Managers,2.0,-6,C
5148,5009147,M,Y,N,0,315000.0,Working,Higher education,Married,House / apartment,-15825,-3720,1,1,1,0,Managers,2.0,-7,C
5149,5009147,M,Y,N,0,315000.0,Working,Higher education,Married,House / apartment,-15825,-3720,1,1,1,0,Managers,2.0,-8,0
5150,5009147,M,Y,N,0,315000.0,Working,Higher education,Married,House / apartment,-15825,-3720,1,1,1,0,Managers,2.0,-9,0
5151,5009147,M,Y,N,0,315000.0,Working,Higher education,Married,House / apartment,-15825,-3720,1,1,1,0,Managers,2.0,-10,0
5152,5009147,M,Y,N,0,315000.0,Working,Higher education,Married,House / apartment,-15825,-3720,1,1,1,0,Managers,2.0,-11,0
5153,5009147,M,Y,N,0,315000.0,Working,Higher education,Married,House / apartment,-15825,-3720,1,1,1,0,Managers,2.0,-12,0
5154,5009149,M,Y,N,0,315000.0,Working,Higher education,Married,House / apartment,-15825,-3720,1,1,1,0,Managers,2.0,0,C
5155,5009149,M,Y,N,0,315000.0,Working,Higher education,Married,House / apartment,-15825,-3720,1,1,1,0,Managers,2.0,-1,C
5156,5009149,M,Y,N,0,315000.0,Working,Higher education,Married,House / apartment,-15825,-3720,1,1,1,0,Managers,2.0,-2,C
5157,5009149,M,Y,N,0,315000.0,Working,Higher education,Married,House / apartment,-15825,-3720,1,1,1,0,Managers,2.0,-3,0
5158,5009149,M,Y,N,0,315000.0,Working,Higher education,Married,House / apartment,-15825,-3720,1,1,1,0,Managers,2.0,-4,0
5159,5009149,M,Y,N,0,315000.0,Working,Higher education,Married,House / apartment,-15825,-3720,1,1,1,0,Managers,2.0,-5,0
5160,5009149,M,Y,N,0,315000.0,Working,Higher education,Married,House / apartment,-15825,-3720,1,1,1,0,Managers,2.0,-6,0
5161,5009149,M,Y,N,0,315000.0,Working,Higher education,Married,House / apartment,-15825,-3720,1,1,1,0,Managers,2.0,-7,0
5162,5009150,M,Y,N,0,315000.0,Working,Higher education,Married,House / apartment,-15825,-3720,1,1,1,0,Managers,2.0,0,C
5163,5009150,M,Y,N,0,315000.0,Working,Higher education,Married,House / apartment,-15825,-3720,1,1,1,0,Managers,2.0,-1,C
5164,5009150,M,Y,N,0,315000.0,Working,Higher education,Married,House / apartment,-15825,-3720,1,1,1,0,Managers,2.0,-2,C
5165,5009150,M,Y,N,0,315000.0,Working,Higher education,Married,House / apartment,-15825,-3720,1,1,1,0,Managers,2.0,-3,C
5166,5009150,M,Y,N,0,315000.0,Working,Higher education,Married,House / apartment,-15825,-3720,1,1,1,0,Managers,2.0,-4,C
5167,5009150,M,Y,N,0,315000.0,Working,Higher education,Married,House / apartment,-15825,-3720,1,1,1,0,Managers,2.0,-5,C
5168,5009150,M,Y,N,0,315000.0,Working,Higher education,Married,House / apartment,-15825,-3720,1,1,1,0,Managers,2.0,-6,C
5169,5009150,M,Y,N,0,315000.0,Working,Higher education,Married,House / apartment,-15825,-3720,1,1,1,0,Managers,2.0,-7,C
5170,5009150,M,Y,N,0,315000.0,Working,Higher education,Married,House / apartment,-15825,-3720,1,1,1,0,Managers,2.0,-8,C
5171,5009150,M,Y,N,0,315000.0,Working,Higher education,Married,House / apartment,-15825,-3720,1,1,1,0,Managers,2.0,-9,C
5172,5009150,M,Y,N,0,315000.0,Working,Higher education,Married,House / apartment,-15825,-3720,1,1,1,0,Managers,2.0,-10,C
5173,5009150,M,Y,N,0,315000.0,Working,Higher education,Married,House / apartment,-15825,-3720,1,1,1,0,Managers,2.0,-11,C
5174,5009150,M,Y,N,0,315000.0,Working,Higher education,Married,House / apartment,-15825,-3720,1,1,1,0,Managers,2.0,-12,C
5175,5009150,M,Y,N,0,315000.0,Working,Higher education,Married,House / apartment,-15825,-3720,1,1,1,0,Managers,2.0,-13,C
5176,5009150,M,Y,N,0,315000.0,Working,Higher education,Married,House / apartment,-15825,-3720,1,1,1,0,Managers,2.0,-14,0
5177,5009150,M,Y,N,0,315000.0,Working,Higher education,Married,House / apartment,-15825,-3720,1,1,1,0,Managers,2.0,-15,1
5178,5009150,M,Y,N,0,315000.0,Working,Higher education,Married,House / apartment,-15825,-3720,1,1,1,0,Managers,2.0,-16,0
5179,5009150,M,Y,N,0,315000.0,Working,Higher education,Married,House / apartment,-15825,-3720,1,1,1,0,Managers,2.0,-17,0
5180,5009151,F,N,N,0,180000.0,Working,Secondary / secondary special,Married,House / apartment,-19575,-2901,1,0,0,0,Sales staff,2.0,0,C
5181,5009151,F,N,N,0,180000.0,Working,Secondary / secondary special,Married,House / apartment,-19575,-2901,1,0,0,0,Sales staff,2.0,-1,C
5182,5009151,F,N,N,0,180000.0,Working,Secondary / secondary special,Married,House / apartment,-19575,-2901,1,0,0,0,Sales staff,2.0,-2,C
5183,5009151,F,N,N,0,180000.0,Working,Secondary / secondary special,Married,House / apartment,-19575,-2901,1,0,0,0,Sales staff,2.0,-3,C
5184,5009151,F,N,N,0,180000.0,Working,Secondary / secondary special,Married,House / apartment,-19575,-2901,1,0,0,0,Sales staff,2.0,-4,C
5185,5009151,F,N,N,0,180000.0,Working,Secondary / secondary special,Married,House / apartment,-19575,-2901,1,0,0,0,Sales staff,2.0,-5,C
5186,5009151,F,N,N,0,180000.0,Working,Secondary / secondary special,Married,House / apartment,-19575,-2901,1,0,0,0,Sales staff,2.0,-6,C
5187,5009151,F,N,N,0,180000.0,Working,Secondary / secondary special,Married,House / apartment,-19575,-2901,1,0,0,0,Sales staff,2.0,-7,C
5188,5009151,F,N,N,0,180000.0,Working,Secondary / secondary special,Married,House / apartment,-19575,-2901,1,0,0,0,Sales staff,2.0,-8,C
5189,5009151,F,N,N,0,180000.0,Working,Secondary / secondary special,Married,House / apartment,-19575,-2901,1,0,0,0,Sales staff,2.0,-9,C
5190,5009151,F,N,N,0,180000.0,Working,Secondary / secondary special,Married,House / apartment,-19575,-2901,1,0,0,0,Sales staff,2.0,-10,C
5191,5009151,F,N,N,0,180000.0,Working,Secondary / secondary special,Married,House / apartment,-19575,-2901,1,0,0,0,Sales staff,2.0,-11,C
5192,5009151,F,N,N,0,180000.0,Working,Secondary / secondary special,Married,House / apartment,-19575,-2901,1,0,0,0,Sales staff,2.0,-12,C
5193,5009151,F,N,N,0,180000.0,Working,Secondary / secondary special,Married,House / apartment,-19575,-2901,1,0,0,0,Sales staff,2.0,-13,C
5194,5009151,F,N,N,0,180000.0,Working,Secondary / secondary special,Married,House / apartment,-19575,-2901,1,0,0,0,Sales staff,2.0,-14,C
5195,5009151,F,N,N,0,180000.0,Working,Secondary / secondary special,Married,House / apartment,-19575,-2901,1,0,0,0,Sales staff,2.0,-15,C
5196,5009151,F,N,N,0,180000.0,Working,Secondary / secondary special,Married,House / apartment,-19575,-2901,1,0,0,0,Sales staff,2.0,-16,C
5197,5009151,F,N,N,0,180000.0,Working,Secondary / secondary special,Married,House / apartment,-19575,-2901,1,0,0,0,Sales staff,2.0,-17,C
5198,5009151,F,N,N,0,180000.0,Working,Secondary / secondary special,Married,House / apartment,-19575,-2901,1,0,0,0,Sales staff,2.0,-18,C
5199,5009151,F,N,N,0,180000.0,Working,Secondary / secondary special,Married,House / apartment,-19575,-2901,1,0,0,0,Sales staff,2.0,-19,C
5200,5009151,F,N,N,0,180000.0,Working,Secondary / secondary special,Married,House / apartment,-19575,-2901,1,0,0,0,Sales staff,2.0,-20,C
5201,5009151,F,N,N,0,180000.0,Working,Secondary / secondary special,Married,House / apartment,-19575,-2901,1,0,0,0,Sales staff,2.0,-21,C
5202,5009151,F,N,N,0,180000.0,Working,Secondary / secondary special,Married,House / apartment,-19575,-2901,1,0,0,0,Sales staff,2.0,-22,C
5203,5009151,F,N,N,0,180000.0,Working,Secondary / secondary special,Married,House / apartment,-19575,-2901,1,0,0,0,Sales staff,2.0,-23,C
5204,5009151,F,N,N,0,180000.0,Working,Secondary / secondary special,Married,House / apartment,-19575,-2901,1,0,0,0,Sales staff,2.0,-24,C
5205,5009151,F,N,N,0,180000.0,Working,Secondary / secondary special,Married,House / apartment,-19575,-2901,1,0,0,0,Sales staff,2.0,-25,X
5206,5009151,F,N,N,0,180000.0,Working,Secondary / secondary special,Married,House / apartment,-19575,-2901,1,0,0,0,Sales staff,2.0,-26,0
5207,5009151,F,N,N,0,180000.0,Working,Secondary / secondary special,Married,House / apartment,-19575,-2901,1,0,0,0,Sales staff,2.0,-27,0
5208,5009151,F,N,N,0,180000.0,Working,Secondary / secondary special,Married,House / apartment,-19575,-2901,1,0,0,0,Sales staff,2.0,-28,0
5209,5009151,F,N,N,0,180000.0,Working,Secondary / secondary special,Married,House / apartment,-19575,-2901,1,0,0,0,Sales staff,2.0,-29,0
5210,5009152,F,N,N,0,180000.0,Working,Secondary / secondary special,Married,House / apartment,-19575,-2901,1,0,0,0,Sales staff,2.0,0,C
5211,5009152,F,N,N,0,180000.0,Working,Secondary / secondary special,Married,House / apartment,-19575,-2901,1,0,0,0,Sales staff,2.0,-1,C
5212,5009152,F,N,N,0,180000.0,Working,Secondary / secondary special,Married,House / apartment,-19575,-2901,1,0,0,0,Sales staff,2.0,-2,C
5213,5009152,F,N,N,0,180000.0,Working,Secondary / secondary special,Married,House / apartment,-19575,-2901,1,0,0,0,Sales staff,2.0,-3,C
5214,5009152,F,N,N,0,180000.0,Working,Secondary / secondary special,Married,House / apartment,-19575,-2901,1,0,0,0,Sales staff,2.0,-4,C
5215,5009152,F,N,N,0,180000.0,Working,Secondary / secondary special,Married,House / apartment,-19575,-2901,1,0,0,0,Sales staff,2.0,-5,C
5216,5009152,F,N,N,0,180000.0,Working,Secondary / secondary special,Married,House / apartment,-19575,-2901,1,0,0,0,Sales staff,2.0,-6,C
5217,5009152,F,N,N,0,180000.0,Working,Secondary / secondary special,Married,House / apartment,-19575,-2901,1,0,0,0,Sales staff,2.0,-7,C
5218,5009152,F,N,N,0,180000.0,Working,Secondary / secondary special,Married,House / apartment,-19575,-2901,1,0,0,0,Sales staff,2.0,-8,C
5219,5009152,F,N,N,0,180000.0,Working,Secondary / secondary special,Married,House / apartment,-19575,-2901,1,0,0,0,Sales staff,2.0,-9,C
5220,5009152,F,N,N,0,180000.0,Working,Secondary / secondary special,Married,House / apartment,-19575,-2901,1,0,0,0,Sales staff,2.0,-10,C
5221,5009152,F,N,N,0,180000.0,Working,Secondary / secondary special,Married,House / apartment,-19575,-2901,1,0,0,0,Sales staff,2.0,-11,C
5222,5009152,F,N,N,0,180000.0,Working,Secondary / secondary special,Married,House / apartment,-19575,-2901,1,0,0,0,Sales staff,2.0,-12,C
5223,5009152,F,N,N,0,180000.0,Working,Secondary / secondary special,Married,House / apartment,-19575,-2901,1,0,0,0,Sales staff,2.0,-13,C
5224,5009152,F,N,N,0,180000.0,Working,Secondary / secondary special,Married,House / apartment,-19575,-2901,1,0,0,0,Sales staff,2.0,-14,C
5225,5009152,F,N,N,0,180000.0,Working,Secondary / secondary special,Married,House / apartment,-19575,-2901,1,0,0,0,Sales staff,2.0,-15,C
5226,5009152,F,N,N,0,180000.0,Working,Secondary / secondary special,Married,House / apartment,-19575,-2901,1,0,0,0,Sales staff,2.0,-16,C
5227,5009152,F,N,N,0,180000.0,Working,Secondary / secondary special,Married,House / apartment,-19575,-2901,1,0,0,0,Sales staff,2.0,-17,C
5228,5009152,F,N,N,0,180000.0,Working,Secondary / secondary special,Married,House / apartment,-19575,-2901,1,0,0,0,Sales staff,2.0,-18,C
5229,5009152,F,N,N,0,180000.0,Working,Secondary / secondary special,Married,House / apartment,-19575,-2901,1,0,0,0,Sales staff,2.0,-19,C
5230,5009152,F,N,N,0,180000.0,Working,Secondary / secondary special,Married,House / apartment,-19575,-2901,1,0,0,0,Sales staff,2.0,-20,C
5231,5009152,F,N,N,0,180000.0,Working,Secondary / secondary special,Married,House / apartment,-19575,-2901,1,0,0,0,Sales staff,2.0,-21,C
5232,5009152,F,N,N,0,180000.0,Working,Secondary / secondary special,Married,House / apartment,-19575,-2901,1,0,0,0,Sales staff,2.0,-22,C
5233,5009152,F,N,N,0,180000.0,Working,Secondary / secondary special,Married,House / apartment,-19575,-2901,1,0,0,0,Sales staff,2.0,-23,C
5234,5009152,F,N,N,0,180000.0,Working,Secondary / secondary special,Married,House / apartment,-19575,-2901,1,0,0,0,Sales staff,2.0,-24,C
5235,5009152,F,N,N,0,180000.0,Working,Secondary / secondary special,Married,House / apartment,-19575,-2901,1,0,0,0,Sales staff,2.0,-25,C
5236,5009152,F,N,N,0,180000.0,Working,Secondary / secondary special,Married,House / apartment,-19575,-2901,1,0,0,0,Sales staff,2.0,-26,C
5237,5009152,F,N,N,0,180000.0,Working,Secondary / secondary special,Married,House / apartment,-19575,-2901,1,0,0,0,Sales staff,2.0,-27,C
5238,5009152,F,N,N,0,180000.0,Working,Secondary / secondary special,Married,House / apartment,-19575,-2901,1,0,0,0,Sales staff,2.0,-28,C
5239,5009152,F,N,N,0,180000.0,Working,Secondary / secondary special,Married,House / apartment,-19575,-2901,1,0,0,0,Sales staff,2.0,-29,C
5240,5009152,F,N,N,0,180000.0,Working,Secondary / secondary special,Married,House / apartment,-19575,-2901,1,0,0,0,Sales staff,2.0,-30,C
5241,5009152,F,N,N,0,180000.0,Working,Secondary / secondary special,Married,House / apartment,-19575,-2901,1,0,0,0,Sales staff,2.0,-31,C
5242,5009152,F,N,N,0,180000.0,Working,Secondary / secondary special,Married,House / apartment,-19575,-2901,1,0,0,0,Sales staff,2.0,-32,C
5243,5009152,F,N,N,0,180000.0,Working,Secondary / secondary special,Married,House / apartment,-19575,-2901,1,0,0,0,Sales staff,2.0,-33,C
5244,5009152,F,N,N,0,180000.0,Working,Secondary / secondary special,Married,House / apartment,-19575,-2901,1,0,0,0,Sales staff,2.0,-34,C
5245,5009152,F,N,N,0,180000.0,Working,Secondary / secondary special,Married,House / apartment,-19575,-2901,1,0,0,0,Sales staff,2.0,-35,C
5246,5009152,F,N,N,0,180000.0,Working,Secondary / secondary special,Married,House / apartment,-19575,-2901,1,0,0,0,Sales staff,2.0,-36,C
5247,5009152,F,N,N,0,180000.0,Working,Secondary / secondary special,Married,House / apartment,-19575,-2901,1,0,0,0,Sales staff,2.0,-37,C
5248,5009152,F,N,N,0,180000.0,Working,Secondary / secondary special,Married,House / apartment,-19575,-2901,1,0,0,0,Sales staff,2.0,-38,C
5249,5009152,F,N,N,0,180000.0,Working,Secondary / secondary special,Married,House / apartment,-19575,-2901,1,0,0,0,Sales staff,2.0,-39,C
5250,5009152,F,N,N,0,180000.0,Working,Secondary / secondary special,Married,House / apartment,-19575,-2901,1,0,0,0,Sales staff,2.0,-40,C
5251,5009152,F,N,N,0,180000.0,Working,Secondary / secondary special,Married,House / apartment,-19575,-2901,1,0,0,0,Sales staff,2.0,-41,C
5252,5009152,F,N,N,0,180000.0,Working,Secondary / secondary special,Married,House / apartment,-19575,-2901,1,0,0,0,Sales staff,2.0,-42,C
5253,5009152,F,N,N,0,180000.0,Working,Secondary / secondary special,Married,House / apartment,-19575,-2901,1,0,0,0,Sales staff,2.0,-43,X
5254,5009152,F,N,N,0,180000.0,Working,Secondary / secondary special,Married,House / apartment,-19575,-2901,1,0,0,0,Sales staff,2.0,-44,0
5255,5009152,F,N,N,0,180000.0,Working,Secondary / secondary special,Married,House / apartment,-19575,-2901,1,0,0,0,Sales staff,2.0,-45,0
5256,5009152,F,N,N,0,180000.0,Working,Secondary / secondary special,Married,House / apartment,-19575,-2901,1,0,0,0,Sales staff,2.0,-46,0
5257,5009152,F,N,N,0,180000.0,Working,Secondary / secondary special,Married,House / apartment,-19575,-2901,1,0,0,0,Sales staff,2.0,-47,0
5258,5009153,F,N,N,0,180000.0,Working,Secondary / secondary special,Married,House / apartment,-19575,-2901,1,0,0,0,Sales staff,2.0,-6,C
5259,5009153,F,N,N,0,180000.0,Working,Secondary / secondary special,Married,House / apartment,-19575,-2901,1,0,0,0,Sales staff,2.0,-7,C
5260,5009153,F,N,N,0,180000.0,Working,Secondary / secondary special,Married,House / apartment,-19575,-2901,1,0,0,0,Sales staff,2.0,-8,C
5261,5009153,F,N,N,0,180000.0,Working,Secondary / secondary special,Married,House / apartment,-19575,-2901,1,0,0,0,Sales staff,2.0,-9,C
5262,5009153,F,N,N,0,180000.0,Working,Secondary / secondary special,Married,House / apartment,-19575,-2901,1,0,0,0,Sales staff,2.0,-10,C
5263,5009153,F,N,N,0,180000.0,Working,Secondary / secondary special,Married,House / apartment,-19575,-2901,1,0,0,0,Sales staff,2.0,-11,C
5264,5009153,F,N,N,0,180000.0,Working,Secondary / secondary special,Married,House / apartment,-19575,-2901,1,0,0,0,Sales staff,2.0,-12,C
5265,5009153,F,N,N,0,180000.0,Working,Secondary / secondary special,Married,House / apartment,-19575,-2901,1,0,0,0,Sales staff,2.0,-13,C
5266,5009153,F,N,N,0,180000.0,Working,Secondary / secondary special,Married,House / apartment,-19575,-2901,1,0,0,0,Sales staff,2.0,-14,C
5267,5009153,F,N,N,0,180000.0,Working,Secondary / secondary special,Married,House / apartment,-19575,-2901,1,0,0,0,Sales staff,2.0,-15,C
5268,5009153,F,N,N,0,180000.0,Working,Secondary / secondary special,Married,House / apartment,-19575,-2901,1,0,0,0,Sales staff,2.0,-16,C
5269,5009153,F,N,N,0,180000.0,Working,Secondary / secondary special,Married,House / apartment,-19575,-2901,1,0,0,0,Sales staff,2.0,-17,C
5270,5009153,F,N,N,0,180000.0,Working,Secondary / secondary special,Married,House / apartment,-19575,-2901,1,0,0,0,Sales staff,2.0,-18,C
5271,5009153,F,N,N,0,180000.0,Working,Secondary / secondary special,Married,House / apartment,-19575,-2901,1,0,0,0,Sales staff,2.0,-19,C
5272,5009153,F,N,N,0,180000.0,Working,Secondary / secondary special,Married,House / apartment,-19575,-2901,1,0,0,0,Sales staff,2.0,-20,C
5273,5009153,F,N,N,0,180000.0,Working,Secondary / secondary special,Married,House / apartment,-19575,-2901,1,0,0,0,Sales staff,2.0,-21,C
5274,5009153,F,N,N,0,180000.0,Working,Secondary / secondary special,Married,House / apartment,-19575,-2901,1,0,0,0,Sales staff,2.0,-22,C
5275,5009153,F,N,N,0,180000.0,Working,Secondary / secondary special,Married,House / apartment,-19575,-2901,1,0,0,0,Sales staff,2.0,-23,C
5276,5009153,F,N,N,0,180000.0,Working,Secondary / secondary special,Married,House / apartment,-19575,-2901,1,0,0,0,Sales staff,2.0,-24,C
5277,5009153,F,N,N,0,180000.0,Working,Secondary / secondary special,Married,House / apartment,-19575,-2901,1,0,0,0,Sales staff,2.0,-25,C
5278,5009153,F,N,N,0,180000.0,Working,Secondary / secondary special,Married,House / apartment,-19575,-2901,1,0,0,0,Sales staff,2.0,-26,C
5279,5009153,F,N,N,0,180000.0,Working,Secondary / secondary special,Married,House / apartment,-19575,-2901,1,0,0,0,Sales staff,2.0,-27,C
5280,5009153,F,N,N,0,180000.0,Working,Secondary / secondary special,Married,House / apartment,-19575,-2901,1,0,0,0,Sales staff,2.0,-28,C
5281,5009153,F,N,N,0,180000.0,Working,Secondary / secondary special,Married,House / apartment,-19575,-2901,1,0,0,0,Sales staff,2.0,-29,C
5282,5009153,F,N,N,0,180000.0,Working,Secondary / secondary special,Married,House / apartment,-19575,-2901,1,0,0,0,Sales staff,2.0,-30,C
5283,5009153,F,N,N,0,180000.0,Working,Secondary / secondary special,Married,House / apartment,-19575,-2901,1,0,0,0,Sales staff,2.0,-31,C
5284,5009153,F,N,N,0,180000.0,Working,Secondary / secondary special,Married,House / apartment,-19575,-2901,1,0,0,0,Sales staff,2.0,-32,C
5285,5009153,F,N,N,0,180000.0,Working,Secondary / secondary special,Married,House / apartment,-19575,-2901,1,0,0,0,Sales staff,2.0,-33,C
5286,5009153,F,N,N,0,180000.0,Working,Secondary / secondary special,Married,House / apartment,-19575,-2901,1,0,0,0,Sales staff,2.0,-34,C
5287,5009153,F,N,N,0,180000.0,Working,Secondary / secondary special,Married,House / apartment,-19575,-2901,1,0,0,0,Sales staff,2.0,-35,C
5288,5009153,F,N,N,0,180000.0,Working,Secondary / secondary special,Married,House / apartment,-19575,-2901,1,0,0,0,Sales staff,2.0,-36,C
5289,5009153,F,N,N,0,180000.0,Working,Secondary / secondary special,Married,House / apartment,-19575,-2901,1,0,0,0,Sales staff,2.0,-37,C
5290,5009153,F,N,N,0,180000.0,Working,Secondary / secondary special,Married,House / apartment,-19575,-2901,1,0,0,0,Sales staff,2.0,-38,C
5291,5009153,F,N,N,0,180000.0,Working,Secondary / secondary special,Married,House / apartment,-19575,-2901,1,0,0,0,Sales staff,2.0,-39,C
5292,5009153,F,N,N,0,180000.0,Working,Secondary / secondary special,Married,House / apartment,-19575,-2901,1,0,0,0,Sales staff,2.0,-40,C
5293,5009153,F,N,N,0,180000.0,Working,Secondary / secondary special,Married,House / apartment,-19575,-2901,1,0,0,0,Sales staff,2.0,-41,C
5294,5009153,F,N,N,0,180000.0,Working,Secondary / secondary special,Married,House / apartment,-19575,-2901,1,0,0,0,Sales staff,2.0,-42,C
5295,5009153,F,N,N,0,180000.0,Working,Secondary / secondary special,Married,House / apartment,-19575,-2901,1,0,0,0,Sales staff,2.0,-43,C
5296,5009153,F,N,N,0,180000.0,Working,Secondary / secondary special,Married,House / apartment,-19575,-2901,1,0,0,0,Sales staff,2.0,-44,C
5297,5009153,F,N,N,0,180000.0,Working,Secondary / secondary special,Married,House / apartment,-19575,-2901,1,0,0,0,Sales staff,2.0,-45,C
5298,5009153,F,N,N,0,180000.0,Working,Secondary / secondary special,Married,House / apartment,-19575,-2901,1,0,0,0,Sales staff,2.0,-46,C
5299,5009153,F,N,N,0,180000.0,Working,Secondary / secondary special,Married,House / apartment,-19575,-2901,1,0,0,0,Sales staff,2.0,-47,C
5300,5009153,F,N,N,0,180000.0,Working,Secondary / secondary special,Married,House / apartment,-19575,-2901,1,0,0,0,Sales staff,2.0,-48,C
5301,5009153,F,N,N,0,180000.0,Working,Secondary / secondary special,Married,House / apartment,-19575,-2901,1,0,0,0,Sales staff,2.0,-49,X
5302,5009153,F,N,N,0,180000.0,Working,Secondary / secondary special,Married,House / apartment,-19575,-2901,1,0,0,0,Sales staff,2.0,-50,0
5303,5009153,F,N,N,0,180000.0,Working,Secondary / secondary special,Married,House / apartment,-19575,-2901,1,0,0,0,Sales staff,2.0,-51,0
5304,5009153,F,N,N,0,180000.0,Working,Secondary / secondary special,Married,House / apartment,-19575,-2901,1,0,0,0,Sales staff,2.0,-52,0
5305,5009153,F,N,N,0,180000.0,Working,Secondary / secondary special,Married,House / apartment,-19575,-2901,1,0,0,0,Sales staff,2.0,-53,0
5306,5009154,F,N,N,0,180000.0,Working,Secondary / secondary special,Married,House / apartment,-19575,-2901,1,0,0,0,Sales staff,2.0,0,C
5307,5009154,F,N,N,0,180000.0,Working,Secondary / secondary special,Married,House / apartment,-19575,-2901,1,0,0,0,Sales staff,2.0,-1,C
5308,5009154,F,N,N,0,180000.0,Working,Secondary / secondary special,Married,House / apartment,-19575,-2901,1,0,0,0,Sales staff,2.0,-2,C
5309,5009154,F,N,N,0,180000.0,Working,Secondary / secondary special,Married,House / apartment,-19575,-2901,1,0,0,0,Sales staff,2.0,-3,C
5310,5009154,F,N,N,0,180000.0,Working,Secondary / secondary special,Married,House / apartment,-19575,-2901,1,0,0,0,Sales staff,2.0,-4,C
5311,5009154,F,N,N,0,180000.0,Working,Secondary / secondary special,Married,House / apartment,-19575,-2901,1,0,0,0,Sales staff,2.0,-5,C
5312,5009154,F,N,N,0,180000.0,Working,Secondary / secondary special,Married,House / apartment,-19575,-2901,1,0,0,0,Sales staff,2.0,-6,C
5313,5009154,F,N,N,0,180000.0,Working,Secondary / secondary special,Married,House / apartment,-19575,-2901,1,0,0,0,Sales staff,2.0,-7,C
5314,5009154,F,N,N,0,180000.0,Working,Secondary / secondary special,Married,House / apartment,-19575,-2901,1,0,0,0,Sales staff,2.0,-8,C
5315,5009154,F,N,N,0,180000.0,Working,Secondary / secondary special,Married,House / apartment,-19575,-2901,1,0,0,0,Sales staff,2.0,-9,C
5316,5009154,F,N,N,0,180000.0,Working,Secondary / secondary special,Married,House / apartment,-19575,-2901,1,0,0,0,Sales staff,2.0,-10,C
5317,5009154,F,N,N,0,180000.0,Working,Secondary / secondary special,Married,House / apartment,-19575,-2901,1,0,0,0,Sales staff,2.0,-11,C
5318,5009154,F,N,N,0,180000.0,Working,Secondary / secondary special,Married,House / apartment,-19575,-2901,1,0,0,0,Sales staff,2.0,-12,C
5319,5009154,F,N,N,0,180000.0,Working,Secondary / secondary special,Married,House / apartment,-19575,-2901,1,0,0,0,Sales staff,2.0,-13,C
5320,5009154,F,N,N,0,180000.0,Working,Secondary / secondary special,Married,House / apartment,-19575,-2901,1,0,0,0,Sales staff,2.0,-14,C
5321,5009154,F,N,N,0,180000.0,Working,Secondary / secondary special,Married,House / apartment,-19575,-2901,1,0,0,0,Sales staff,2.0,-15,C
5322,5009154,F,N,N,0,180000.0,Working,Secondary / secondary special,Married,House / apartment,-19575,-2901,1,0,0,0,Sales staff,2.0,-16,C
5323,5009154,F,N,N,0,180000.0,Working,Secondary / secondary special,Married,House / apartment,-19575,-2901,1,0,0,0,Sales staff,2.0,-17,C
5324,5009154,F,N,N,0,180000.0,Working,Secondary / secondary special,Married,House / apartment,-19575,-2901,1,0,0,0,Sales staff,2.0,-18,C
5325,5009154,F,N,N,0,180000.0,Working,Secondary / secondary special,Married,House / apartment,-19575,-2901,1,0,0,0,Sales staff,2.0,-19,C
5326,5009154,F,N,N,0,180000.0,Working,Secondary / secondary special,Married,House / apartment,-19575,-2901,1,0,0,0,Sales staff,2.0,-20,C
5327,5009154,F,N,N,0,180000.0,Working,Secondary / secondary special,Married,House / apartment,-19575,-2901,1,0,0,0,Sales staff,2.0,-21,C
5328,5009154,F,N,N,0,180000.0,Working,Secondary / secondary special,Married,House / apartment,-19575,-2901,1,0,0,0,Sales staff,2.0,-22,C
5329,5009154,F,N,N,0,180000.0,Working,Secondary / secondary special,Married,House / apartment,-19575,-2901,1,0,0,0,Sales staff,2.0,-23,C
5330,5009154,F,N,N,0,180000.0,Working,Secondary / secondary special,Married,House / apartment,-19575,-2901,1,0,0,0,Sales staff,2.0,-24,X
5331,5009154,F,N,N,0,180000.0,Working,Secondary / secondary special,Married,House / apartment,-19575,-2901,1,0,0,0,Sales staff,2.0,-25,0
5332,5009154,F,N,N,0,180000.0,Working,Secondary / secondary special,Married,House / apartment,-19575,-2901,1,0,0,0,Sales staff,2.0,-26,0
5333,5009154,F,N,N,0,180000.0,Working,Secondary / secondary special,Married,House / apartment,-19575,-2901,1,0,0,0,Sales staff,2.0,-27,0
5334,5009154,F,N,N,0,180000.0,Working,Secondary / secondary special,Married,House / apartment,-19575,-2901,1,0,0,0,Sales staff,2.0,-28,0
5335,5009155,F,N,N,0,180000.0,Working,Secondary / secondary special,Married,House / apartment,-19575,-2901,1,0,0,0,Sales staff,2.0,0,C
5336,5009155,F,N,N,0,180000.0,Working,Secondary / secondary special,Married,House / apartment,-19575,-2901,1,0,0,0,Sales staff,2.0,-1,C
5337,5009155,F,N,N,0,180000.0,Working,Secondary / secondary special,Married,House / apartment,-19575,-2901,1,0,0,0,Sales staff,2.0,-2,C
5338,5009155,F,N,N,0,180000.0,Working,Secondary / secondary special,Married,House / apartment,-19575,-2901,1,0,0,0,Sales staff,2.0,-3,C
5339,5009155,F,N,N,0,180000.0,Working,Secondary / secondary special,Married,House / apartment,-19575,-2901,1,0,0,0,Sales staff,2.0,-4,C
5340,5009155,F,N,N,0,180000.0,Working,Secondary / secondary special,Married,House / apartment,-19575,-2901,1,0,0,0,Sales staff,2.0,-5,C
5341,5009155,F,N,N,0,180000.0,Working,Secondary / secondary special,Married,House / apartment,-19575,-2901,1,0,0,0,Sales staff,2.0,-6,C
5342,5009155,F,N,N,0,180000.0,Working,Secondary / secondary special,Married,House / apartment,-19575,-2901,1,0,0,0,Sales staff,2.0,-7,C
5343,5009155,F,N,N,0,180000.0,Working,Secondary / secondary special,Married,House / apartment,-19575,-2901,1,0,0,0,Sales staff,2.0,-8,C
5344,5009155,F,N,N,0,180000.0,Working,Secondary / secondary special,Married,House / apartment,-19575,-2901,1,0,0,0,Sales staff,2.0,-9,C
5345,5009155,F,N,N,0,180000.0,Working,Secondary / secondary special,Married,House / apartment,-19575,-2901,1,0,0,0,Sales staff,2.0,-10,C
5346,5009155,F,N,N,0,180000.0,Working,Secondary / secondary special,Married,House / apartment,-19575,-2901,1,0,0,0,Sales staff,2.0,-11,C
5347,5009155,F,N,N,0,180000.0,Working,Secondary / secondary special,Married,House / apartment,-19575,-2901,1,0,0,0,Sales staff,2.0,-12,C
5348,5009155,F,N,N,0,180000.0,Working,Secondary / secondary special,Married,House / apartment,-19575,-2901,1,0,0,0,Sales staff,2.0,-13,C
5349,5009155,F,N,N,0,180000.0,Working,Secondary / secondary special,Married,House / apartment,-19575,-2901,1,0,0,0,Sales staff,2.0,-14,C
5350,5009155,F,N,N,0,180000.0,Working,Secondary / secondary special,Married,House / apartment,-19575,-2901,1,0,0,0,Sales staff,2.0,-15,C
5351,5009155,F,N,N,0,180000.0,Working,Secondary / secondary special,Married,House / apartment,-19575,-2901,1,0,0,0,Sales staff,2.0,-16,C
5352,5009155,F,N,N,0,180000.0,Working,Secondary / secondary special,Married,House / apartment,-19575,-2901,1,0,0,0,Sales staff,2.0,-17,C
5353,5009155,F,N,N,0,180000.0,Working,Secondary / secondary special,Married,House / apartment,-19575,-2901,1,0,0,0,Sales staff,2.0,-18,C
5354,5009155,F,N,N,0,180000.0,Working,Secondary / secondary special,Married,House / apartment,-19575,-2901,1,0,0,0,Sales staff,2.0,-19,C
5355,5009155,F,N,N,0,180000.0,Working,Secondary / secondary special,Married,House / apartment,-19575,-2901,1,0,0,0,Sales staff,2.0,-20,C
5356,5009155,F,N,N,0,180000.0,Working,Secondary / secondary special,Married,House / apartment,-19575,-2901,1,0,0,0,Sales staff,2.0,-21,C
5357,5009155,F,N,N,0,180000.0,Working,Secondary / secondary special,Married,House / apartment,-19575,-2901,1,0,0,0,Sales staff,2.0,-22,C
5358,5009155,F,N,N,0,180000.0,Working,Secondary / secondary special,Married,House / apartment,-19575,-2901,1,0,0,0,Sales staff,2.0,-23,X
5359,5009155,F,N,N,0,180000.0,Working,Secondary / secondary special,Married,House / apartment,-19575,-2901,1,0,0,0,Sales staff,2.0,-24,0
5360,5009155,F,N,N,0,180000.0,Working,Secondary / secondary special,Married,House / apartment,-19575,-2901,1,0,0,0,Sales staff,2.0,-25,0
5361,5009155,F,N,N,0,180000.0,Working,Secondary / secondary special,Married,House / apartment,-19575,-2901,1,0,0,0,Sales staff,2.0,-26,0
5362,5009155,F,N,N,0,180000.0,Working,Secondary / secondary special,Married,House / apartment,-19575,-2901,1,0,0,0,Sales staff,2.0,-27,0
5363,5009156,F,N,N,0,180000.0,Working,Secondary / secondary special,Married,House / apartment,-19575,-2901,1,0,0,0,Sales staff,2.0,0,C
5364,5009156,F,N,N,0,180000.0,Working,Secondary / secondary special,Married,House / apartment,-19575,-2901,1,0,0,0,Sales staff,2.0,-1,C
5365,5009156,F,N,N,0,180000.0,Working,Secondary / secondary special,Married,House / apartment,-19575,-2901,1,0,0,0,Sales staff,2.0,-2,C
5366,5009156,F,N,N,0,180000.0,Working,Secondary / secondary special,Married,House / apartment,-19575,-2901,1,0,0,0,Sales staff,2.0,-3,C
5367,5009156,F,N,N,0,180000.0,Working,Secondary / secondary special,Married,House / apartment,-19575,-2901,1,0,0,0,Sales staff,2.0,-4,C
5368,5009156,F,N,N,0,180000.0,Working,Secondary / secondary special,Married,House / apartment,-19575,-2901,1,0,0,0,Sales staff,2.0,-5,C
5369,5009156,F,N,N,0,180000.0,Working,Secondary / secondary special,Married,House / apartment,-19575,-2901,1,0,0,0,Sales staff,2.0,-6,C
5370,5009156,F,N,N,0,180000.0,Working,Secondary / secondary special,Married,House / apartment,-19575,-2901,1,0,0,0,Sales staff,2.0,-7,C
5371,5009156,F,N,N,0,180000.0,Working,Secondary / secondary special,Married,House / apartment,-19575,-2901,1,0,0,0,Sales staff,2.0,-8,C
5372,5009156,F,N,N,0,180000.0,Working,Secondary / secondary special,Married,House / apartment,-19575,-2901,1,0,0,0,Sales staff,2.0,-9,C
5373,5009156,F,N,N,0,180000.0,Working,Secondary / secondary special,Married,House / apartment,-19575,-2901,1,0,0,0,Sales staff,2.0,-10,C
5374,5009156,F,N,N,0,180000.0,Working,Secondary / secondary special,Married,House / apartment,-19575,-2901,1,0,0,0,Sales staff,2.0,-11,C
5375,5009156,F,N,N,0,180000.0,Working,Secondary / secondary special,Married,House / apartment,-19575,-2901,1,0,0,0,Sales staff,2.0,-12,C
5376,5009156,F,N,N,0,180000.0,Working,Secondary / secondary special,Married,House / apartment,-19575,-2901,1,0,0,0,Sales staff,2.0,-13,X
5377,5009156,F,N,N,0,180000.0,Working,Secondary / secondary special,Married,House / apartment,-19575,-2901,1,0,0,0,Sales staff,2.0,-14,0
5378,5009156,F,N,N,0,180000.0,Working,Secondary / secondary special,Married,House / apartment,-19575,-2901,1,0,0,0,Sales staff,2.0,-15,0
5379,5009156,F,N,N,0,180000.0,Working,Secondary / secondary special,Married,House / apartment,-19575,-2901,1,0,0,0,Sales staff,2.0,-16,0
5380,5009156,F,N,N,0,180000.0,Working,Secondary / secondary special,Married,House / apartment,-19575,-2901,1,0,0,0,Sales staff,2.0,-17,0
5381,5009157,F,N,N,0,180000.0,Working,Secondary / secondary special,Married,House / apartment,-19575,-2901,1,0,0,0,Sales staff,2.0,-8,C
5382,5009157,F,N,N,0,180000.0,Working,Secondary / secondary special,Married,House / apartment,-19575,-2901,1,0,0,0,Sales staff,2.0,-9,C
5383,5009157,F,N,N,0,180000.0,Working,Secondary / secondary special,Married,House / apartment,-19575,-2901,1,0,0,0,Sales staff,2.0,-10,C
5384,5009157,F,N,N,0,180000.0,Working,Secondary / secondary special,Married,House / apartment,-19575,-2901,1,0,0,0,Sales staff,2.0,-11,C
5385,5009157,F,N,N,0,180000.0,Working,Secondary / secondary special,Married,House / apartment,-19575,-2901,1,0,0,0,Sales staff,2.0,-12,C
5386,5009157,F,N,N,0,180000.0,Working,Secondary / secondary special,Married,House / apartment,-19575,-2901,1,0,0,0,Sales staff,2.0,-13,C
5387,5009157,F,N,N,0,180000.0,Working,Secondary / secondary special,Married,House / apartment,-19575,-2901,1,0,0,0,Sales staff,2.0,-14,C
5388,5009157,F,N,N,0,180000.0,Working,Secondary / secondary special,Married,House / apartment,-19575,-2901,1,0,0,0,Sales staff,2.0,-15,C
5389,5009157,F,N,N,0,180000.0,Working,Secondary / secondary special,Married,House / apartment,-19575,-2901,1,0,0,0,Sales staff,2.0,-16,C
5390,5009157,F,N,N,0,180000.0,Working,Secondary / secondary special,Married,House / apartment,-19575,-2901,1,0,0,0,Sales staff,2.0,-17,C
5391,5009157,F,N,N,0,180000.0,Working,Secondary / secondary special,Married,House / apartment,-19575,-2901,1,0,0,0,Sales staff,2.0,-18,C
5392,5009157,F,N,N,0,180000.0,Working,Secondary / secondary special,Married,House / apartment,-19575,-2901,1,0,0,0,Sales staff,2.0,-19,C
5393,5009157,F,N,N,0,180000.0,Working,Secondary / secondary special,Married,House / apartment,-19575,-2901,1,0,0,0,Sales staff,2.0,-20,C
5394,5009157,F,N,N,0,180000.0,Working,Secondary / secondary special,Married,House / apartment,-19575,-2901,1,0,0,0,Sales staff,2.0,-21,C
5395,5009157,F,N,N,0,180000.0,Working,Secondary / secondary special,Married,House / apartment,-19575,-2901,1,0,0,0,Sales staff,2.0,-22,C
5396,5009157,F,N,N,0,180000.0,Working,Secondary / secondary special,Married,House / apartment,-19575,-2901,1,0,0,0,Sales staff,2.0,-23,C
5397,5009157,F,N,N,0,180000.0,Working,Secondary / secondary special,Married,House / apartment,-19575,-2901,1,0,0,0,Sales staff,2.0,-24,C
5398,5009157,F,N,N,0,180000.0,Working,Secondary / secondary special,Married,House / apartment,-19575,-2901,1,0,0,0,Sales staff,2.0,-25,C
5399,5009157,F,N,N,0,180000.0,Working,Secondary / secondary special,Married,House / apartment,-19575,-2901,1,0,0,0,Sales staff,2.0,-26,C
5400,5009157,F,N,N,0,180000.0,Working,Secondary / secondary special,Married,House / apartment,-19575,-2901,1,0,0,0,Sales staff,2.0,-27,C
5401,5009157,F,N,N,0,180000.0,Working,Secondary / secondary special,Married,House / apartment,-19575,-2901,1,0,0,0,Sales staff,2.0,-28,C
5402,5009157,F,N,N,0,180000.0,Working,Secondary / secondary special,Married,House / apartment,-19575,-2901,1,0,0,0,Sales staff,2.0,-29,C
5403,5009157,F,N,N,0,180000.0,Working,Secondary / secondary special,Married,House / apartment,-19575,-2901,1,0,0,0,Sales staff,2.0,-30,C
5404,5009157,F,N,N,0,180000.0,Working,Secondary / secondary special,Married,House / apartment,-19575,-2901,1,0,0,0,Sales staff,2.0,-31,C
5405,5009157,F,N,N,0,180000.0,Working,Secondary / secondary special,Married,House / apartment,-19575,-2901,1,0,0,0,Sales staff,2.0,-32,C
5406,5009157,F,N,N,0,180000.0,Working,Secondary / secondary special,Married,House / apartment,-19575,-2901,1,0,0,0,Sales staff,2.0,-33,C
5407,5009157,F,N,N,0,180000.0,Working,Secondary / secondary special,Married,House / apartment,-19575,-2901,1,0,0,0,Sales staff,2.0,-34,C
5408,5009157,F,N,N,0,180000.0,Working,Secondary / secondary special,Married,House / apartment,-19575,-2901,1,0,0,0,Sales staff,2.0,-35,C
5409,5009157,F,N,N,0,180000.0,Working,Secondary / secondary special,Married,House / apartment,-19575,-2901,1,0,0,0,Sales staff,2.0,-36,C
5410,5009157,F,N,N,0,180000.0,Working,Secondary / secondary special,Married,House / apartment,-19575,-2901,1,0,0,0,Sales staff,2.0,-37,C
5411,5009157,F,N,N,0,180000.0,Working,Secondary / secondary special,Married,House / apartment,-19575,-2901,1,0,0,0,Sales staff,2.0,-38,C
5412,5009157,F,N,N,0,180000.0,Working,Secondary / secondary special,Married,House / apartment,-19575,-2901,1,0,0,0,Sales staff,2.0,-39,C
5413,5009157,F,N,N,0,180000.0,Working,Secondary / secondary special,Married,House / apartment,-19575,-2901,1,0,0,0,Sales staff,2.0,-40,C
5414,5009157,F,N,N,0,180000.0,Working,Secondary / secondary special,Married,House / apartment,-19575,-2901,1,0,0,0,Sales staff,2.0,-41,C
5415,5009157,F,N,N,0,180000.0,Working,Secondary / secondary special,Married,House / apartment,-19575,-2901,1,0,0,0,Sales staff,2.0,-42,C
5416,5009157,F,N,N,0,180000.0,Working,Secondary / secondary special,Married,House / apartment,-19575,-2901,1,0,0,0,Sales staff,2.0,-43,C
5417,5009157,F,N,N,0,180000.0,Working,Secondary / secondary special,Married,House / apartment,-19575,-2901,1,0,0,0,Sales staff,2.0,-44,C
5418,5009157,F,N,N,0,180000.0,Working,Secondary / secondary special,Married,House / apartment,-19575,-2901,1,0,0,0,Sales staff,2.0,-45,C
5419,5009157,F,N,N,0,180000.0,Working,Secondary / secondary special,Married,House / apartment,-19575,-2901,1,0,0,0,Sales staff,2.0,-46,C
5420,5009157,F,N,N,0,180000.0,Working,Secondary / secondary special,Married,House / apartment,-19575,-2901,1,0,0,0,Sales staff,2.0,-47,C
5421,5009157,F,N,N,0,180000.0,Working,Secondary / secondary special,Married,House / apartment,-19575,-2901,1,0,0,0,Sales staff,2.0,-48,C
5422,5009157,F,N,N,0,180000.0,Working,Secondary / secondary special,Married,House / apartment,-19575,-2901,1,0,0,0,Sales staff,2.0,-49,C
5423,5009157,F,N,N,0,180000.0,Working,Secondary / secondary special,Married,House / apartment,-19575,-2901,1,0,0,0,Sales staff,2.0,-50,C
5424,5009157,F,N,N,0,180000.0,Working,Secondary / secondary special,Married,House / apartment,-19575,-2901,1,0,0,0,Sales staff,2.0,-51,X
5425,5009157,F,N,N,0,180000.0,Working,Secondary / secondary special,Married,House / apartment,-19575,-2901,1,0,0,0,Sales staff,2.0,-52,0
5426,5009157,F,N,N,0,180000.0,Working,Secondary / secondary special,Married,House / apartment,-19575,-2901,1,0,0,0,Sales staff,2.0,-53,0
5427,5009157,F,N,N,0,180000.0,Working,Secondary / secondary special,Married,House / apartment,-19575,-2901,1,0,0,0,Sales staff,2.0,-54,0
5428,5009157,F,N,N,0,180000.0,Working,Secondary / secondary special,Married,House / apartment,-19575,-2901,1,0,0,0,Sales staff,2.0,-55,0
5429,5009158,F,N,N,0,180000.0,Working,Secondary / secondary special,Married,House / apartment,-19575,-2901,1,0,0,0,Sales staff,2.0,0,C
5430,5009158,F,N,N,0,180000.0,Working,Secondary / secondary special,Married,House / apartment,-19575,-2901,1,0,0,0,Sales staff,2.0,-1,C
5431,5009158,F,N,N,0,180000.0,Working,Secondary / secondary special,Married,House / apartment,-19575,-2901,1,0,0,0,Sales staff,2.0,-2,C
5432,5009158,F,N,N,0,180000.0,Working,Secondary / secondary special,Married,House / apartment,-19575,-2901,1,0,0,0,Sales staff,2.0,-3,C
5433,5009158,F,N,N,0,180000.0,Working,Secondary / secondary special,Married,House / apartment,-19575,-2901,1,0,0,0,Sales staff,2.0,-4,C
5434,5009158,F,N,N,0,180000.0,Working,Secondary / secondary special,Married,House / apartment,-19575,-2901,1,0,0,0,Sales staff,2.0,-5,C
5435,5009158,F,N,N,0,180000.0,Working,Secondary / secondary special,Married,House / apartment,-19575,-2901,1,0,0,0,Sales staff,2.0,-6,C
5436,5009158,F,N,N,0,180000.0,Working,Secondary / secondary special,Married,House / apartment,-19575,-2901,1,0,0,0,Sales staff,2.0,-7,C
5437,5009158,F,N,N,0,180000.0,Working,Secondary / secondary special,Married,House / apartment,-19575,-2901,1,0,0,0,Sales staff,2.0,-8,C
5438,5009158,F,N,N,0,180000.0,Working,Secondary / secondary special,Married,House / apartment,-19575,-2901,1,0,0,0,Sales staff,2.0,-9,C
5439,5009158,F,N,N,0,180000.0,Working,Secondary / secondary special,Married,House / apartment,-19575,-2901,1,0,0,0,Sales staff,2.0,-10,C
5440,5009158,F,N,N,0,180000.0,Working,Secondary / secondary special,Married,House / apartment,-19575,-2901,1,0,0,0,Sales staff,2.0,-11,C
5441,5009158,F,N,N,0,180000.0,Working,Secondary / secondary special,Married,House / apartment,-19575,-2901,1,0,0,0,Sales staff,2.0,-12,C
5442,5009158,F,N,N,0,180000.0,Working,Secondary / secondary special,Married,House / apartment,-19575,-2901,1,0,0,0,Sales staff,2.0,-13,C
5443,5009158,F,N,N,0,180000.0,Working,Secondary / secondary special,Married,House / apartment,-19575,-2901,1,0,0,0,Sales staff,2.0,-14,C
5444,5009158,F,N,N,0,180000.0,Working,Secondary / secondary special,Married,House / apartment,-19575,-2901,1,0,0,0,Sales staff,2.0,-15,C
5445,5009158,F,N,N,0,180000.0,Working,Secondary / secondary special,Married,House / apartment,-19575,-2901,1,0,0,0,Sales staff,2.0,-16,C
5446,5009158,F,N,N,0,180000.0,Working,Secondary / secondary special,Married,House / apartment,-19575,-2901,1,0,0,0,Sales staff,2.0,-17,C
5447,5009158,F,N,N,0,180000.0,Working,Secondary / secondary special,Married,House / apartment,-19575,-2901,1,0,0,0,Sales staff,2.0,-18,C
5448,5009158,F,N,N,0,180000.0,Working,Secondary / secondary special,Married,House / apartment,-19575,-2901,1,0,0,0,Sales staff,2.0,-19,C
5449,5009158,F,N,N,0,180000.0,Working,Secondary / secondary special,Married,House / apartment,-19575,-2901,1,0,0,0,Sales staff,2.0,-20,C
5450,5009158,F,N,N,0,180000.0,Working,Secondary / secondary special,Married,House / apartment,-19575,-2901,1,0,0,0,Sales staff,2.0,-21,C
5451,5009158,F,N,N,0,180000.0,Working,Secondary / secondary special,Married,House / apartment,-19575,-2901,1,0,0,0,Sales staff,2.0,-22,C
5452,5009158,F,N,N,0,180000.0,Working,Secondary / secondary special,Married,House / apartment,-19575,-2901,1,0,0,0,Sales staff,2.0,-23,C
5453,5009158,F,N,N,0,180000.0,Working,Secondary / secondary special,Married,House / apartment,-19575,-2901,1,0,0,0,Sales staff,2.0,-24,C
5454,5009158,F,N,N,0,180000.0,Working,Secondary / secondary special,Married,House / apartment,-19575,-2901,1,0,0,0,Sales staff,2.0,-25,C
5455,5009158,F,N,N,0,180000.0,Working,Secondary / secondary special,Married,House / apartment,-19575,-2901,1,0,0,0,Sales staff,2.0,-26,C
5456,5009158,F,N,N,0,180000.0,Working,Secondary / secondary special,Married,House / apartment,-19575,-2901,1,0,0,0,Sales staff,2.0,-27,C
5457,5009158,F,N,N,0,180000.0,Working,Secondary / secondary special,Married,House / apartment,-19575,-2901,1,0,0,0,Sales staff,2.0,-28,C
5458,5009158,F,N,N,0,180000.0,Working,Secondary / secondary special,Married,House / apartment,-19575,-2901,1,0,0,0,Sales staff,2.0,-29,C
5459,5009158,F,N,N,0,180000.0,Working,Secondary / secondary special,Married,House / apartment,-19575,-2901,1,0,0,0,Sales staff,2.0,-30,C
5460,5009158,F,N,N,0,180000.0,Working,Secondary / secondary special,Married,House / apartment,-19575,-2901,1,0,0,0,Sales staff,2.0,-31,C
5461,5009158,F,N,N,0,180000.0,Working,Secondary / secondary special,Married,House / apartment,-19575,-2901,1,0,0,0,Sales staff,2.0,-32,C
5462,5009158,F,N,N,0,180000.0,Working,Secondary / secondary special,Married,House / apartment,-19575,-2901,1,0,0,0,Sales staff,2.0,-33,C
5463,5009158,F,N,N,0,180000.0,Working,Secondary / secondary special,Married,House / apartment,-19575,-2901,1,0,0,0,Sales staff,2.0,-34,C
5464,5009158,F,N,N,0,180000.0,Working,Secondary / secondary special,Married,House / apartment,-19575,-2901,1,0,0,0,Sales staff,2.0,-35,C
5465,5009158,F,N,N,0,180000.0,Working,Secondary / secondary special,Married,House / apartment,-19575,-2901,1,0,0,0,Sales staff,2.0,-36,C
5466,5009158,F,N,N,0,180000.0,Working,Secondary / secondary special,Married,House / apartment,-19575,-2901,1,0,0,0,Sales staff,2.0,-37,C
5467,5009158,F,N,N,0,180000.0,Working,Secondary / secondary special,Married,House / apartment,-19575,-2901,1,0,0,0,Sales staff,2.0,-38,C
5468,5009158,F,N,N,0,180000.0,Working,Secondary / secondary special,Married,House / apartment,-19575,-2901,1,0,0,0,Sales staff,2.0,-39,X
5469,5009158,F,N,N,0,180000.0,Working,Secondary / secondary special,Married,House / apartment,-19575,-2901,1,0,0,0,Sales staff,2.0,-40,0
5470,5009158,F,N,N,0,180000.0,Working,Secondary / secondary special,Married,House / apartment,-19575,-2901,1,0,0,0,Sales staff,2.0,-41,0
5471,5009158,F,N,N,0,180000.0,Working,Secondary / secondary special,Married,House / apartment,-19575,-2901,1,0,0,0,Sales staff,2.0,-42,0
5472,5009158,F,N,N,0,180000.0,Working,Secondary / secondary special,Married,House / apartment,-19575,-2901,1,0,0,0,Sales staff,2.0,-43,0
5473,5009159,F,N,N,0,180000.0,Working,Secondary / secondary special,Married,House / apartment,-19575,-2901,1,0,0,0,Sales staff,2.0,0,C
5474,5009159,F,N,N,0,180000.0,Working,Secondary / secondary special,Married,House / apartment,-19575,-2901,1,0,0,0,Sales staff,2.0,-1,C
5475,5009159,F,N,N,0,180000.0,Working,Secondary / secondary special,Married,House / apartment,-19575,-2901,1,0,0,0,Sales staff,2.0,-2,C
5476,5009159,F,N,N,0,180000.0,Working,Secondary / secondary special,Married,House / apartment,-19575,-2901,1,0,0,0,Sales staff,2.0,-3,C
5477,5009159,F,N,N,0,180000.0,Working,Secondary / secondary special,Married,House / apartment,-19575,-2901,1,0,0,0,Sales staff,2.0,-4,C
5478,5009159,F,N,N,0,180000.0,Working,Secondary / secondary special,Married,House / apartment,-19575,-2901,1,0,0,0,Sales staff,2.0,-5,C
5479,5009159,F,N,N,0,180000.0,Working,Secondary / secondary special,Married,House / apartment,-19575,-2901,1,0,0,0,Sales staff,2.0,-6,C
5480,5009159,F,N,N,0,180000.0,Working,Secondary / secondary special,Married,House / apartment,-19575,-2901,1,0,0,0,Sales staff,2.0,-7,C
5481,5009159,F,N,N,0,180000.0,Working,Secondary / secondary special,Married,House / apartment,-19575,-2901,1,0,0,0,Sales staff,2.0,-8,C
5482,5009159,F,N,N,0,180000.0,Working,Secondary / secondary special,Married,House / apartment,-19575,-2901,1,0,0,0,Sales staff,2.0,-9,C
5483,5009159,F,N,N,0,180000.0,Working,Secondary / secondary special,Married,House / apartment,-19575,-2901,1,0,0,0,Sales staff,2.0,-10,X
5484,5009159,F,N,N,0,180000.0,Working,Secondary / secondary special,Married,House / apartment,-19575,-2901,1,0,0,0,Sales staff,2.0,-11,0
5485,5009159,F,N,N,0,180000.0,Working,Secondary / secondary special,Married,House / apartment,-19575,-2901,1,0,0,0,Sales staff,2.0,-12,0
5486,5009159,F,N,N,0,180000.0,Working,Secondary / secondary special,Married,House / apartment,-19575,-2901,1,0,0,0,Sales staff,2.0,-13,0
5487,5009159,F,N,N,0,180000.0,Working,Secondary / secondary special,Married,House / apartment,-19575,-2901,1,0,0,0,Sales staff,2.0,-14,0
5488,5009160,F,N,N,0,180000.0,Working,Secondary / secondary special,Married,House / apartment,-19575,-2901,1,0,0,0,Sales staff,2.0,0,C
5489,5009160,F,N,N,0,180000.0,Working,Secondary / secondary special,Married,House / apartment,-19575,-2901,1,0,0,0,Sales staff,2.0,-1,C
5490,5009160,F,N,N,0,180000.0,Working,Secondary / secondary special,Married,House / apartment,-19575,-2901,1,0,0,0,Sales staff,2.0,-2,C
5491,5009160,F,N,N,0,180000.0,Working,Secondary / secondary special,Married,House / apartment,-19575,-2901,1,0,0,0,Sales staff,2.0,-3,C
5492,5009160,F,N,N,0,180000.0,Working,Secondary / secondary special,Married,House / apartment,-19575,-2901,1,0,0,0,Sales staff,2.0,-4,C
5493,5009160,F,N,N,0,180000.0,Working,Secondary / secondary special,Married,House / apartment,-19575,-2901,1,0,0,0,Sales staff,2.0,-5,C
5494,5009160,F,N,N,0,180000.0,Working,Secondary / secondary special,Married,House / apartment,-19575,-2901,1,0,0,0,Sales staff,2.0,-6,C
5495,5009160,F,N,N,0,180000.0,Working,Secondary / secondary special,Married,House / apartment,-19575,-2901,1,0,0,0,Sales staff,2.0,-7,C
5496,5009160,F,N,N,0,180000.0,Working,Secondary / secondary special,Married,House / apartment,-19575,-2901,1,0,0,0,Sales staff,2.0,-8,C
5497,5009160,F,N,N,0,180000.0,Working,Secondary / secondary special,Married,House / apartment,-19575,-2901,1,0,0,0,Sales staff,2.0,-9,C
5498,5009160,F,N,N,0,180000.0,Working,Secondary / secondary special,Married,House / apartment,-19575,-2901,1,0,0,0,Sales staff,2.0,-10,C
5499,5009160,F,N,N,0,180000.0,Working,Secondary / secondary special,Married,House / apartment,-19575,-2901,1,0,0,0,Sales staff,2.0,-11,C
5500,5009160,F,N,N,0,180000.0,Working,Secondary / secondary special,Married,House / apartment,-19575,-2901,1,0,0,0,Sales staff,2.0,-12,C
5501,5009160,F,N,N,0,180000.0,Working,Secondary / secondary special,Married,House / apartment,-19575,-2901,1,0,0,0,Sales staff,2.0,-13,C
5502,5009160,F,N,N,0,180000.0,Working,Secondary / secondary special,Married,House / apartment,-19575,-2901,1,0,0,0,Sales staff,2.0,-14,C
5503,5009160,F,N,N,0,180000.0,Working,Secondary / secondary special,Married,House / apartment,-19575,-2901,1,0,0,0,Sales staff,2.0,-15,C
5504,5009160,F,N,N,0,180000.0,Working,Secondary / secondary special,Married,House / apartment,-19575,-2901,1,0,0,0,Sales staff,2.0,-16,C
5505,5009160,F,N,N,0,180000.0,Working,Secondary / secondary special,Married,House / apartment,-19575,-2901,1,0,0,0,Sales staff,2.0,-17,X
5506,5009160,F,N,N,0,180000.0,Working,Secondary / secondary special,Married,House / apartment,-19575,-2901,1,0,0,0,Sales staff,2.0,-18,0
5507,5009160,F,N,N,0,180000.0,Working,Secondary / secondary special,Married,House / apartment,-19575,-2901,1,0,0,0,Sales staff,2.0,-19,0
5508,5009160,F,N,N,0,180000.0,Working,Secondary / secondary special,Married,House / apartment,-19575,-2901,1,0,0,0,Sales staff,2.0,-20,0
5509,5009160,F,N,N,0,180000.0,Working,Secondary / secondary special,Married,House / apartment,-19575,-2901,1,0,0,0,Sales staff,2.0,-21,0
5510,5009161,F,N,N,0,180000.0,Working,Secondary / secondary special,Married,House / apartment,-19575,-2901,1,0,0,0,Sales staff,2.0,0,C
5511,5009161,F,N,N,0,180000.0,Working,Secondary / secondary special,Married,House / apartment,-19575,-2901,1,0,0,0,Sales staff,2.0,-1,C
5512,5009161,F,N,N,0,180000.0,Working,Secondary / secondary special,Married,House / apartment,-19575,-2901,1,0,0,0,Sales staff,2.0,-2,C
5513,5009161,F,N,N,0,180000.0,Working,Secondary / secondary special,Married,House / apartment,-19575,-2901,1,0,0,0,Sales staff,2.0,-3,C
5514,5009161,F,N,N,0,180000.0,Working,Secondary / secondary special,Married,House / apartment,-19575,-2901,1,0,0,0,Sales staff,2.0,-4,C
5515,5009161,F,N,N,0,180000.0,Working,Secondary / secondary special,Married,House / apartment,-19575,-2901,1,0,0,0,Sales staff,2.0,-5,C
5516,5009161,F,N,N,0,180000.0,Working,Secondary / secondary special,Married,House / apartment,-19575,-2901,1,0,0,0,Sales staff,2.0,-6,C
5517,5009161,F,N,N,0,180000.0,Working,Secondary / secondary special,Married,House / apartment,-19575,-2901,1,0,0,0,Sales staff,2.0,-7,C
5518,5009161,F,N,N,0,180000.0,Working,Secondary / secondary special,Married,House / apartment,-19575,-2901,1,0,0,0,Sales staff,2.0,-8,C
5519,5009161,F,N,N,0,180000.0,Working,Secondary / secondary special,Married,House / apartment,-19575,-2901,1,0,0,0,Sales staff,2.0,-9,C
5520,5009161,F,N,N,0,180000.0,Working,Secondary / secondary special,Married,House / apartment,-19575,-2901,1,0,0,0,Sales staff,2.0,-10,C
5521,5009161,F,N,N,0,180000.0,Working,Secondary / secondary special,Married,House / apartment,-19575,-2901,1,0,0,0,Sales staff,2.0,-11,C
5522,5009161,F,N,N,0,180000.0,Working,Secondary / secondary special,Married,House / apartment,-19575,-2901,1,0,0,0,Sales staff,2.0,-12,C
5523,5009161,F,N,N,0,180000.0,Working,Secondary / secondary special,Married,House / apartment,-19575,-2901,1,0,0,0,Sales staff,2.0,-13,C
5524,5009161,F,N,N,0,180000.0,Working,Secondary / secondary special,Married,House / apartment,-19575,-2901,1,0,0,0,Sales staff,2.0,-14,C
5525,5009161,F,N,N,0,180000.0,Working,Secondary / secondary special,Married,House / apartment,-19575,-2901,1,0,0,0,Sales staff,2.0,-15,C
5526,5009161,F,N,N,0,180000.0,Working,Secondary / secondary special,Married,House / apartment,-19575,-2901,1,0,0,0,Sales staff,2.0,-16,C
5527,5009161,F,N,N,0,180000.0,Working,Secondary / secondary special,Married,House / apartment,-19575,-2901,1,0,0,0,Sales staff,2.0,-17,C
5528,5009161,F,N,N,0,180000.0,Working,Secondary / secondary special,Married,House / apartment,-19575,-2901,1,0,0,0,Sales staff,2.0,-18,C
5529,5009161,F,N,N,0,180000.0,Working,Secondary / secondary special,Married,House / apartment,-19575,-2901,1,0,0,0,Sales staff,2.0,-19,C
5530,5009161,F,N,N,0,180000.0,Working,Secondary / secondary special,Married,House / apartment,-19575,-2901,1,0,0,0,Sales staff,2.0,-20,1
5531,5009161,F,N,N,0,180000.0,Working,Secondary / secondary special,Married,House / apartment,-19575,-2901,1,0,0,0,Sales staff,2.0,-21,1
5532,5009161,F,N,N,0,180000.0,Working,Secondary / secondary special,Married,House / apartment,-19575,-2901,1,0,0,0,Sales staff,2.0,-22,0
5533,5009161,F,N,N,0,180000.0,Working,Secondary / secondary special,Married,House / apartment,-19575,-2901,1,0,0,0,Sales staff,2.0,-23,0
5534,5009162,F,N,N,0,180000.0,Working,Secondary / secondary special,Married,House / apartment,-19575,-2901,1,0,0,0,Sales staff,2.0,-9,C
5535,5009162,F,N,N,0,180000.0,Working,Secondary / secondary special,Married,House / apartment,-19575,-2901,1,0,0,0,Sales staff,2.0,-10,C
5536,5009162,F,N,N,0,180000.0,Working,Secondary / secondary special,Married,House / apartment,-19575,-2901,1,0,0,0,Sales staff,2.0,-11,C
5537,5009162,F,N,N,0,180000.0,Working,Secondary / secondary special,Married,House / apartment,-19575,-2901,1,0,0,0,Sales staff,2.0,-12,C
5538,5009162,F,N,N,0,180000.0,Working,Secondary / secondary special,Married,House / apartment,-19575,-2901,1,0,0,0,Sales staff,2.0,-13,C
5539,5009162,F,N,N,0,180000.0,Working,Secondary / secondary special,Married,House / apartment,-19575,-2901,1,0,0,0,Sales staff,2.0,-14,C
5540,5009162,F,N,N,0,180000.0,Working,Secondary / secondary special,Married,House / apartment,-19575,-2901,1,0,0,0,Sales staff,2.0,-15,C
5541,5009162,F,N,N,0,180000.0,Working,Secondary / secondary special,Married,House / apartment,-19575,-2901,1,0,0,0,Sales staff,2.0,-16,C
5542,5009162,F,N,N,0,180000.0,Working,Secondary / secondary special,Married,House / apartment,-19575,-2901,1,0,0,0,Sales staff,2.0,-17,C
5543,5009162,F,N,N,0,180000.0,Working,Secondary / secondary special,Married,House / apartment,-19575,-2901,1,0,0,0,Sales staff,2.0,-18,C
5544,5009162,F,N,N,0,180000.0,Working,Secondary / secondary special,Married,House / apartment,-19575,-2901,1,0,0,0,Sales staff,2.0,-19,C
5545,5009162,F,N,N,0,180000.0,Working,Secondary / secondary special,Married,House / apartment,-19575,-2901,1,0,0,0,Sales staff,2.0,-20,C
5546,5009162,F,N,N,0,180000.0,Working,Secondary / secondary special,Married,House / apartment,-19575,-2901,1,0,0,0,Sales staff,2.0,-21,C
5547,5009162,F,N,N,0,180000.0,Working,Secondary / secondary special,Married,House / apartment,-19575,-2901,1,0,0,0,Sales staff,2.0,-22,C
5548,5009162,F,N,N,0,180000.0,Working,Secondary / secondary special,Married,House / apartment,-19575,-2901,1,0,0,0,Sales staff,2.0,-23,C
5549,5009162,F,N,N,0,180000.0,Working,Secondary / secondary special,Married,House / apartment,-19575,-2901,1,0,0,0,Sales staff,2.0,-24,C
5550,5009162,F,N,N,0,180000.0,Working,Secondary / secondary special,Married,House / apartment,-19575,-2901,1,0,0,0,Sales staff,2.0,-25,C
5551,5009162,F,N,N,0,180000.0,Working,Secondary / secondary special,Married,House / apartment,-19575,-2901,1,0,0,0,Sales staff,2.0,-26,C
5552,5009162,F,N,N,0,180000.0,Working,Secondary / secondary special,Married,House / apartment,-19575,-2901,1,0,0,0,Sales staff,2.0,-27,C
5553,5009162,F,N,N,0,180000.0,Working,Secondary / secondary special,Married,House / apartment,-19575,-2901,1,0,0,0,Sales staff,2.0,-28,C
5554,5009162,F,N,N,0,180000.0,Working,Secondary / secondary special,Married,House / apartment,-19575,-2901,1,0,0,0,Sales staff,2.0,-29,C
5555,5009162,F,N,N,0,180000.0,Working,Secondary / secondary special,Married,House / apartment,-19575,-2901,1,0,0,0,Sales staff,2.0,-30,C
5556,5009162,F,N,N,0,180000.0,Working,Secondary / secondary special,Married,House / apartment,-19575,-2901,1,0,0,0,Sales staff,2.0,-31,C
5557,5009162,F,N,N,0,180000.0,Working,Secondary / secondary special,Married,House / apartment,-19575,-2901,1,0,0,0,Sales staff,2.0,-32,C
5558,5009162,F,N,N,0,180000.0,Working,Secondary / secondary special,Married,House / apartment,-19575,-2901,1,0,0,0,Sales staff,2.0,-33,C
5559,5009162,F,N,N,0,180000.0,Working,Secondary / secondary special,Married,House / apartment,-19575,-2901,1,0,0,0,Sales staff,2.0,-34,C
5560,5009162,F,N,N,0,180000.0,Working,Secondary / secondary special,Married,House / apartment,-19575,-2901,1,0,0,0,Sales staff,2.0,-35,C
5561,5009162,F,N,N,0,180000.0,Working,Secondary / secondary special,Married,House / apartment,-19575,-2901,1,0,0,0,Sales staff,2.0,-36,C
5562,5009162,F,N,N,0,180000.0,Working,Secondary / secondary special,Married,House / apartment,-19575,-2901,1,0,0,0,Sales staff,2.0,-37,C
5563,5009162,F,N,N,0,180000.0,Working,Secondary / secondary special,Married,House / apartment,-19575,-2901,1,0,0,0,Sales staff,2.0,-38,C
5564,5009162,F,N,N,0,180000.0,Working,Secondary / secondary special,Married,House / apartment,-19575,-2901,1,0,0,0,Sales staff,2.0,-39,C
5565,5009162,F,N,N,0,180000.0,Working,Secondary / secondary special,Married,House / apartment,-19575,-2901,1,0,0,0,Sales staff,2.0,-40,C
5566,5009162,F,N,N,0,180000.0,Working,Secondary / secondary special,Married,House / apartment,-19575,-2901,1,0,0,0,Sales staff,2.0,-41,C
5567,5009162,F,N,N,0,180000.0,Working,Secondary / secondary special,Married,House / apartment,-19575,-2901,1,0,0,0,Sales staff,2.0,-42,C
5568,5009162,F,N,N,0,180000.0,Working,Secondary / secondary special,Married,House / apartment,-19575,-2901,1,0,0,0,Sales staff,2.0,-43,C
5569,5009162,F,N,N,0,180000.0,Working,Secondary / secondary special,Married,House / apartment,-19575,-2901,1,0,0,0,Sales staff,2.0,-44,C
5570,5009162,F,N,N,0,180000.0,Working,Secondary / secondary special,Married,House / apartment,-19575,-2901,1,0,0,0,Sales staff,2.0,-45,C
5571,5009162,F,N,N,0,180000.0,Working,Secondary / secondary special,Married,House / apartment,-19575,-2901,1,0,0,0,Sales staff,2.0,-46,C
5572,5009162,F,N,N,0,180000.0,Working,Secondary / secondary special,Married,House / apartment,-19575,-2901,1,0,0,0,Sales staff,2.0,-47,C
5573,5009162,F,N,N,0,180000.0,Working,Secondary / secondary special,Married,House / apartment,-19575,-2901,1,0,0,0,Sales staff,2.0,-48,C
5574,5009162,F,N,N,0,180000.0,Working,Secondary / secondary special,Married,House / apartment,-19575,-2901,1,0,0,0,Sales staff,2.0,-49,C
5575,5009162,F,N,N,0,180000.0,Working,Secondary / secondary special,Married,House / apartment,-19575,-2901,1,0,0,0,Sales staff,2.0,-50,C
5576,5009162,F,N,N,0,180000.0,Working,Secondary / secondary special,Married,House / apartment,-19575,-2901,1,0,0,0,Sales staff,2.0,-51,C
5577,5009162,F,N,N,0,180000.0,Working,Secondary / secondary special,Married,House / apartment,-19575,-2901,1,0,0,0,Sales staff,2.0,-52,X
5578,5009162,F,N,N,0,180000.0,Working,Secondary / secondary special,Married,House / apartment,-19575,-2901,1,0,0,0,Sales staff,2.0,-53,0
5579,5009162,F,N,N,0,180000.0,Working,Secondary / secondary special,Married,House / apartment,-19575,-2901,1,0,0,0,Sales staff,2.0,-54,0
5580,5009162,F,N,N,0,180000.0,Working,Secondary / secondary special,Married,House / apartment,-19575,-2901,1,0,0,0,Sales staff,2.0,-55,0
5581,5009162,F,N,N,0,180000.0,Working,Secondary / secondary special,Married,House / apartment,-19575,-2901,1,0,0,0,Sales staff,2.0,-56,0
5582,5009163,F,N,N,0,157500.0,Working,Secondary / secondary special,Married,House / apartment,-12915,-3174,1,0,1,0,Sales staff,2.0,0,0
5583,5009163,F,N,N,0,157500.0,Working,Secondary / secondary special,Married,House / apartment,-12915,-3174,1,0,1,0,Sales staff,2.0,-1,0
5584,5009163,F,N,N,0,157500.0,Working,Secondary / secondary special,Married,House / apartment,-12915,-3174,1,0,1,0,Sales staff,2.0,-2,0
5585,5009163,F,N,N,0,157500.0,Working,Secondary / secondary special,Married,House / apartment,-12915,-3174,1,0,1,0,Sales staff,2.0,-3,0
5586,5009163,F,N,N,0,157500.0,Working,Secondary / secondary special,Married,House / apartment,-12915,-3174,1,0,1,0,Sales staff,2.0,-4,0
5587,5009163,F,N,N,0,157500.0,Working,Secondary / secondary special,Married,House / apartment,-12915,-3174,1,0,1,0,Sales staff,2.0,-5,0
5588,5009163,F,N,N,0,157500.0,Working,Secondary / secondary special,Married,House / apartment,-12915,-3174,1,0,1,0,Sales staff,2.0,-6,0
5589,5009163,F,N,N,0,157500.0,Working,Secondary / secondary special,Married,House / apartment,-12915,-3174,1,0,1,0,Sales staff,2.0,-7,0
5590,5009163,F,N,N,0,157500.0,Working,Secondary / secondary special,Married,House / apartment,-12915,-3174,1,0,1,0,Sales staff,2.0,-8,0
5591,5009163,F,N,N,0,157500.0,Working,Secondary / secondary special,Married,House / apartment,-12915,-3174,1,0,1,0,Sales staff,2.0,-9,0
5592,5009163,F,N,N,0,157500.0,Working,Secondary / secondary special,Married,House / apartment,-12915,-3174,1,0,1,0,Sales staff,2.0,-10,0
5593,5009163,F,N,N,0,157500.0,Working,Secondary / secondary special,Married,House / apartment,-12915,-3174,1,0,1,0,Sales staff,2.0,-11,0
5594,5009163,F,N,N,0,157500.0,Working,Secondary / secondary special,Married,House / apartment,-12915,-3174,1,0,1,0,Sales staff,2.0,-12,0
5595,5009164,F,N,N,0,157500.0,Working,Secondary / secondary special,Married,House / apartment,-12915,-3174,1,0,1,0,Sales staff,2.0,-13,0
5596,5009164,F,N,N,0,157500.0,Working,Secondary / secondary special,Married,House / apartment,-12915,-3174,1,0,1,0,Sales staff,2.0,-14,0
5597,5009164,F,N,N,0,157500.0,Working,Secondary / secondary special,Married,House / apartment,-12915,-3174,1,0,1,0,Sales staff,2.0,-15,0
5598,5009164,F,N,N,0,157500.0,Working,Secondary / secondary special,Married,House / apartment,-12915,-3174,1,0,1,0,Sales staff,2.0,-16,0
5599,5009164,F,N,N,0,157500.0,Working,Secondary / secondary special,Married,House / apartment,-12915,-3174,1,0,1,0,Sales staff,2.0,-17,0
5600,5009164,F,N,N,0,157500.0,Working,Secondary / secondary special,Married,House / apartment,-12915,-3174,1,0,1,0,Sales staff,2.0,-18,0
5601,5009164,F,N,N,0,157500.0,Working,Secondary / secondary special,Married,House / apartment,-12915,-3174,1,0,1,0,Sales staff,2.0,-19,0
5602,5009164,F,N,N,0,157500.0,Working,Secondary / secondary special,Married,House / apartment,-12915,-3174,1,0,1,0,Sales staff,2.0,-20,0
5603,5009164,F,N,N,0,157500.0,Working,Secondary / secondary special,Married,House / apartment,-12915,-3174,1,0,1,0,Sales staff,2.0,-21,0
5604,5009164,F,N,N,0,157500.0,Working,Secondary / secondary special,Married,House / apartment,-12915,-3174,1,0,1,0,Sales staff,2.0,-22,0
5605,5009164,F,N,N,0,157500.0,Working,Secondary / secondary special,Married,House / apartment,-12915,-3174,1,0,1,0,Sales staff,2.0,-23,0
5606,5009164,F,N,N,0,157500.0,Working,Secondary / secondary special,Married,House / apartment,-12915,-3174,1,0,1,0,Sales staff,2.0,-24,0
5607,5009164,F,N,N,0,157500.0,Working,Secondary / secondary special,Married,House / apartment,-12915,-3174,1,0,1,0,Sales staff,2.0,-25,0
5608,5009164,F,N,N,0,157500.0,Working,Secondary / secondary special,Married,House / apartment,-12915,-3174,1,0,1,0,Sales staff,2.0,-26,0
5609,5009164,F,N,N,0,157500.0,Working,Secondary / secondary special,Married,House / apartment,-12915,-3174,1,0,1,0,Sales staff,2.0,-27,0
5610,5009164,F,N,N,0,157500.0,Working,Secondary / secondary special,Married,House / apartment,-12915,-3174,1,0,1,0,Sales staff,2.0,-28,0
5611,5009164,F,N,N,0,157500.0,Working,Secondary / secondary special,Married,House / apartment,-12915,-3174,1,0,1,0,Sales staff,2.0,-29,0
5612,5009165,F,N,N,0,157500.0,Working,Secondary / secondary special,Married,House / apartment,-12915,-3174,1,0,1,0,Sales staff,2.0,-25,0
5613,5009165,F,N,N,0,157500.0,Working,Secondary / secondary special,Married,House / apartment,-12915,-3174,1,0,1,0,Sales staff,2.0,-26,0
5614,5009165,F,N,N,0,157500.0,Working,Secondary / secondary special,Married,House / apartment,-12915,-3174,1,0,1,0,Sales staff,2.0,-27,0
5615,5009165,F,N,N,0,157500.0,Working,Secondary / secondary special,Married,House / apartment,-12915,-3174,1,0,1,0,Sales staff,2.0,-28,0
5616,5009165,F,N,N,0,157500.0,Working,Secondary / secondary special,Married,House / apartment,-12915,-3174,1,0,1,0,Sales staff,2.0,-29,0
5617,5009165,F,N,N,0,157500.0,Working,Secondary / secondary special,Married,House / apartment,-12915,-3174,1,0,1,0,Sales staff,2.0,-30,0
5618,5009165,F,N,N,0,157500.0,Working,Secondary / secondary special,Married,House / apartment,-12915,-3174,1,0,1,0,Sales staff,2.0,-31,0
5619,5009165,F,N,N,0,157500.0,Working,Secondary / secondary special,Married,House / apartment,-12915,-3174,1,0,1,0,Sales staff,2.0,-32,0
5620,5009165,F,N,N,0,157500.0,Working,Secondary / secondary special,Married,House / apartment,-12915,-3174,1,0,1,0,Sales staff,2.0,-33,0
5621,5009165,F,N,N,0,157500.0,Working,Secondary / secondary special,Married,House / apartment,-12915,-3174,1,0,1,0,Sales staff,2.0,-34,0
5622,5009165,F,N,N,0,157500.0,Working,Secondary / secondary special,Married,House / apartment,-12915,-3174,1,0,1,0,Sales staff,2.0,-35,0
5623,5009165,F,N,N,0,157500.0,Working,Secondary / secondary special,Married,House / apartment,-12915,-3174,1,0,1,0,Sales staff,2.0,-36,0
5624,5009165,F,N,N,0,157500.0,Working,Secondary / secondary special,Married,House / apartment,-12915,-3174,1,0,1,0,Sales staff,2.0,-37,0
5625,5009165,F,N,N,0,157500.0,Working,Secondary / secondary special,Married,House / apartment,-12915,-3174,1,0,1,0,Sales staff,2.0,-38,0
5626,5009165,F,N,N,0,157500.0,Working,Secondary / secondary special,Married,House / apartment,-12915,-3174,1,0,1,0,Sales staff,2.0,-39,0
5627,5009165,F,N,N,0,157500.0,Working,Secondary / secondary special,Married,House / apartment,-12915,-3174,1,0,1,0,Sales staff,2.0,-40,0
5628,5009165,F,N,N,0,157500.0,Working,Secondary / secondary special,Married,House / apartment,-12915,-3174,1,0,1,0,Sales staff,2.0,-41,0
5629,5009166,F,N,N,0,157500.0,Working,Secondary / secondary special,Married,House / apartment,-12915,-3174,1,0,1,0,Sales staff,2.0,0,0
5630,5009166,F,N,N,0,157500.0,Working,Secondary / secondary special,Married,House / apartment,-12915,-3174,1,0,1,0,Sales staff,2.0,-1,0
5631,5009166,F,N,N,0,157500.0,Working,Secondary / secondary special,Married,House / apartment,-12915,-3174,1,0,1,0,Sales staff,2.0,-2,0
5632,5009166,F,N,N,0,157500.0,Working,Secondary / secondary special,Married,House / apartment,-12915,-3174,1,0,1,0,Sales staff,2.0,-3,0
5633,5009166,F,N,N,0,157500.0,Working,Secondary / secondary special,Married,House / apartment,-12915,-3174,1,0,1,0,Sales staff,2.0,-4,0
5634,5009166,F,N,N,0,157500.0,Working,Secondary / secondary special,Married,House / apartment,-12915,-3174,1,0,1,0,Sales staff,2.0,-5,0
5635,5009166,F,N,N,0,157500.0,Working,Secondary / secondary special,Married,House / apartment,-12915,-3174,1,0,1,0,Sales staff,2.0,-6,0
5636,5009166,F,N,N,0,157500.0,Working,Secondary / secondary special,Married,House / apartment,-12915,-3174,1,0,1,0,Sales staff,2.0,-7,0
5637,5009166,F,N,N,0,157500.0,Working,Secondary / secondary special,Married,House / apartment,-12915,-3174,1,0,1,0,Sales staff,2.0,-8,0
5638,5009166,F,N,N,0,157500.0,Working,Secondary / secondary special,Married,House / apartment,-12915,-3174,1,0,1,0,Sales staff,2.0,-9,0
5639,5009166,F,N,N,0,157500.0,Working,Secondary / secondary special,Married,House / apartment,-12915,-3174,1,0,1,0,Sales staff,2.0,-10,0
5640,5009166,F,N,N,0,157500.0,Working,Secondary / secondary special,Married,House / apartment,-12915,-3174,1,0,1,0,Sales staff,2.0,-11,0
5641,5009166,F,N,N,0,157500.0,Working,Secondary / secondary special,Married,House / apartment,-12915,-3174,1,0,1,0,Sales staff,2.0,-12,0
5642,5009166,F,N,N,0,157500.0,Working,Secondary / secondary special,Married,House / apartment,-12915,-3174,1,0,1,0,Sales staff,2.0,-13,0
5643,5009166,F,N,N,0,157500.0,Working,Secondary / secondary special,Married,House / apartment,-12915,-3174,1,0,1,0,Sales staff,2.0,-14,0
5644,5009166,F,N,N,0,157500.0,Working,Secondary / secondary special,Married,House / apartment,-12915,-3174,1,0,1,0,Sales staff,2.0,-15,0
5645,5009166,F,N,N,0,157500.0,Working,Secondary / secondary special,Married,House / apartment,-12915,-3174,1,0,1,0,Sales staff,2.0,-16,0
5646,5009168,F,N,N,0,157500.0,Working,Secondary / secondary special,Married,House / apartment,-12915,-3174,1,0,1,0,Sales staff,2.0,-22,0
5647,5009168,F,N,N,0,157500.0,Working,Secondary / secondary special,Married,House / apartment,-12915,-3174,1,0,1,0,Sales staff,2.0,-23,0
5648,5009168,F,N,N,0,157500.0,Working,Secondary / secondary special,Married,House / apartment,-12915,-3174,1,0,1,0,Sales staff,2.0,-24,0
5649,5009168,F,N,N,0,157500.0,Working,Secondary / secondary special,Married,House / apartment,-12915,-3174,1,0,1,0,Sales staff,2.0,-25,0
5650,5009168,F,N,N,0,157500.0,Working,Secondary / secondary special,Married,House / apartment,-12915,-3174,1,0,1,0,Sales staff,2.0,-26,0
5651,5009168,F,N,N,0,157500.0,Working,Secondary / secondary special,Married,House / apartment,-12915,-3174,1,0,1,0,Sales staff,2.0,-27,0
5652,5009168,F,N,N,0,157500.0,Working,Secondary / secondary special,Married,House / apartment,-12915,-3174,1,0,1,0,Sales staff,2.0,-28,0
5653,5009168,F,N,N,0,157500.0,Working,Secondary / secondary special,Married,House / apartment,-12915,-3174,1,0,1,0,Sales staff,2.0,-29,0
5654,5009168,F,N,N,0,157500.0,Working,Secondary / secondary special,Married,House / apartment,-12915,-3174,1,0,1,0,Sales staff,2.0,-30,0
5655,5009168,F,N,N,0,157500.0,Working,Secondary / secondary special,Married,House / apartment,-12915,-3174,1,0,1,0,Sales staff,2.0,-31,0
5656,5009168,F,N,N,0,157500.0,Working,Secondary / secondary special,Married,House / apartment,-12915,-3174,1,0,1,0,Sales staff,2.0,-32,0
5657,5009168,F,N,N,0,157500.0,Working,Secondary / secondary special,Married,House / apartment,-12915,-3174,1,0,1,0,Sales staff,2.0,-33,0
5658,5009168,F,N,N,0,157500.0,Working,Secondary / secondary special,Married,House / apartment,-12915,-3174,1,0,1,0,Sales staff,2.0,-34,0
5659,5009168,F,N,N,0,157500.0,Working,Secondary / secondary special,Married,House / apartment,-12915,-3174,1,0,1,0,Sales staff,2.0,-35,0
5660,5009168,F,N,N,0,157500.0,Working,Secondary / secondary special,Married,House / apartment,-12915,-3174,1,0,1,0,Sales staff,2.0,-36,0
5661,5009168,F,N,N,0,157500.0,Working,Secondary / secondary special,Married,House / apartment,-12915,-3174,1,0,1,0,Sales staff,2.0,-37,0
5662,5009168,F,N,N,0,157500.0,Working,Secondary / secondary special,Married,House / apartment,-12915,-3174,1,0,1,0,Sales staff,2.0,-38,0
5663,5009170,F,Y,N,0,144000.0,Pensioner,Secondary / secondary special,Married,House / apartment,-22877,365243,1,0,1,1,,2.0,-17,C
5664,5009170,F,Y,N,0,144000.0,Pensioner,Secondary / secondary special,Married,House / apartment,-22877,365243,1,0,1,1,,2.0,-18,C
5665,5009170,F,Y,N,0,144000.0,Pensioner,Secondary / secondary special,Married,House / apartment,-22877,365243,1,0,1,1,,2.0,-19,C
5666,5009170,F,Y,N,0,144000.0,Pensioner,Secondary / secondary special,Married,House / apartment,-22877,365243,1,0,1,1,,2.0,-20,0
5667,5009170,F,Y,N,0,144000.0,Pensioner,Secondary / secondary special,Married,House / apartment,-22877,365243,1,0,1,1,,2.0,-21,0
5668,5009170,F,Y,N,0,144000.0,Pensioner,Secondary / secondary special,Married,House / apartment,-22877,365243,1,0,1,1,,2.0,-22,0
5669,5009170,F,Y,N,0,144000.0,Pensioner,Secondary / secondary special,Married,House / apartment,-22877,365243,1,0,1,1,,2.0,-23,0
5670,5009170,F,Y,N,0,144000.0,Pensioner,Secondary / secondary special,Married,House / apartment,-22877,365243,1,0,1,1,,2.0,-24,0
5671,5009170,F,Y,N,0,144000.0,Pensioner,Secondary / secondary special,Married,House / apartment,-22877,365243,1,0,1,1,,2.0,-25,0
5672,5009170,F,Y,N,0,144000.0,Pensioner,Secondary / secondary special,Married,House / apartment,-22877,365243,1,0,1,1,,2.0,-26,0
5673,5009170,F,Y,N,0,144000.0,Pensioner,Secondary / secondary special,Married,House / apartment,-22877,365243,1,0,1,1,,2.0,-27,0
5674,5009170,F,Y,N,0,144000.0,Pensioner,Secondary / secondary special,Married,House / apartment,-22877,365243,1,0,1,1,,2.0,-28,0
5675,5009170,F,Y,N,0,144000.0,Pensioner,Secondary / secondary special,Married,House / apartment,-22877,365243,1,0,1,1,,2.0,-29,0
5676,5009170,F,Y,N,0,144000.0,Pensioner,Secondary / secondary special,Married,House / apartment,-22877,365243,1,0,1,1,,2.0,-30,0
5677,5009177,M,Y,N,0,229500.0,Working,Incomplete higher,Married,Co-op apartment,-18325,-1256,1,0,0,0,Laborers,2.0,0,C
5678,5009177,M,Y,N,0,229500.0,Working,Incomplete higher,Married,Co-op apartment,-18325,-1256,1,0,0,0,Laborers,2.0,-1,C
5679,5009177,M,Y,N,0,229500.0,Working,Incomplete higher,Married,Co-op apartment,-18325,-1256,1,0,0,0,Laborers,2.0,-2,C
5680,5009177,M,Y,N,0,229500.0,Working,Incomplete higher,Married,Co-op apartment,-18325,-1256,1,0,0,0,Laborers,2.0,-3,C
5681,5009177,M,Y,N,0,229500.0,Working,Incomplete higher,Married,Co-op apartment,-18325,-1256,1,0,0,0,Laborers,2.0,-4,C
5682,5009177,M,Y,N,0,229500.0,Working,Incomplete higher,Married,Co-op apartment,-18325,-1256,1,0,0,0,Laborers,2.0,-5,C
5683,5009177,M,Y,N,0,229500.0,Working,Incomplete higher,Married,Co-op apartment,-18325,-1256,1,0,0,0,Laborers,2.0,-6,C
5684,5009177,M,Y,N,0,229500.0,Working,Incomplete higher,Married,Co-op apartment,-18325,-1256,1,0,0,0,Laborers,2.0,-7,C
5685,5009177,M,Y,N,0,229500.0,Working,Incomplete higher,Married,Co-op apartment,-18325,-1256,1,0,0,0,Laborers,2.0,-8,C
5686,5009177,M,Y,N,0,229500.0,Working,Incomplete higher,Married,Co-op apartment,-18325,-1256,1,0,0,0,Laborers,2.0,-9,C
5687,5009177,M,Y,N,0,229500.0,Working,Incomplete higher,Married,Co-op apartment,-18325,-1256,1,0,0,0,Laborers,2.0,-10,C
5688,5009177,M,Y,N,0,229500.0,Working,Incomplete higher,Married,Co-op apartment,-18325,-1256,1,0,0,0,Laborers,2.0,-11,C
5689,5009177,M,Y,N,0,229500.0,Working,Incomplete higher,Married,Co-op apartment,-18325,-1256,1,0,0,0,Laborers,2.0,-12,0
5690,5009177,M,Y,N,0,229500.0,Working,Incomplete higher,Married,Co-op apartment,-18325,-1256,1,0,0,0,Laborers,2.0,-13,0
5691,5009177,M,Y,N,0,229500.0,Working,Incomplete higher,Married,Co-op apartment,-18325,-1256,1,0,0,0,Laborers,2.0,-14,0
5692,5009177,M,Y,N,0,229500.0,Working,Incomplete higher,Married,Co-op apartment,-18325,-1256,1,0,0,0,Laborers,2.0,-15,0
5693,5009177,M,Y,N,0,229500.0,Working,Incomplete higher,Married,Co-op apartment,-18325,-1256,1,0,0,0,Laborers,2.0,-16,0
5694,5009177,M,Y,N,0,229500.0,Working,Incomplete higher,Married,Co-op apartment,-18325,-1256,1,0,0,0,Laborers,2.0,-17,0
5695,5009177,M,Y,N,0,229500.0,Working,Incomplete higher,Married,Co-op apartment,-18325,-1256,1,0,0,0,Laborers,2.0,-18,0
5696,5009177,M,Y,N,0,229500.0,Working,Incomplete higher,Married,Co-op apartment,-18325,-1256,1,0,0,0,Laborers,2.0,-19,0
5697,5009177,M,Y,N,0,229500.0,Working,Incomplete higher,Married,Co-op apartment,-18325,-1256,1,0,0,0,Laborers,2.0,-20,0
5698,5009177,M,Y,N,0,229500.0,Working,Incomplete higher,Married,Co-op apartment,-18325,-1256,1,0,0,0,Laborers,2.0,-21,0
5699,5009177,M,Y,N,0,229500.0,Working,Incomplete higher,Married,Co-op apartment,-18325,-1256,1,0,0,0,Laborers,2.0,-22,0
5700,5009177,M,Y,N,0,229500.0,Working,Incomplete higher,Married,Co-op apartment,-18325,-1256,1,0,0,0,Laborers,2.0,-23,0
5701,5009177,M,Y,N,0,229500.0,Working,Incomplete higher,Married,Co-op apartment,-18325,-1256,1,0,0,0,Laborers,2.0,-24,0
5702,5009177,M,Y,N,0,229500.0,Working,Incomplete higher,Married,Co-op apartment,-18325,-1256,1,0,0,0,Laborers,2.0,-25,0
5703,5009177,M,Y,N,0,229500.0,Working,Incomplete higher,Married,Co-op apartment,-18325,-1256,1,0,0,0,Laborers,2.0,-26,0
5704,5009177,M,Y,N,0,229500.0,Working,Incomplete higher,Married,Co-op apartment,-18325,-1256,1,0,0,0,Laborers,2.0,-27,0
5705,5009177,M,Y,N,0,229500.0,Working,Incomplete higher,Married,Co-op apartment,-18325,-1256,1,0,0,0,Laborers,2.0,-28,0
5706,5009177,M,Y,N,0,229500.0,Working,Incomplete higher,Married,Co-op apartment,-18325,-1256,1,0,0,0,Laborers,2.0,-29,0
5707,5009177,M,Y,N,0,229500.0,Working,Incomplete higher,Married,Co-op apartment,-18325,-1256,1,0,0,0,Laborers,2.0,-30,0
5708,5009177,M,Y,N,0,229500.0,Working,Incomplete higher,Married,Co-op apartment,-18325,-1256,1,0,0,0,Laborers,2.0,-31,0
5709,5009177,M,Y,N,0,229500.0,Working,Incomplete higher,Married,Co-op apartment,-18325,-1256,1,0,0,0,Laborers,2.0,-32,0
5710,5009177,M,Y,N,0,229500.0,Working,Incomplete higher,Married,Co-op apartment,-18325,-1256,1,0,0,0,Laborers,2.0,-33,0
5711,5009177,M,Y,N,0,229500.0,Working,Incomplete higher,Married,Co-op apartment,-18325,-1256,1,0,0,0,Laborers,2.0,-34,0
5712,5009177,M,Y,N,0,229500.0,Working,Incomplete higher,Married,Co-op apartment,-18325,-1256,1,0,0,0,Laborers,2.0,-35,0
5713,5009177,M,Y,N,0,229500.0,Working,Incomplete higher,Married,Co-op apartment,-18325,-1256,1,0,0,0,Laborers,2.0,-36,0
5714,5009177,M,Y,N,0,229500.0,Working,Incomplete higher,Married,Co-op apartment,-18325,-1256,1,0,0,0,Laborers,2.0,-37,0
5715,5009177,M,Y,N,0,229500.0,Working,Incomplete higher,Married,Co-op apartment,-18325,-1256,1,0,0,0,Laborers,2.0,-38,0
5716,5009177,M,Y,N,0,229500.0,Working,Incomplete higher,Married,Co-op apartment,-18325,-1256,1,0,0,0,Laborers,2.0,-39,0
5717,5009177,M,Y,N,0,229500.0,Working,Incomplete higher,Married,Co-op apartment,-18325,-1256,1,0,0,0,Laborers,2.0,-40,0
5718,5009177,M,Y,N,0,229500.0,Working,Incomplete higher,Married,Co-op apartment,-18325,-1256,1,0,0,0,Laborers,2.0,-41,0
5719,5009177,M,Y,N,0,229500.0,Working,Incomplete higher,Married,Co-op apartment,-18325,-1256,1,0,0,0,Laborers,2.0,-42,0
5720,5009177,M,Y,N,0,229500.0,Working,Incomplete higher,Married,Co-op apartment,-18325,-1256,1,0,0,0,Laborers,2.0,-43,0
5721,5009177,M,Y,N,0,229500.0,Working,Incomplete higher,Married,Co-op apartment,-18325,-1256,1,0,0,0,Laborers,2.0,-44,0
5722,5009177,M,Y,N,0,229500.0,Working,Incomplete higher,Married,Co-op apartment,-18325,-1256,1,0,0,0,Laborers,2.0,-45,1
5723,5009177,M,Y,N,0,229500.0,Working,Incomplete higher,Married,Co-op apartment,-18325,-1256,1,0,0,0,Laborers,2.0,-46,0
5724,5009177,M,Y,N,0,229500.0,Working,Incomplete higher,Married,Co-op apartment,-18325,-1256,1,0,0,0,Laborers,2.0,-47,X
5725,5009177,M,Y,N,0,229500.0,Working,Incomplete higher,Married,Co-op apartment,-18325,-1256,1,0,0,0,Laborers,2.0,-48,X
5726,5009177,M,Y,N,0,229500.0,Working,Incomplete higher,Married,Co-op apartment,-18325,-1256,1,0,0,0,Laborers,2.0,-49,X
5727,5009178,M,Y,N,0,229500.0,Working,Incomplete higher,Married,Co-op apartment,-18325,-1256,1,0,0,0,Laborers,2.0,0,0
5728,5009178,M,Y,N,0,229500.0,Working,Incomplete higher,Married,Co-op apartment,-18325,-1256,1,0,0,0,Laborers,2.0,-1,0
5729,5009178,M,Y,N,0,229500.0,Working,Incomplete higher,Married,Co-op apartment,-18325,-1256,1,0,0,0,Laborers,2.0,-2,0
5730,5009178,M,Y,N,0,229500.0,Working,Incomplete higher,Married,Co-op apartment,-18325,-1256,1,0,0,0,Laborers,2.0,-3,0
5731,5009178,M,Y,N,0,229500.0,Working,Incomplete higher,Married,Co-op apartment,-18325,-1256,1,0,0,0,Laborers,2.0,-4,0
5732,5009178,M,Y,N,0,229500.0,Working,Incomplete higher,Married,Co-op apartment,-18325,-1256,1,0,0,0,Laborers,2.0,-5,0
5733,5009178,M,Y,N,0,229500.0,Working,Incomplete higher,Married,Co-op apartment,-18325,-1256,1,0,0,0,Laborers,2.0,-6,0
5734,5009178,M,Y,N,0,229500.0,Working,Incomplete higher,Married,Co-op apartment,-18325,-1256,1,0,0,0,Laborers,2.0,-7,0
5735,5009178,M,Y,N,0,229500.0,Working,Incomplete higher,Married,Co-op apartment,-18325,-1256,1,0,0,0,Laborers,2.0,-8,0
5736,5009178,M,Y,N,0,229500.0,Working,Incomplete higher,Married,Co-op apartment,-18325,-1256,1,0,0,0,Laborers,2.0,-9,0
5737,5009178,M,Y,N,0,229500.0,Working,Incomplete higher,Married,Co-op apartment,-18325,-1256,1,0,0,0,Laborers,2.0,-10,0
5738,5009178,M,Y,N,0,229500.0,Working,Incomplete higher,Married,Co-op apartment,-18325,-1256,1,0,0,0,Laborers,2.0,-11,0
5739,5009178,M,Y,N,0,229500.0,Working,Incomplete higher,Married,Co-op apartment,-18325,-1256,1,0,0,0,Laborers,2.0,-12,0
5740,5009178,M,Y,N,0,229500.0,Working,Incomplete higher,Married,Co-op apartment,-18325,-1256,1,0,0,0,Laborers,2.0,-13,0
5741,5009178,M,Y,N,0,229500.0,Working,Incomplete higher,Married,Co-op apartment,-18325,-1256,1,0,0,0,Laborers,2.0,-14,0
5742,5009178,M,Y,N,0,229500.0,Working,Incomplete higher,Married,Co-op apartment,-18325,-1256,1,0,0,0,Laborers,2.0,-15,0
5743,5009178,M,Y,N,0,229500.0,Working,Incomplete higher,Married,Co-op apartment,-18325,-1256,1,0,0,0,Laborers,2.0,-16,0
5744,5009178,M,Y,N,0,229500.0,Working,Incomplete higher,Married,Co-op apartment,-18325,-1256,1,0,0,0,Laborers,2.0,-17,0
5745,5009178,M,Y,N,0,229500.0,Working,Incomplete higher,Married,Co-op apartment,-18325,-1256,1,0,0,0,Laborers,2.0,-18,0
5746,5009178,M,Y,N,0,229500.0,Working,Incomplete higher,Married,Co-op apartment,-18325,-1256,1,0,0,0,Laborers,2.0,-19,0
5747,5009178,M,Y,N,0,229500.0,Working,Incomplete higher,Married,Co-op apartment,-18325,-1256,1,0,0,0,Laborers,2.0,-20,0
5748,5009178,M,Y,N,0,229500.0,Working,Incomplete higher,Married,Co-op apartment,-18325,-1256,1,0,0,0,Laborers,2.0,-21,0
5749,5009178,M,Y,N,0,229500.0,Working,Incomplete higher,Married,Co-op apartment,-18325,-1256,1,0,0,0,Laborers,2.0,-22,0
5750,5009178,M,Y,N,0,229500.0,Working,Incomplete higher,Married,Co-op apartment,-18325,-1256,1,0,0,0,Laborers,2.0,-23,0
5751,5009178,M,Y,N,0,229500.0,Working,Incomplete higher,Married,Co-op apartment,-18325,-1256,1,0,0,0,Laborers,2.0,-24,0
5752,5009178,M,Y,N,0,229500.0,Working,Incomplete higher,Married,Co-op apartment,-18325,-1256,1,0,0,0,Laborers,2.0,-25,0
5753,5009178,M,Y,N,0,229500.0,Working,Incomplete higher,Married,Co-op apartment,-18325,-1256,1,0,0,0,Laborers,2.0,-26,0
5754,5009178,M,Y,N,0,229500.0,Working,Incomplete higher,Married,Co-op apartment,-18325,-1256,1,0,0,0,Laborers,2.0,-27,0
5755,5009178,M,Y,N,0,229500.0,Working,Incomplete higher,Married,Co-op apartment,-18325,-1256,1,0,0,0,Laborers,2.0,-28,0
5756,5009178,M,Y,N,0,229500.0,Working,Incomplete higher,Married,Co-op apartment,-18325,-1256,1,0,0,0,Laborers,2.0,-29,0
5757,5009178,M,Y,N,0,229500.0,Working,Incomplete higher,Married,Co-op apartment,-18325,-1256,1,0,0,0,Laborers,2.0,-30,1
5758,5009178,M,Y,N,0,229500.0,Working,Incomplete higher,Married,Co-op apartment,-18325,-1256,1,0,0,0,Laborers,2.0,-31,0
5759,5009178,M,Y,N,0,229500.0,Working,Incomplete higher,Married,Co-op apartment,-18325,-1256,1,0,0,0,Laborers,2.0,-32,X
5760,5009178,M,Y,N,0,229500.0,Working,Incomplete higher,Married,Co-op apartment,-18325,-1256,1,0,0,0,Laborers,2.0,-33,X
5761,5009178,M,Y,N,0,229500.0,Working,Incomplete higher,Married,Co-op apartment,-18325,-1256,1,0,0,0,Laborers,2.0,-34,X
5762,5009179,M,Y,N,0,229500.0,Working,Incomplete higher,Married,Co-op apartment,-18325,-1256,1,0,0,0,Laborers,2.0,-39,C
5763,5009179,M,Y,N,0,229500.0,Working,Incomplete higher,Married,Co-op apartment,-18325,-1256,1,0,0,0,Laborers,2.0,-40,C
5764,5009179,M,Y,N,0,229500.0,Working,Incomplete higher,Married,Co-op apartment,-18325,-1256,1,0,0,0,Laborers,2.0,-41,C
5765,5009179,M,Y,N,0,229500.0,Working,Incomplete higher,Married,Co-op apartment,-18325,-1256,1,0,0,0,Laborers,2.0,-42,C
5766,5009179,M,Y,N,0,229500.0,Working,Incomplete higher,Married,Co-op apartment,-18325,-1256,1,0,0,0,Laborers,2.0,-43,C
5767,5009179,M,Y,N,0,229500.0,Working,Incomplete higher,Married,Co-op apartment,-18325,-1256,1,0,0,0,Laborers,2.0,-44,C
5768,5009179,M,Y,N,0,229500.0,Working,Incomplete higher,Married,Co-op apartment,-18325,-1256,1,0,0,0,Laborers,2.0,-45,C
5769,5009179,M,Y,N,0,229500.0,Working,Incomplete higher,Married,Co-op apartment,-18325,-1256,1,0,0,0,Laborers,2.0,-46,C
5770,5009179,M,Y,N,0,229500.0,Working,Incomplete higher,Married,Co-op apartment,-18325,-1256,1,0,0,0,Laborers,2.0,-47,C
5771,5009179,M,Y,N,0,229500.0,Working,Incomplete higher,Married,Co-op apartment,-18325,-1256,1,0,0,0,Laborers,2.0,-48,C
5772,5009179,M,Y,N,0,229500.0,Working,Incomplete higher,Married,Co-op apartment,-18325,-1256,1,0,0,0,Laborers,2.0,-49,C
5773,5009179,M,Y,N,0,229500.0,Working,Incomplete higher,Married,Co-op apartment,-18325,-1256,1,0,0,0,Laborers,2.0,-50,0
5774,5009179,M,Y,N,0,229500.0,Working,Incomplete higher,Married,Co-op apartment,-18325,-1256,1,0,0,0,Laborers,2.0,-51,0
5775,5009180,M,Y,N,0,229500.0,Working,Incomplete higher,Married,Co-op apartment,-18325,-1256,1,0,0,0,Laborers,2.0,0,C
5776,5009180,M,Y,N,0,229500.0,Working,Incomplete higher,Married,Co-op apartment,-18325,-1256,1,0,0,0,Laborers,2.0,-1,0
5777,5009180,M,Y,N,0,229500.0,Working,Incomplete higher,Married,Co-op apartment,-18325,-1256,1,0,0,0,Laborers,2.0,-2,0
5778,5009180,M,Y,N,0,229500.0,Working,Incomplete higher,Married,Co-op apartment,-18325,-1256,1,0,0,0,Laborers,2.0,-3,0
5779,5009180,M,Y,N,0,229500.0,Working,Incomplete higher,Married,Co-op apartment,-18325,-1256,1,0,0,0,Laborers,2.0,-4,0
5780,5009180,M,Y,N,0,229500.0,Working,Incomplete higher,Married,Co-op apartment,-18325,-1256,1,0,0,0,Laborers,2.0,-5,0
5781,5009180,M,Y,N,0,229500.0,Working,Incomplete higher,Married,Co-op apartment,-18325,-1256,1,0,0,0,Laborers,2.0,-6,0
5782,5009180,M,Y,N,0,229500.0,Working,Incomplete higher,Married,Co-op apartment,-18325,-1256,1,0,0,0,Laborers,2.0,-7,0
5783,5009180,M,Y,N,0,229500.0,Working,Incomplete higher,Married,Co-op apartment,-18325,-1256,1,0,0,0,Laborers,2.0,-8,0
5784,5009180,M,Y,N,0,229500.0,Working,Incomplete higher,Married,Co-op apartment,-18325,-1256,1,0,0,0,Laborers,2.0,-9,0
5785,5009180,M,Y,N,0,229500.0,Working,Incomplete higher,Married,Co-op apartment,-18325,-1256,1,0,0,0,Laborers,2.0,-10,0
5786,5009180,M,Y,N,0,229500.0,Working,Incomplete higher,Married,Co-op apartment,-18325,-1256,1,0,0,0,Laborers,2.0,-11,0
5787,5009180,M,Y,N,0,229500.0,Working,Incomplete higher,Married,Co-op apartment,-18325,-1256,1,0,0,0,Laborers,2.0,-12,0
5788,5009180,M,Y,N,0,229500.0,Working,Incomplete higher,Married,Co-op apartment,-18325,-1256,1,0,0,0,Laborers,2.0,-13,0
5789,5009180,M,Y,N,0,229500.0,Working,Incomplete higher,Married,Co-op apartment,-18325,-1256,1,0,0,0,Laborers,2.0,-14,0
5790,5009180,M,Y,N,0,229500.0,Working,Incomplete higher,Married,Co-op apartment,-18325,-1256,1,0,0,0,Laborers,2.0,-15,0
5791,5009180,M,Y,N,0,229500.0,Working,Incomplete higher,Married,Co-op apartment,-18325,-1256,1,0,0,0,Laborers,2.0,-16,0
5792,5009180,M,Y,N,0,229500.0,Working,Incomplete higher,Married,Co-op apartment,-18325,-1256,1,0,0,0,Laborers,2.0,-17,0
5793,5009180,M,Y,N,0,229500.0,Working,Incomplete higher,Married,Co-op apartment,-18325,-1256,1,0,0,0,Laborers,2.0,-18,0
5794,5009180,M,Y,N,0,229500.0,Working,Incomplete higher,Married,Co-op apartment,-18325,-1256,1,0,0,0,Laborers,2.0,-19,0
5795,5009180,M,Y,N,0,229500.0,Working,Incomplete higher,Married,Co-op apartment,-18325,-1256,1,0,0,0,Laborers,2.0,-20,0
5796,5009180,M,Y,N,0,229500.0,Working,Incomplete higher,Married,Co-op apartment,-18325,-1256,1,0,0,0,Laborers,2.0,-21,0
5797,5009180,M,Y,N,0,229500.0,Working,Incomplete higher,Married,Co-op apartment,-18325,-1256,1,0,0,0,Laborers,2.0,-22,0
5798,5009180,M,Y,N,0,229500.0,Working,Incomplete higher,Married,Co-op apartment,-18325,-1256,1,0,0,0,Laborers,2.0,-23,0
5799,5009180,M,Y,N,0,229500.0,Working,Incomplete higher,Married,Co-op apartment,-18325,-1256,1,0,0,0,Laborers,2.0,-24,0
5800,5009180,M,Y,N,0,229500.0,Working,Incomplete higher,Married,Co-op apartment,-18325,-1256,1,0,0,0,Laborers,2.0,-25,0
5801,5009180,M,Y,N,0,229500.0,Working,Incomplete higher,Married,Co-op apartment,-18325,-1256,1,0,0,0,Laborers,2.0,-26,0
5802,5009180,M,Y,N,0,229500.0,Working,Incomplete higher,Married,Co-op apartment,-18325,-1256,1,0,0,0,Laborers,2.0,-27,0
5803,5009180,M,Y,N,0,229500.0,Working,Incomplete higher,Married,Co-op apartment,-18325,-1256,1,0,0,0,Laborers,2.0,-28,0
5804,5009180,M,Y,N,0,229500.0,Working,Incomplete higher,Married,Co-op apartment,-18325,-1256,1,0,0,0,Laborers,2.0,-29,0
5805,5009180,M,Y,N,0,229500.0,Working,Incomplete higher,Married,Co-op apartment,-18325,-1256,1,0,0,0,Laborers,2.0,-30,0
5806,5009180,M,Y,N,0,229500.0,Working,Incomplete higher,Married,Co-op apartment,-18325,-1256,1,0,0,0,Laborers,2.0,-31,0
5807,5009180,M,Y,N,0,229500.0,Working,Incomplete higher,Married,Co-op apartment,-18325,-1256,1,0,0,0,Laborers,2.0,-32,0
5808,5009180,M,Y,N,0,229500.0,Working,Incomplete higher,Married,Co-op apartment,-18325,-1256,1,0,0,0,Laborers,2.0,-33,0
5809,5009180,M,Y,N,0,229500.0,Working,Incomplete higher,Married,Co-op apartment,-18325,-1256,1,0,0,0,Laborers,2.0,-34,1
5810,5009180,M,Y,N,0,229500.0,Working,Incomplete higher,Married,Co-op apartment,-18325,-1256,1,0,0,0,Laborers,2.0,-35,0
5811,5009180,M,Y,N,0,229500.0,Working,Incomplete higher,Married,Co-op apartment,-18325,-1256,1,0,0,0,Laborers,2.0,-36,X
5812,5009180,M,Y,N,0,229500.0,Working,Incomplete higher,Married,Co-op apartment,-18325,-1256,1,0,0,0,Laborers,2.0,-37,X
5813,5009180,M,Y,N,0,229500.0,Working,Incomplete higher,Married,Co-op apartment,-18325,-1256,1,0,0,0,Laborers,2.0,-38,X
5814,5009181,M,Y,N,0,229500.0,Working,Incomplete higher,Married,Co-op apartment,-18325,-1256,1,0,0,0,Laborers,2.0,0,0
5815,5009181,M,Y,N,0,229500.0,Working,Incomplete higher,Married,Co-op apartment,-18325,-1256,1,0,0,0,Laborers,2.0,-1,0
5816,5009181,M,Y,N,0,229500.0,Working,Incomplete higher,Married,Co-op apartment,-18325,-1256,1,0,0,0,Laborers,2.0,-2,0
5817,5009181,M,Y,N,0,229500.0,Working,Incomplete higher,Married,Co-op apartment,-18325,-1256,1,0,0,0,Laborers,2.0,-3,0
5818,5009181,M,Y,N,0,229500.0,Working,Incomplete higher,Married,Co-op apartment,-18325,-1256,1,0,0,0,Laborers,2.0,-4,0
5819,5009181,M,Y,N,0,229500.0,Working,Incomplete higher,Married,Co-op apartment,-18325,-1256,1,0,0,0,Laborers,2.0,-5,0
5820,5009181,M,Y,N,0,229500.0,Working,Incomplete higher,Married,Co-op apartment,-18325,-1256,1,0,0,0,Laborers,2.0,-6,0
5821,5009181,M,Y,N,0,229500.0,Working,Incomplete higher,Married,Co-op apartment,-18325,-1256,1,0,0,0,Laborers,2.0,-7,0
5822,5009181,M,Y,N,0,229500.0,Working,Incomplete higher,Married,Co-op apartment,-18325,-1256,1,0,0,0,Laborers,2.0,-8,1
5823,5009181,M,Y,N,0,229500.0,Working,Incomplete higher,Married,Co-op apartment,-18325,-1256,1,0,0,0,Laborers,2.0,-9,0
5824,5009181,M,Y,N,0,229500.0,Working,Incomplete higher,Married,Co-op apartment,-18325,-1256,1,0,0,0,Laborers,2.0,-10,X
5825,5009181,M,Y,N,0,229500.0,Working,Incomplete higher,Married,Co-op apartment,-18325,-1256,1,0,0,0,Laborers,2.0,-11,X
5826,5009181,M,Y,N,0,229500.0,Working,Incomplete higher,Married,Co-op apartment,-18325,-1256,1,0,0,0,Laborers,2.0,-12,X
5827,5009182,M,Y,N,0,229500.0,Working,Incomplete higher,Married,Co-op apartment,-18325,-1256,1,0,0,0,Laborers,2.0,0,C
5828,5009182,M,Y,N,0,229500.0,Working,Incomplete higher,Married,Co-op apartment,-18325,-1256,1,0,0,0,Laborers,2.0,-1,C
5829,5009182,M,Y,N,0,229500.0,Working,Incomplete higher,Married,Co-op apartment,-18325,-1256,1,0,0,0,Laborers,2.0,-2,C
5830,5009182,M,Y,N,0,229500.0,Working,Incomplete higher,Married,Co-op apartment,-18325,-1256,1,0,0,0,Laborers,2.0,-3,C
5831,5009182,M,Y,N,0,229500.0,Working,Incomplete higher,Married,Co-op apartment,-18325,-1256,1,0,0,0,Laborers,2.0,-4,C
5832,5009182,M,Y,N,0,229500.0,Working,Incomplete higher,Married,Co-op apartment,-18325,-1256,1,0,0,0,Laborers,2.0,-5,C
5833,5009182,M,Y,N,0,229500.0,Working,Incomplete higher,Married,Co-op apartment,-18325,-1256,1,0,0,0,Laborers,2.0,-6,C
5834,5009182,M,Y,N,0,229500.0,Working,Incomplete higher,Married,Co-op apartment,-18325,-1256,1,0,0,0,Laborers,2.0,-7,C
5835,5009182,M,Y,N,0,229500.0,Working,Incomplete higher,Married,Co-op apartment,-18325,-1256,1,0,0,0,Laborers,2.0,-8,C
5836,5009182,M,Y,N,0,229500.0,Working,Incomplete higher,Married,Co-op apartment,-18325,-1256,1,0,0,0,Laborers,2.0,-9,C
5837,5009182,M,Y,N,0,229500.0,Working,Incomplete higher,Married,Co-op apartment,-18325,-1256,1,0,0,0,Laborers,2.0,-10,C
5838,5009182,M,Y,N,0,229500.0,Working,Incomplete higher,Married,Co-op apartment,-18325,-1256,1,0,0,0,Laborers,2.0,-11,C
5839,5009182,M,Y,N,0,229500.0,Working,Incomplete higher,Married,Co-op apartment,-18325,-1256,1,0,0,0,Laborers,2.0,-12,C
5840,5009182,M,Y,N,0,229500.0,Working,Incomplete higher,Married,Co-op apartment,-18325,-1256,1,0,0,0,Laborers,2.0,-13,C
5841,5009182,M,Y,N,0,229500.0,Working,Incomplete higher,Married,Co-op apartment,-18325,-1256,1,0,0,0,Laborers,2.0,-14,C
5842,5009182,M,Y,N,0,229500.0,Working,Incomplete higher,Married,Co-op apartment,-18325,-1256,1,0,0,0,Laborers,2.0,-15,C
5843,5009182,M,Y,N,0,229500.0,Working,Incomplete higher,Married,Co-op apartment,-18325,-1256,1,0,0,0,Laborers,2.0,-16,C
5844,5009182,M,Y,N,0,229500.0,Working,Incomplete higher,Married,Co-op apartment,-18325,-1256,1,0,0,0,Laborers,2.0,-17,C
5845,5009182,M,Y,N,0,229500.0,Working,Incomplete higher,Married,Co-op apartment,-18325,-1256,1,0,0,0,Laborers,2.0,-18,C
5846,5009182,M,Y,N,0,229500.0,Working,Incomplete higher,Married,Co-op apartment,-18325,-1256,1,0,0,0,Laborers,2.0,-19,C
5847,5009182,M,Y,N,0,229500.0,Working,Incomplete higher,Married,Co-op apartment,-18325,-1256,1,0,0,0,Laborers,2.0,-20,C
5848,5009182,M,Y,N,0,229500.0,Working,Incomplete higher,Married,Co-op apartment,-18325,-1256,1,0,0,0,Laborers,2.0,-21,C
5849,5009182,M,Y,N,0,229500.0,Working,Incomplete higher,Married,Co-op apartment,-18325,-1256,1,0,0,0,Laborers,2.0,-22,C
5850,5009182,M,Y,N,0,229500.0,Working,Incomplete higher,Married,Co-op apartment,-18325,-1256,1,0,0,0,Laborers,2.0,-23,C
5851,5009182,M,Y,N,0,229500.0,Working,Incomplete higher,Married,Co-op apartment,-18325,-1256,1,0,0,0,Laborers,2.0,-24,C
5852,5009182,M,Y,N,0,229500.0,Working,Incomplete higher,Married,Co-op apartment,-18325,-1256,1,0,0,0,Laborers,2.0,-25,C
5853,5009182,M,Y,N,0,229500.0,Working,Incomplete higher,Married,Co-op apartment,-18325,-1256,1,0,0,0,Laborers,2.0,-26,C
5854,5009182,M,Y,N,0,229500.0,Working,Incomplete higher,Married,Co-op apartment,-18325,-1256,1,0,0,0,Laborers,2.0,-27,C
5855,5009182,M,Y,N,0,229500.0,Working,Incomplete higher,Married,Co-op apartment,-18325,-1256,1,0,0,0,Laborers,2.0,-28,C
5856,5009182,M,Y,N,0,229500.0,Working,Incomplete higher,Married,Co-op apartment,-18325,-1256,1,0,0,0,Laborers,2.0,-29,0
5857,5009182,M,Y,N,0,229500.0,Working,Incomplete higher,Married,Co-op apartment,-18325,-1256,1,0,0,0,Laborers,2.0,-30,0
5858,5009182,M,Y,N,0,229500.0,Working,Incomplete higher,Married,Co-op apartment,-18325,-1256,1,0,0,0,Laborers,2.0,-31,0
5859,5009182,M,Y,N,0,229500.0,Working,Incomplete higher,Married,Co-op apartment,-18325,-1256,1,0,0,0,Laborers,2.0,-32,0
5860,5009182,M,Y,N,0,229500.0,Working,Incomplete higher,Married,Co-op apartment,-18325,-1256,1,0,0,0,Laborers,2.0,-33,0
5861,5009182,M,Y,N,0,229500.0,Working,Incomplete higher,Married,Co-op apartment,-18325,-1256,1,0,0,0,Laborers,2.0,-34,0
5862,5009183,M,Y,N,0,229500.0,Working,Incomplete higher,Married,Co-op apartment,-18325,-1256,1,0,0,0,Laborers,2.0,0,C
5863,5009183,M,Y,N,0,229500.0,Working,Incomplete higher,Married,Co-op apartment,-18325,-1256,1,0,0,0,Laborers,2.0,-1,C
5864,5009183,M,Y,N,0,229500.0,Working,Incomplete higher,Married,Co-op apartment,-18325,-1256,1,0,0,0,Laborers,2.0,-2,C
5865,5009183,M,Y,N,0,229500.0,Working,Incomplete higher,Married,Co-op apartment,-18325,-1256,1,0,0,0,Laborers,2.0,-3,C
5866,5009183,M,Y,N,0,229500.0,Working,Incomplete higher,Married,Co-op apartment,-18325,-1256,1,0,0,0,Laborers,2.0,-4,C
5867,5009183,M,Y,N,0,229500.0,Working,Incomplete higher,Married,Co-op apartment,-18325,-1256,1,0,0,0,Laborers,2.0,-5,C
5868,5009183,M,Y,N,0,229500.0,Working,Incomplete higher,Married,Co-op apartment,-18325,-1256,1,0,0,0,Laborers,2.0,-6,C
5869,5009183,M,Y,N,0,229500.0,Working,Incomplete higher,Married,Co-op apartment,-18325,-1256,1,0,0,0,Laborers,2.0,-7,C
5870,5009183,M,Y,N,0,229500.0,Working,Incomplete higher,Married,Co-op apartment,-18325,-1256,1,0,0,0,Laborers,2.0,-8,C
5871,5009183,M,Y,N,0,229500.0,Working,Incomplete higher,Married,Co-op apartment,-18325,-1256,1,0,0,0,Laborers,2.0,-9,C
5872,5009183,M,Y,N,0,229500.0,Working,Incomplete higher,Married,Co-op apartment,-18325,-1256,1,0,0,0,Laborers,2.0,-10,C
5873,5009183,M,Y,N,0,229500.0,Working,Incomplete higher,Married,Co-op apartment,-18325,-1256,1,0,0,0,Laborers,2.0,-11,C
5874,5009183,M,Y,N,0,229500.0,Working,Incomplete higher,Married,Co-op apartment,-18325,-1256,1,0,0,0,Laborers,2.0,-12,C
5875,5009183,M,Y,N,0,229500.0,Working,Incomplete higher,Married,Co-op apartment,-18325,-1256,1,0,0,0,Laborers,2.0,-13,C
5876,5009183,M,Y,N,0,229500.0,Working,Incomplete higher,Married,Co-op apartment,-18325,-1256,1,0,0,0,Laborers,2.0,-14,C
5877,5009183,M,Y,N,0,229500.0,Working,Incomplete higher,Married,Co-op apartment,-18325,-1256,1,0,0,0,Laborers,2.0,-15,C
5878,5009183,M,Y,N,0,229500.0,Working,Incomplete higher,Married,Co-op apartment,-18325,-1256,1,0,0,0,Laborers,2.0,-16,C
5879,5009183,M,Y,N,0,229500.0,Working,Incomplete higher,Married,Co-op apartment,-18325,-1256,1,0,0,0,Laborers,2.0,-17,C
5880,5009183,M,Y,N,0,229500.0,Working,Incomplete higher,Married,Co-op apartment,-18325,-1256,1,0,0,0,Laborers,2.0,-18,C
5881,5009183,M,Y,N,0,229500.0,Working,Incomplete higher,Married,Co-op apartment,-18325,-1256,1,0,0,0,Laborers,2.0,-19,C
5882,5009183,M,Y,N,0,229500.0,Working,Incomplete higher,Married,Co-op apartment,-18325,-1256,1,0,0,0,Laborers,2.0,-20,C
5883,5009183,M,Y,N,0,229500.0,Working,Incomplete higher,Married,Co-op apartment,-18325,-1256,1,0,0,0,Laborers,2.0,-21,C
5884,5009183,M,Y,N,0,229500.0,Working,Incomplete higher,Married,Co-op apartment,-18325,-1256,1,0,0,0,Laborers,2.0,-22,C
5885,5009183,M,Y,N,0,229500.0,Working,Incomplete higher,Married,Co-op apartment,-18325,-1256,1,0,0,0,Laborers,2.0,-23,C
5886,5009183,M,Y,N,0,229500.0,Working,Incomplete higher,Married,Co-op apartment,-18325,-1256,1,0,0,0,Laborers,2.0,-24,C
5887,5009183,M,Y,N,0,229500.0,Working,Incomplete higher,Married,Co-op apartment,-18325,-1256,1,0,0,0,Laborers,2.0,-25,C
5888,5009183,M,Y,N,0,229500.0,Working,Incomplete higher,Married,Co-op apartment,-18325,-1256,1,0,0,0,Laborers,2.0,-26,C
5889,5009183,M,Y,N,0,229500.0,Working,Incomplete higher,Married,Co-op apartment,-18325,-1256,1,0,0,0,Laborers,2.0,-27,C
5890,5009183,M,Y,N,0,229500.0,Working,Incomplete higher,Married,Co-op apartment,-18325,-1256,1,0,0,0,Laborers,2.0,-28,C
5891,5009183,M,Y,N,0,229500.0,Working,Incomplete higher,Married,Co-op apartment,-18325,-1256,1,0,0,0,Laborers,2.0,-29,0
5892,5009183,M,Y,N,0,229500.0,Working,Incomplete higher,Married,Co-op apartment,-18325,-1256,1,0,0,0,Laborers,2.0,-30,0
5893,5009183,M,Y,N,0,229500.0,Working,Incomplete higher,Married,Co-op apartment,-18325,-1256,1,0,0,0,Laborers,2.0,-31,X
5894,5009186,F,N,N,0,270000.0,Working,Higher education,Married,House / apartment,-17573,-5792,1,1,1,0,Managers,2.0,0,0
5895,5009186,F,N,N,0,270000.0,Working,Higher education,Married,House / apartment,-17573,-5792,1,1,1,0,Managers,2.0,-1,0
5896,5009186,F,N,N,0,270000.0,Working,Higher education,Married,House / apartment,-17573,-5792,1,1,1,0,Managers,2.0,-2,1
5897,5009186,F,N,N,0,270000.0,Working,Higher education,Married,House / apartment,-17573,-5792,1,1,1,0,Managers,2.0,-3,0
5898,5009187,F,N,N,0,270000.0,Working,Higher education,Married,House / apartment,-17573,-5792,1,1,1,0,Managers,2.0,0,0
5899,5009187,F,N,N,0,270000.0,Working,Higher education,Married,House / apartment,-17573,-5792,1,1,1,0,Managers,2.0,-1,0
5900,5009187,F,N,N,0,270000.0,Working,Higher education,Married,House / apartment,-17573,-5792,1,1,1,0,Managers,2.0,-2,0
5901,5009187,F,N,N,0,270000.0,Working,Higher education,Married,House / apartment,-17573,-5792,1,1,1,0,Managers,2.0,-3,0
5902,5009187,F,N,N,0,270000.0,Working,Higher education,Married,House / apartment,-17573,-5792,1,1,1,0,Managers,2.0,-4,0
5903,5009187,F,N,N,0,270000.0,Working,Higher education,Married,House / apartment,-17573,-5792,1,1,1,0,Managers,2.0,-5,0
5904,5009188,F,N,N,0,270000.0,Working,Higher education,Married,House / apartment,-17573,-5792,1,1,1,0,Managers,2.0,0,C
5905,5009188,F,N,N,0,270000.0,Working,Higher education,Married,House / apartment,-17573,-5792,1,1,1,0,Managers,2.0,-1,C
5906,5009188,F,N,N,0,270000.0,Working,Higher education,Married,House / apartment,-17573,-5792,1,1,1,0,Managers,2.0,-2,C
5907,5009188,F,N,N,0,270000.0,Working,Higher education,Married,House / apartment,-17573,-5792,1,1,1,0,Managers,2.0,-3,C
5908,5009188,F,N,N,0,270000.0,Working,Higher education,Married,House / apartment,-17573,-5792,1,1,1,0,Managers,2.0,-4,C
5909,5009188,F,N,N,0,270000.0,Working,Higher education,Married,House / apartment,-17573,-5792,1,1,1,0,Managers,2.0,-5,C
5910,5009188,F,N,N,0,270000.0,Working,Higher education,Married,House / apartment,-17573,-5792,1,1,1,0,Managers,2.0,-6,0
5911,5009188,F,N,N,0,270000.0,Working,Higher education,Married,House / apartment,-17573,-5792,1,1,1,0,Managers,2.0,-7,0
5912,5009188,F,N,N,0,270000.0,Working,Higher education,Married,House / apartment,-17573,-5792,1,1,1,0,Managers,2.0,-8,0
5913,5009188,F,N,N,0,270000.0,Working,Higher education,Married,House / apartment,-17573,-5792,1,1,1,0,Managers,2.0,-9,0
5914,5009188,F,N,N,0,270000.0,Working,Higher education,Married,House / apartment,-17573,-5792,1,1,1,0,Managers,2.0,-10,0
5915,5009188,F,N,N,0,270000.0,Working,Higher education,Married,House / apartment,-17573,-5792,1,1,1,0,Managers,2.0,-11,0
5916,5009188,F,N,N,0,270000.0,Working,Higher education,Married,House / apartment,-17573,-5792,1,1,1,0,Managers,2.0,-12,0
5917,5009188,F,N,N,0,270000.0,Working,Higher education,Married,House / apartment,-17573,-5792,1,1,1,0,Managers,2.0,-13,0
5918,5009188,F,N,N,0,270000.0,Working,Higher education,Married,House / apartment,-17573,-5792,1,1,1,0,Managers,2.0,-14,0
5919,5009188,F,N,N,0,270000.0,Working,Higher education,Married,House / apartment,-17573,-5792,1,1,1,0,Managers,2.0,-15,0
5920,5009188,F,N,N,0,270000.0,Working,Higher education,Married,House / apartment,-17573,-5792,1,1,1,0,Managers,2.0,-16,0
5921,5009189,F,N,N,0,270000.0,Working,Higher education,Married,House / apartment,-17573,-5792,1,1,1,0,Managers,2.0,0,C
5922,5009189,F,N,N,0,270000.0,Working,Higher education,Married,House / apartment,-17573,-5792,1,1,1,0,Managers,2.0,-1,C
5923,5009189,F,N,N,0,270000.0,Working,Higher education,Married,House / apartment,-17573,-5792,1,1,1,0,Managers,2.0,-2,C
5924,5009189,F,N,N,0,270000.0,Working,Higher education,Married,House / apartment,-17573,-5792,1,1,1,0,Managers,2.0,-3,C
5925,5009189,F,N,N,0,270000.0,Working,Higher education,Married,House / apartment,-17573,-5792,1,1,1,0,Managers,2.0,-4,C
5926,5009189,F,N,N,0,270000.0,Working,Higher education,Married,House / apartment,-17573,-5792,1,1,1,0,Managers,2.0,-5,C
5927,5009189,F,N,N,0,270000.0,Working,Higher education,Married,House / apartment,-17573,-5792,1,1,1,0,Managers,2.0,-6,C
5928,5009189,F,N,N,0,270000.0,Working,Higher education,Married,House / apartment,-17573,-5792,1,1,1,0,Managers,2.0,-7,0
5929,5009189,F,N,N,0,270000.0,Working,Higher education,Married,House / apartment,-17573,-5792,1,1,1,0,Managers,2.0,-8,0
5930,5009189,F,N,N,0,270000.0,Working,Higher education,Married,House / apartment,-17573,-5792,1,1,1,0,Managers,2.0,-9,0
5931,5009189,F,N,N,0,270000.0,Working,Higher education,Married,House / apartment,-17573,-5792,1,1,1,0,Managers,2.0,-10,0
5932,5009189,F,N,N,0,270000.0,Working,Higher education,Married,House / apartment,-17573,-5792,1,1,1,0,Managers,2.0,-11,0
5933,5009189,F,N,N,0,270000.0,Working,Higher education,Married,House / apartment,-17573,-5792,1,1,1,0,Managers,2.0,-12,0
5934,5009189,F,N,N,0,270000.0,Working,Higher education,Married,House / apartment,-17573,-5792,1,1,1,0,Managers,2.0,-13,0
5935,5009189,F,N,N,0,270000.0,Working,Higher education,Married,House / apartment,-17573,-5792,1,1,1,0,Managers,2.0,-14,0
5936,5009189,F,N,N,0,270000.0,Working,Higher education,Married,House / apartment,-17573,-5792,1,1,1,0,Managers,2.0,-15,0
5937,5009189,F,N,N,0,270000.0,Working,Higher education,Married,House / apartment,-17573,-5792,1,1,1,0,Managers,2.0,-16,X
5938,5009190,F,N,N,0,270000.0,Working,Higher education,Married,House / apartment,-17573,-5792,1,1,1,0,Managers,2.0,0,C
5939,5009190,F,N,N,0,270000.0,Working,Higher education,Married,House / apartment,-17573,-5792,1,1,1,0,Managers,2.0,-1,C
5940,5009190,F,N,N,0,270000.0,Working,Higher education,Married,House / apartment,-17573,-5792,1,1,1,0,Managers,2.0,-2,C
5941,5009190,F,N,N,0,270000.0,Working,Higher education,Married,House / apartment,-17573,-5792,1,1,1,0,Managers,2.0,-3,C
5942,5009190,F,N,N,0,270000.0,Working,Higher education,Married,House / apartment,-17573,-5792,1,1,1,0,Managers,2.0,-4,C
5943,5009190,F,N,N,0,270000.0,Working,Higher education,Married,House / apartment,-17573,-5792,1,1,1,0,Managers,2.0,-5,C
5944,5009190,F,N,N,0,270000.0,Working,Higher education,Married,House / apartment,-17573,-5792,1,1,1,0,Managers,2.0,-6,C
5945,5009190,F,N,N,0,270000.0,Working,Higher education,Married,House / apartment,-17573,-5792,1,1,1,0,Managers,2.0,-7,C
5946,5009190,F,N,N,0,270000.0,Working,Higher education,Married,House / apartment,-17573,-5792,1,1,1,0,Managers,2.0,-8,C
5947,5009190,F,N,N,0,270000.0,Working,Higher education,Married,House / apartment,-17573,-5792,1,1,1,0,Managers,2.0,-9,C
5948,5009190,F,N,N,0,270000.0,Working,Higher education,Married,House / apartment,-17573,-5792,1,1,1,0,Managers,2.0,-10,C
5949,5009190,F,N,N,0,270000.0,Working,Higher education,Married,House / apartment,-17573,-5792,1,1,1,0,Managers,2.0,-11,C
5950,5009190,F,N,N,0,270000.0,Working,Higher education,Married,House / apartment,-17573,-5792,1,1,1,0,Managers,2.0,-12,C
5951,5009190,F,N,N,0,270000.0,Working,Higher education,Married,House / apartment,-17573,-5792,1,1,1,0,Managers,2.0,-13,C
5952,5009190,F,N,N,0,270000.0,Working,Higher education,Married,House / apartment,-17573,-5792,1,1,1,0,Managers,2.0,-14,C
5953,5009190,F,N,N,0,270000.0,Working,Higher education,Married,House / apartment,-17573,-5792,1,1,1,0,Managers,2.0,-15,C
5954,5009190,F,N,N,0,270000.0,Working,Higher education,Married,House / apartment,-17573,-5792,1,1,1,0,Managers,2.0,-16,C
5955,5009190,F,N,N,0,270000.0,Working,Higher education,Married,House / apartment,-17573,-5792,1,1,1,0,Managers,2.0,-17,C
5956,5009190,F,N,N,0,270000.0,Working,Higher education,Married,House / apartment,-17573,-5792,1,1,1,0,Managers,2.0,-18,C
5957,5009190,F,N,N,0,270000.0,Working,Higher education,Married,House / apartment,-17573,-5792,1,1,1,0,Managers,2.0,-19,C
5958,5009190,F,N,N,0,270000.0,Working,Higher education,Married,House / apartment,-17573,-5792,1,1,1,0,Managers,2.0,-20,0
5959,5009190,F,N,N,0,270000.0,Working,Higher education,Married,House / apartment,-17573,-5792,1,1,1,0,Managers,2.0,-21,0
5960,5009190,F,N,N,0,270000.0,Working,Higher education,Married,House / apartment,-17573,-5792,1,1,1,0,Managers,2.0,-22,0
5961,5009191,F,N,N,0,270000.0,Working,Higher education,Married,House / apartment,-17573,-5792,1,1,1,0,Managers,2.0,-12,C
5962,5009191,F,N,N,0,270000.0,Working,Higher education,Married,House / apartment,-17573,-5792,1,1,1,0,Managers,2.0,-13,C
5963,5009191,F,N,N,0,270000.0,Working,Higher education,Married,House / apartment,-17573,-5792,1,1,1,0,Managers,2.0,-14,C
5964,5009191,F,N,N,0,270000.0,Working,Higher education,Married,House / apartment,-17573,-5792,1,1,1,0,Managers,2.0,-15,C
5965,5009191,F,N,N,0,270000.0,Working,Higher education,Married,House / apartment,-17573,-5792,1,1,1,0,Managers,2.0,-16,C
5966,5009191,F,N,N,0,270000.0,Working,Higher education,Married,House / apartment,-17573,-5792,1,1,1,0,Managers,2.0,-17,C
5967,5009191,F,N,N,0,270000.0,Working,Higher education,Married,House / apartment,-17573,-5792,1,1,1,0,Managers,2.0,-18,C
5968,5009191,F,N,N,0,270000.0,Working,Higher education,Married,House / apartment,-17573,-5792,1,1,1,0,Managers,2.0,-19,C
5969,5009191,F,N,N,0,270000.0,Working,Higher education,Married,House / apartment,-17573,-5792,1,1,1,0,Managers,2.0,-20,0
5970,5009191,F,N,N,0,270000.0,Working,Higher education,Married,House / apartment,-17573,-5792,1,1,1,0,Managers,2.0,-21,0
5971,5009191,F,N,N,0,270000.0,Working,Higher education,Married,House / apartment,-17573,-5792,1,1,1,0,Managers,2.0,-22,0
5972,5009191,F,N,N,0,270000.0,Working,Higher education,Married,House / apartment,-17573,-5792,1,1,1,0,Managers,2.0,-23,0
5973,5009191,F,N,N,0,270000.0,Working,Higher education,Married,House / apartment,-17573,-5792,1,1,1,0,Managers,2.0,-24,0
5974,5009191,F,N,N,0,270000.0,Working,Higher education,Married,House / apartment,-17573,-5792,1,1,1,0,Managers,2.0,-25,0
5975,5009191,F,N,N,0,270000.0,Working,Higher education,Married,House / apartment,-17573,-5792,1,1,1,0,Managers,2.0,-26,0
5976,5009191,F,N,N,0,270000.0,Working,Higher education,Married,House / apartment,-17573,-5792,1,1,1,0,Managers,2.0,-27,0
5977,5009191,F,N,N,0,270000.0,Working,Higher education,Married,House / apartment,-17573,-5792,1,1,1,0,Managers,2.0,-28,0
5978,5009192,F,N,N,0,270000.0,Working,Higher education,Married,House / apartment,-17573,-5792,1,1,1,0,Managers,2.0,0,C
5979,5009192,F,N,N,0,270000.0,Working,Higher education,Married,House / apartment,-17573,-5792,1,1,1,0,Managers,2.0,-1,C
5980,5009192,F,N,N,0,270000.0,Working,Higher education,Married,House / apartment,-17573,-5792,1,1,1,0,Managers,2.0,-2,C
5981,5009192,F,N,N,0,270000.0,Working,Higher education,Married,House / apartment,-17573,-5792,1,1,1,0,Managers,2.0,-3,C
5982,5009192,F,N,N,0,270000.0,Working,Higher education,Married,House / apartment,-17573,-5792,1,1,1,0,Managers,2.0,-4,C
5983,5009192,F,N,N,0,270000.0,Working,Higher education,Married,House / apartment,-17573,-5792,1,1,1,0,Managers,2.0,-5,C
5984,5009192,F,N,N,0,270000.0,Working,Higher education,Married,House / apartment,-17573,-5792,1,1,1,0,Managers,2.0,-6,C
5985,5009192,F,N,N,0,270000.0,Working,Higher education,Married,House / apartment,-17573,-5792,1,1,1,0,Managers,2.0,-7,C
5986,5009192,F,N,N,0,270000.0,Working,Higher education,Married,House / apartment,-17573,-5792,1,1,1,0,Managers,2.0,-8,C
5987,5009192,F,N,N,0,270000.0,Working,Higher education,Married,House / apartment,-17573,-5792,1,1,1,0,Managers,2.0,-9,C
5988,5009192,F,N,N,0,270000.0,Working,Higher education,Married,House / apartment,-17573,-5792,1,1,1,0,Managers,2.0,-10,C
5989,5009192,F,N,N,0,270000.0,Working,Higher education,Married,House / apartment,-17573,-5792,1,1,1,0,Managers,2.0,-11,C
5990,5009192,F,N,N,0,270000.0,Working,Higher education,Married,House / apartment,-17573,-5792,1,1,1,0,Managers,2.0,-12,C
5991,5009192,F,N,N,0,270000.0,Working,Higher education,Married,House / apartment,-17573,-5792,1,1,1,0,Managers,2.0,-13,C
5992,5009192,F,N,N,0,270000.0,Working,Higher education,Married,House / apartment,-17573,-5792,1,1,1,0,Managers,2.0,-14,C
5993,5009192,F,N,N,0,270000.0,Working,Higher education,Married,House / apartment,-17573,-5792,1,1,1,0,Managers,2.0,-15,C
5994,5009192,F,N,N,0,270000.0,Working,Higher education,Married,House / apartment,-17573,-5792,1,1,1,0,Managers,2.0,-16,C
5995,5009192,F,N,N,0,270000.0,Working,Higher education,Married,House / apartment,-17573,-5792,1,1,1,0,Managers,2.0,-17,C
5996,5009192,F,N,N,0,270000.0,Working,Higher education,Married,House / apartment,-17573,-5792,1,1,1,0,Managers,2.0,-18,C
5997,5009192,F,N,N,0,270000.0,Working,Higher education,Married,House / apartment,-17573,-5792,1,1,1,0,Managers,2.0,-19,C
5998,5009192,F,N,N,0,270000.0,Working,Higher education,Married,House / apartment,-17573,-5792,1,1,1,0,Managers,2.0,-20,C
5999,5009192,F,N,N,0,270000.0,Working,Higher education,Married,House / apartment,-17573,-5792,1,1,1,0,Managers,2.0,-21,C
6000,5009192,F,N,N,0,270000.0,Working,Higher education,Married,House / apartment,-17573,-5792,1,1,1,0,Managers,2.0,-22,C
6001,5009192,F,N,N,0,270000.0,Working,Higher education,Married,House / apartment,-17573,-5792,1,1,1,0,Managers,2.0,-23,0
6002,5009192,F,N,N,0,270000.0,Working,Higher education,Married,House / apartment,-17573,-5792,1,1,1,0,Managers,2.0,-24,0
6003,5009192,F,N,N,0,270000.0,Working,Higher education,Married,House / apartment,-17573,-5792,1,1,1,0,Managers,2.0,-25,0
6004,5009192,F,N,N,0,270000.0,Working,Higher education,Married,House / apartment,-17573,-5792,1,1,1,0,Managers,2.0,-26,0
6005,5009192,F,N,N,0,270000.0,Working,Higher education,Married,House / apartment,-17573,-5792,1,1,1,0,Managers,2.0,-27,0
6006,5009192,F,N,N,0,270000.0,Working,Higher education,Married,House / apartment,-17573,-5792,1,1,1,0,Managers,2.0,-28,0
6007,5009192,F,N,N,0,270000.0,Working,Higher education,Married,House / apartment,-17573,-5792,1,1,1,0,Managers,2.0,-29,0
6008,5009192,F,N,N,0,270000.0,Working,Higher education,Married,House / apartment,-17573,-5792,1,1,1,0,Managers,2.0,-30,0
6009,5009192,F,N,N,0,270000.0,Working,Higher education,Married,House / apartment,-17573,-5792,1,1,1,0,Managers,2.0,-31,0
6010,5009192,F,N,N,0,270000.0,Working,Higher education,Married,House / apartment,-17573,-5792,1,1,1,0,Managers,2.0,-32,0
6011,5009192,F,N,N,0,270000.0,Working,Higher education,Married,House / apartment,-17573,-5792,1,1,1,0,Managers,2.0,-33,0
6012,5009193,F,N,N,0,270000.0,Working,Higher education,Married,House / apartment,-17573,-5792,1,1,1,0,Managers,2.0,-7,C
6013,5009193,F,N,N,0,270000.0,Working,Higher education,Married,House / apartment,-17573,-5792,1,1,1,0,Managers,2.0,-8,C
6014,5009193,F,N,N,0,270000.0,Working,Higher education,Married,House / apartment,-17573,-5792,1,1,1,0,Managers,2.0,-9,C
6015,5009193,F,N,N,0,270000.0,Working,Higher education,Married,House / apartment,-17573,-5792,1,1,1,0,Managers,2.0,-10,C
6016,5009193,F,N,N,0,270000.0,Working,Higher education,Married,House / apartment,-17573,-5792,1,1,1,0,Managers,2.0,-11,C
6017,5009193,F,N,N,0,270000.0,Working,Higher education,Married,House / apartment,-17573,-5792,1,1,1,0,Managers,2.0,-12,C
6018,5009193,F,N,N,0,270000.0,Working,Higher education,Married,House / apartment,-17573,-5792,1,1,1,0,Managers,2.0,-13,C
6019,5009193,F,N,N,0,270000.0,Working,Higher education,Married,House / apartment,-17573,-5792,1,1,1,0,Managers,2.0,-14,C
6020,5009193,F,N,N,0,270000.0,Working,Higher education,Married,House / apartment,-17573,-5792,1,1,1,0,Managers,2.0,-15,C
6021,5009193,F,N,N,0,270000.0,Working,Higher education,Married,House / apartment,-17573,-5792,1,1,1,0,Managers,2.0,-16,C
6022,5009193,F,N,N,0,270000.0,Working,Higher education,Married,House / apartment,-17573,-5792,1,1,1,0,Managers,2.0,-17,C
6023,5009193,F,N,N,0,270000.0,Working,Higher education,Married,House / apartment,-17573,-5792,1,1,1,0,Managers,2.0,-18,C
6024,5009193,F,N,N,0,270000.0,Working,Higher education,Married,House / apartment,-17573,-5792,1,1,1,0,Managers,2.0,-19,C
6025,5009193,F,N,N,0,270000.0,Working,Higher education,Married,House / apartment,-17573,-5792,1,1,1,0,Managers,2.0,-20,C
6026,5009193,F,N,N,0,270000.0,Working,Higher education,Married,House / apartment,-17573,-5792,1,1,1,0,Managers,2.0,-21,C
6027,5009193,F,N,N,0,270000.0,Working,Higher education,Married,House / apartment,-17573,-5792,1,1,1,0,Managers,2.0,-22,C
6028,5009193,F,N,N,0,270000.0,Working,Higher education,Married,House / apartment,-17573,-5792,1,1,1,0,Managers,2.0,-23,C
6029,5009193,F,N,N,0,270000.0,Working,Higher education,Married,House / apartment,-17573,-5792,1,1,1,0,Managers,2.0,-24,C
6030,5009193,F,N,N,0,270000.0,Working,Higher education,Married,House / apartment,-17573,-5792,1,1,1,0,Managers,2.0,-25,0
6031,5009193,F,N,N,0,270000.0,Working,Higher education,Married,House / apartment,-17573,-5792,1,1,1,0,Managers,2.0,-26,0
6032,5009193,F,N,N,0,270000.0,Working,Higher education,Married,House / apartment,-17573,-5792,1,1,1,0,Managers,2.0,-27,0
6033,5009193,F,N,N,0,270000.0,Working,Higher education,Married,House / apartment,-17573,-5792,1,1,1,0,Managers,2.0,-28,0
6034,5009193,F,N,N,0,270000.0,Working,Higher education,Married,House / apartment,-17573,-5792,1,1,1,0,Managers,2.0,-29,0
6035,5009193,F,N,N,0,270000.0,Working,Higher education,Married,House / apartment,-17573,-5792,1,1,1,0,Managers,2.0,-30,0
6036,5009193,F,N,N,0,270000.0,Working,Higher education,Married,House / apartment,-17573,-5792,1,1,1,0,Managers,2.0,-31,0
6037,5009193,F,N,N,0,270000.0,Working,Higher education,Married,House / apartment,-17573,-5792,1,1,1,0,Managers,2.0,-32,0
6038,5009193,F,N,N,0,270000.0,Working,Higher education,Married,House / apartment,-17573,-5792,1,1,1,0,Managers,2.0,-33,0
6039,5009193,F,N,N,0,270000.0,Working,Higher education,Married,House / apartment,-17573,-5792,1,1,1,0,Managers,2.0,-34,0
6040,5009193,F,N,N,0,270000.0,Working,Higher education,Married,House / apartment,-17573,-5792,1,1,1,0,Managers,2.0,-35,1
6041,5009193,F,N,N,0,270000.0,Working,Higher education,Married,House / apartment,-17573,-5792,1,1,1,0,Managers,2.0,-36,0
6042,5009195,F,N,N,0,292500.0,State servant,Secondary / secondary special,Married,House / apartment,-20953,-8684,1,1,1,0,Accountants,2.0,-15,X
6043,5009195,F,N,N,0,292500.0,State servant,Secondary / secondary special,Married,House / apartment,-20953,-8684,1,1,1,0,Accountants,2.0,-16,0
6044,5009195,F,N,N,0,292500.0,State servant,Secondary / secondary special,Married,House / apartment,-20953,-8684,1,1,1,0,Accountants,2.0,-17,0
6045,5009195,F,N,N,0,292500.0,State servant,Secondary / secondary special,Married,House / apartment,-20953,-8684,1,1,1,0,Accountants,2.0,-18,0
6046,5009195,F,N,N,0,292500.0,State servant,Secondary / secondary special,Married,House / apartment,-20953,-8684,1,1,1,0,Accountants,2.0,-19,0
6047,5009195,F,N,N,0,292500.0,State servant,Secondary / secondary special,Married,House / apartment,-20953,-8684,1,1,1,0,Accountants,2.0,-20,0
6048,5009195,F,N,N,0,292500.0,State servant,Secondary / secondary special,Married,House / apartment,-20953,-8684,1,1,1,0,Accountants,2.0,-21,0
6049,5009196,F,N,N,0,292500.0,State servant,Secondary / secondary special,Married,House / apartment,-20953,-8684,1,1,1,0,Accountants,2.0,-14,X
6050,5009196,F,N,N,0,292500.0,State servant,Secondary / secondary special,Married,House / apartment,-20953,-8684,1,1,1,0,Accountants,2.0,-15,0
6051,5009196,F,N,N,0,292500.0,State servant,Secondary / secondary special,Married,House / apartment,-20953,-8684,1,1,1,0,Accountants,2.0,-16,0
6052,5009196,F,N,N,0,292500.0,State servant,Secondary / secondary special,Married,House / apartment,-20953,-8684,1,1,1,0,Accountants,2.0,-17,0
6053,5009196,F,N,N,0,292500.0,State servant,Secondary / secondary special,Married,House / apartment,-20953,-8684,1,1,1,0,Accountants,2.0,-18,0
6054,5009196,F,N,N,0,292500.0,State servant,Secondary / secondary special,Married,House / apartment,-20953,-8684,1,1,1,0,Accountants,2.0,-19,0
6055,5009196,F,N,N,0,292500.0,State servant,Secondary / secondary special,Married,House / apartment,-20953,-8684,1,1,1,0,Accountants,2.0,-20,0
6056,5009196,F,N,N,0,292500.0,State servant,Secondary / secondary special,Married,House / apartment,-20953,-8684,1,1,1,0,Accountants,2.0,-21,0
6057,5009198,F,N,N,0,292500.0,State servant,Secondary / secondary special,Married,House / apartment,-20953,-8684,1,1,1,0,Accountants,2.0,-3,C
6058,5009198,F,N,N,0,292500.0,State servant,Secondary / secondary special,Married,House / apartment,-20953,-8684,1,1,1,0,Accountants,2.0,-4,C
6059,5009198,F,N,N,0,292500.0,State servant,Secondary / secondary special,Married,House / apartment,-20953,-8684,1,1,1,0,Accountants,2.0,-5,C
6060,5009198,F,N,N,0,292500.0,State servant,Secondary / secondary special,Married,House / apartment,-20953,-8684,1,1,1,0,Accountants,2.0,-6,C
6061,5009198,F,N,N,0,292500.0,State servant,Secondary / secondary special,Married,House / apartment,-20953,-8684,1,1,1,0,Accountants,2.0,-7,C
6062,5009198,F,N,N,0,292500.0,State servant,Secondary / secondary special,Married,House / apartment,-20953,-8684,1,1,1,0,Accountants,2.0,-8,C
6063,5009198,F,N,N,0,292500.0,State servant,Secondary / secondary special,Married,House / apartment,-20953,-8684,1,1,1,0,Accountants,2.0,-9,C
6064,5009198,F,N,N,0,292500.0,State servant,Secondary / secondary special,Married,House / apartment,-20953,-8684,1,1,1,0,Accountants,2.0,-10,C
6065,5009198,F,N,N,0,292500.0,State servant,Secondary / secondary special,Married,House / apartment,-20953,-8684,1,1,1,0,Accountants,2.0,-11,C
6066,5009198,F,N,N,0,292500.0,State servant,Secondary / secondary special,Married,House / apartment,-20953,-8684,1,1,1,0,Accountants,2.0,-12,C
6067,5009198,F,N,N,0,292500.0,State servant,Secondary / secondary special,Married,House / apartment,-20953,-8684,1,1,1,0,Accountants,2.0,-13,C
6068,5009198,F,N,N,0,292500.0,State servant,Secondary / secondary special,Married,House / apartment,-20953,-8684,1,1,1,0,Accountants,2.0,-14,C
6069,5009198,F,N,N,0,292500.0,State servant,Secondary / secondary special,Married,House / apartment,-20953,-8684,1,1,1,0,Accountants,2.0,-15,C
6070,5009198,F,N,N,0,292500.0,State servant,Secondary / secondary special,Married,House / apartment,-20953,-8684,1,1,1,0,Accountants,2.0,-16,C
6071,5009198,F,N,N,0,292500.0,State servant,Secondary / secondary special,Married,House / apartment,-20953,-8684,1,1,1,0,Accountants,2.0,-17,C
6072,5009198,F,N,N,0,292500.0,State servant,Secondary / secondary special,Married,House / apartment,-20953,-8684,1,1,1,0,Accountants,2.0,-18,C
6073,5009198,F,N,N,0,292500.0,State servant,Secondary / secondary special,Married,House / apartment,-20953,-8684,1,1,1,0,Accountants,2.0,-19,C
6074,5009198,F,N,N,0,292500.0,State servant,Secondary / secondary special,Married,House / apartment,-20953,-8684,1,1,1,0,Accountants,2.0,-20,C
6075,5009198,F,N,N,0,292500.0,State servant,Secondary / secondary special,Married,House / apartment,-20953,-8684,1,1,1,0,Accountants,2.0,-21,C
6076,5009198,F,N,N,0,292500.0,State servant,Secondary / secondary special,Married,House / apartment,-20953,-8684,1,1,1,0,Accountants,2.0,-22,C
6077,5009198,F,N,N,0,292500.0,State servant,Secondary / secondary special,Married,House / apartment,-20953,-8684,1,1,1,0,Accountants,2.0,-23,C
6078,5009198,F,N,N,0,292500.0,State servant,Secondary / secondary special,Married,House / apartment,-20953,-8684,1,1,1,0,Accountants,2.0,-24,C
6079,5009198,F,N,N,0,292500.0,State servant,Secondary / secondary special,Married,House / apartment,-20953,-8684,1,1,1,0,Accountants,2.0,-25,C
6080,5009198,F,N,N,0,292500.0,State servant,Secondary / secondary special,Married,House / apartment,-20953,-8684,1,1,1,0,Accountants,2.0,-26,C
6081,5009198,F,N,N,0,292500.0,State servant,Secondary / secondary special,Married,House / apartment,-20953,-8684,1,1,1,0,Accountants,2.0,-27,C
6082,5009198,F,N,N,0,292500.0,State servant,Secondary / secondary special,Married,House / apartment,-20953,-8684,1,1,1,0,Accountants,2.0,-28,C
6083,5009198,F,N,N,0,292500.0,State servant,Secondary / secondary special,Married,House / apartment,-20953,-8684,1,1,1,0,Accountants,2.0,-29,C
6084,5009198,F,N,N,0,292500.0,State servant,Secondary / secondary special,Married,House / apartment,-20953,-8684,1,1,1,0,Accountants,2.0,-30,C
6085,5009198,F,N,N,0,292500.0,State servant,Secondary / secondary special,Married,House / apartment,-20953,-8684,1,1,1,0,Accountants,2.0,-31,C
6086,5009198,F,N,N,0,292500.0,State servant,Secondary / secondary special,Married,House / apartment,-20953,-8684,1,1,1,0,Accountants,2.0,-32,0
6087,5009198,F,N,N,0,292500.0,State servant,Secondary / secondary special,Married,House / apartment,-20953,-8684,1,1,1,0,Accountants,2.0,-33,0
6088,5009198,F,N,N,0,292500.0,State servant,Secondary / secondary special,Married,House / apartment,-20953,-8684,1,1,1,0,Accountants,2.0,-34,0
6089,5009198,F,N,N,0,292500.0,State servant,Secondary / secondary special,Married,House / apartment,-20953,-8684,1,1,1,0,Accountants,2.0,-35,0
6090,5009198,F,N,N,0,292500.0,State servant,Secondary / secondary special,Married,House / apartment,-20953,-8684,1,1,1,0,Accountants,2.0,-36,0
6091,5009198,F,N,N,0,292500.0,State servant,Secondary / secondary special,Married,House / apartment,-20953,-8684,1,1,1,0,Accountants,2.0,-37,0
6092,5009198,F,N,N,0,292500.0,State servant,Secondary / secondary special,Married,House / apartment,-20953,-8684,1,1,1,0,Accountants,2.0,-38,0
6093,5009198,F,N,N,0,292500.0,State servant,Secondary / secondary special,Married,House / apartment,-20953,-8684,1,1,1,0,Accountants,2.0,-39,0
6094,5009198,F,N,N,0,292500.0,State servant,Secondary / secondary special,Married,House / apartment,-20953,-8684,1,1,1,0,Accountants,2.0,-40,0
6095,5009198,F,N,N,0,292500.0,State servant,Secondary / secondary special,Married,House / apartment,-20953,-8684,1,1,1,0,Accountants,2.0,-41,0
6096,5009198,F,N,N,0,292500.0,State servant,Secondary / secondary special,Married,House / apartment,-20953,-8684,1,1,1,0,Accountants,2.0,-42,0
6097,5009198,F,N,N,0,292500.0,State servant,Secondary / secondary special,Married,House / apartment,-20953,-8684,1,1,1,0,Accountants,2.0,-43,0
6098,5009198,F,N,N,0,292500.0,State servant,Secondary / secondary special,Married,House / apartment,-20953,-8684,1,1,1,0,Accountants,2.0,-44,0
6099,5009198,F,N,N,0,292500.0,State servant,Secondary / secondary special,Married,House / apartment,-20953,-8684,1,1,1,0,Accountants,2.0,-45,0
6100,5009198,F,N,N,0,292500.0,State servant,Secondary / secondary special,Married,House / apartment,-20953,-8684,1,1,1,0,Accountants,2.0,-46,0
6101,5009198,F,N,N,0,292500.0,State servant,Secondary / secondary special,Married,House / apartment,-20953,-8684,1,1,1,0,Accountants,2.0,-47,0
6102,5009198,F,N,N,0,292500.0,State servant,Secondary / secondary special,Married,House / apartment,-20953,-8684,1,1,1,0,Accountants,2.0,-48,0
6103,5009201,F,N,N,0,292500.0,State servant,Secondary / secondary special,Married,House / apartment,-20953,-8684,1,1,1,0,Accountants,2.0,0,0
6104,5009201,F,N,N,0,292500.0,State servant,Secondary / secondary special,Married,House / apartment,-20953,-8684,1,1,1,0,Accountants,2.0,-1,X
6105,5009202,F,N,N,0,292500.0,State servant,Secondary / secondary special,Married,House / apartment,-20953,-8684,1,1,1,0,Accountants,2.0,0,0
6106,5009202,F,N,N,0,292500.0,State servant,Secondary / secondary special,Married,House / apartment,-20953,-8684,1,1,1,0,Accountants,2.0,-1,0
6107,5009202,F,N,N,0,292500.0,State servant,Secondary / secondary special,Married,House / apartment,-20953,-8684,1,1,1,0,Accountants,2.0,-2,0
6108,5009202,F,N,N,0,292500.0,State servant,Secondary / secondary special,Married,House / apartment,-20953,-8684,1,1,1,0,Accountants,2.0,-3,0
6109,5009202,F,N,N,0,292500.0,State servant,Secondary / secondary special,Married,House / apartment,-20953,-8684,1,1,1,0,Accountants,2.0,-4,0
6110,5009202,F,N,N,0,292500.0,State servant,Secondary / secondary special,Married,House / apartment,-20953,-8684,1,1,1,0,Accountants,2.0,-5,0
6111,5009202,F,N,N,0,292500.0,State servant,Secondary / secondary special,Married,House / apartment,-20953,-8684,1,1,1,0,Accountants,2.0,-6,0
6112,5009203,F,N,N,0,292500.0,State servant,Secondary / secondary special,Married,House / apartment,-20953,-8684,1,1,1,0,Accountants,2.0,-1,X
6113,5009203,F,N,N,0,292500.0,State servant,Secondary / secondary special,Married,House / apartment,-20953,-8684,1,1,1,0,Accountants,2.0,-2,X
6114,5009203,F,N,N,0,292500.0,State servant,Secondary / secondary special,Married,House / apartment,-20953,-8684,1,1,1,0,Accountants,2.0,-3,X
6115,5009203,F,N,N,0,292500.0,State servant,Secondary / secondary special,Married,House / apartment,-20953,-8684,1,1,1,0,Accountants,2.0,-4,X
6116,5009203,F,N,N,0,292500.0,State servant,Secondary / secondary special,Married,House / apartment,-20953,-8684,1,1,1,0,Accountants,2.0,-5,X
6117,5009203,F,N,N,0,292500.0,State servant,Secondary / secondary special,Married,House / apartment,-20953,-8684,1,1,1,0,Accountants,2.0,-6,X
6118,5009203,F,N,N,0,292500.0,State servant,Secondary / secondary special,Married,House / apartment,-20953,-8684,1,1,1,0,Accountants,2.0,-7,X
6119,5009203,F,N,N,0,292500.0,State servant,Secondary / secondary special,Married,House / apartment,-20953,-8684,1,1,1,0,Accountants,2.0,-8,X
6120,5009203,F,N,N,0,292500.0,State servant,Secondary / secondary special,Married,House / apartment,-20953,-8684,1,1,1,0,Accountants,2.0,-9,X
6121,5009203,F,N,N,0,292500.0,State servant,Secondary / secondary special,Married,House / apartment,-20953,-8684,1,1,1,0,Accountants,2.0,-10,X
6122,5009203,F,N,N,0,292500.0,State servant,Secondary / secondary special,Married,House / apartment,-20953,-8684,1,1,1,0,Accountants,2.0,-11,X
6123,5009203,F,N,N,0,292500.0,State servant,Secondary / secondary special,Married,House / apartment,-20953,-8684,1,1,1,0,Accountants,2.0,-12,X
6124,5009203,F,N,N,0,292500.0,State servant,Secondary / secondary special,Married,House / apartment,-20953,-8684,1,1,1,0,Accountants,2.0,-13,X
6125,5009203,F,N,N,0,292500.0,State servant,Secondary / secondary special,Married,House / apartment,-20953,-8684,1,1,1,0,Accountants,2.0,-14,X
6126,5009203,F,N,N,0,292500.0,State servant,Secondary / secondary special,Married,House / apartment,-20953,-8684,1,1,1,0,Accountants,2.0,-15,X
6127,5009203,F,N,N,0,292500.0,State servant,Secondary / secondary special,Married,House / apartment,-20953,-8684,1,1,1,0,Accountants,2.0,-16,X
6128,5009203,F,N,N,0,292500.0,State servant,Secondary / secondary special,Married,House / apartment,-20953,-8684,1,1,1,0,Accountants,2.0,-17,X
6129,5009203,F,N,N,0,292500.0,State servant,Secondary / secondary special,Married,House / apartment,-20953,-8684,1,1,1,0,Accountants,2.0,-18,X
6130,5009203,F,N,N,0,292500.0,State servant,Secondary / secondary special,Married,House / apartment,-20953,-8684,1,1,1,0,Accountants,2.0,-19,X
6131,5009203,F,N,N,0,292500.0,State servant,Secondary / secondary special,Married,House / apartment,-20953,-8684,1,1,1,0,Accountants,2.0,-20,X
6132,5009203,F,N,N,0,292500.0,State servant,Secondary / secondary special,Married,House / apartment,-20953,-8684,1,1,1,0,Accountants,2.0,-21,X
6133,5009204,F,N,N,0,292500.0,State servant,Secondary / secondary special,Married,House / apartment,-20953,-8684,1,1,1,0,Accountants,2.0,0,0
6134,5009204,F,N,N,0,292500.0,State servant,Secondary / secondary special,Married,House / apartment,-20953,-8684,1,1,1,0,Accountants,2.0,-1,0
6135,5009204,F,N,N,0,292500.0,State servant,Secondary / secondary special,Married,House / apartment,-20953,-8684,1,1,1,0,Accountants,2.0,-2,0
6136,5009205,F,N,N,0,292500.0,State servant,Secondary / secondary special,Married,House / apartment,-20953,-8684,1,1,1,0,Accountants,2.0,0,X
6137,5009205,F,N,N,0,292500.0,State servant,Secondary / secondary special,Married,House / apartment,-20953,-8684,1,1,1,0,Accountants,2.0,-1,X
6138,5009205,F,N,N,0,292500.0,State servant,Secondary / secondary special,Married,House / apartment,-20953,-8684,1,1,1,0,Accountants,2.0,-2,X
6139,5009205,F,N,N,0,292500.0,State servant,Secondary / secondary special,Married,House / apartment,-20953,-8684,1,1,1,0,Accountants,2.0,-3,X
6140,5009205,F,N,N,0,292500.0,State servant,Secondary / secondary special,Married,House / apartment,-20953,-8684,1,1,1,0,Accountants,2.0,-4,X
6141,5009205,F,N,N,0,292500.0,State servant,Secondary / secondary special,Married,House / apartment,-20953,-8684,1,1,1,0,Accountants,2.0,-5,X
6142,5009206,F,N,N,0,292500.0,State servant,Secondary / secondary special,Married,House / apartment,-20953,-8684,1,1,1,0,Accountants,2.0,0,C
6143,5009206,F,N,N,0,292500.0,State servant,Secondary / secondary special,Married,House / apartment,-20953,-8684,1,1,1,0,Accountants,2.0,-1,C
6144,5009206,F,N,N,0,292500.0,State servant,Secondary / secondary special,Married,House / apartment,-20953,-8684,1,1,1,0,Accountants,2.0,-2,C
6145,5009206,F,N,N,0,292500.0,State servant,Secondary / secondary special,Married,House / apartment,-20953,-8684,1,1,1,0,Accountants,2.0,-3,C
6146,5009206,F,N,N,0,292500.0,State servant,Secondary / secondary special,Married,House / apartment,-20953,-8684,1,1,1,0,Accountants,2.0,-4,C
6147,5009206,F,N,N,0,292500.0,State servant,Secondary / secondary special,Married,House / apartment,-20953,-8684,1,1,1,0,Accountants,2.0,-5,0
6148,5009206,F,N,N,0,292500.0,State servant,Secondary / secondary special,Married,House / apartment,-20953,-8684,1,1,1,0,Accountants,2.0,-6,0
6149,5009206,F,N,N,0,292500.0,State servant,Secondary / secondary special,Married,House / apartment,-20953,-8684,1,1,1,0,Accountants,2.0,-7,0
6150,5009206,F,N,N,0,292500.0,State servant,Secondary / secondary special,Married,House / apartment,-20953,-8684,1,1,1,0,Accountants,2.0,-8,0
6151,5009206,F,N,N,0,292500.0,State servant,Secondary / secondary special,Married,House / apartment,-20953,-8684,1,1,1,0,Accountants,2.0,-9,0
6152,5009206,F,N,N,0,292500.0,State servant,Secondary / secondary special,Married,House / apartment,-20953,-8684,1,1,1,0,Accountants,2.0,-10,0
6153,5009206,F,N,N,0,292500.0,State servant,Secondary / secondary special,Married,House / apartment,-20953,-8684,1,1,1,0,Accountants,2.0,-11,0
6154,5009206,F,N,N,0,292500.0,State servant,Secondary / secondary special,Married,House / apartment,-20953,-8684,1,1,1,0,Accountants,2.0,-12,0
6155,5009206,F,N,N,0,292500.0,State servant,Secondary / secondary special,Married,House / apartment,-20953,-8684,1,1,1,0,Accountants,2.0,-13,0
6156,5009206,F,N,N,0,292500.0,State servant,Secondary / secondary special,Married,House / apartment,-20953,-8684,1,1,1,0,Accountants,2.0,-14,0
6157,5009206,F,N,N,0,292500.0,State servant,Secondary / secondary special,Married,House / apartment,-20953,-8684,1,1,1,0,Accountants,2.0,-15,0
6158,5009206,F,N,N,0,292500.0,State servant,Secondary / secondary special,Married,House / apartment,-20953,-8684,1,1,1,0,Accountants,2.0,-16,X
6159,5009206,F,N,N,0,292500.0,State servant,Secondary / secondary special,Married,House / apartment,-20953,-8684,1,1,1,0,Accountants,2.0,-17,X
6160,5009206,F,N,N,0,292500.0,State servant,Secondary / secondary special,Married,House / apartment,-20953,-8684,1,1,1,0,Accountants,2.0,-18,X
6161,5009206,F,N,N,0,292500.0,State servant,Secondary / secondary special,Married,House / apartment,-20953,-8684,1,1,1,0,Accountants,2.0,-19,0
6162,5009206,F,N,N,0,292500.0,State servant,Secondary / secondary special,Married,House / apartment,-20953,-8684,1,1,1,0,Accountants,2.0,-20,X
6163,5009206,F,N,N,0,292500.0,State servant,Secondary / secondary special,Married,House / apartment,-20953,-8684,1,1,1,0,Accountants,2.0,-21,X
6164,5009207,F,N,N,0,292500.0,State servant,Secondary / secondary special,Married,House / apartment,-20953,-8684,1,1,1,0,Accountants,2.0,-1,X
6165,5009207,F,N,N,0,292500.0,State servant,Secondary / secondary special,Married,House / apartment,-20953,-8684,1,1,1,0,Accountants,2.0,-2,0
6166,5009207,F,N,N,0,292500.0,State servant,Secondary / secondary special,Married,House / apartment,-20953,-8684,1,1,1,0,Accountants,2.0,-3,0
6167,5009207,F,N,N,0,292500.0,State servant,Secondary / secondary special,Married,House / apartment,-20953,-8684,1,1,1,0,Accountants,2.0,-4,0
6168,5009207,F,N,N,0,292500.0,State servant,Secondary / secondary special,Married,House / apartment,-20953,-8684,1,1,1,0,Accountants,2.0,-5,0
6169,5009207,F,N,N,0,292500.0,State servant,Secondary / secondary special,Married,House / apartment,-20953,-8684,1,1,1,0,Accountants,2.0,-6,0
6170,5009207,F,N,N,0,292500.0,State servant,Secondary / secondary special,Married,House / apartment,-20953,-8684,1,1,1,0,Accountants,2.0,-7,0
6171,5009207,F,N,N,0,292500.0,State servant,Secondary / secondary special,Married,House / apartment,-20953,-8684,1,1,1,0,Accountants,2.0,-8,0
6172,5009207,F,N,N,0,292500.0,State servant,Secondary / secondary special,Married,House / apartment,-20953,-8684,1,1,1,0,Accountants,2.0,-9,0
6173,5009207,F,N,N,0,292500.0,State servant,Secondary / secondary special,Married,House / apartment,-20953,-8684,1,1,1,0,Accountants,2.0,-10,0
6174,5009207,F,N,N,0,292500.0,State servant,Secondary / secondary special,Married,House / apartment,-20953,-8684,1,1,1,0,Accountants,2.0,-11,0
6175,5009207,F,N,N,0,292500.0,State servant,Secondary / secondary special,Married,House / apartment,-20953,-8684,1,1,1,0,Accountants,2.0,-12,0
6176,5009207,F,N,N,0,292500.0,State servant,Secondary / secondary special,Married,House / apartment,-20953,-8684,1,1,1,0,Accountants,2.0,-13,0
6177,5009207,F,N,N,0,292500.0,State servant,Secondary / secondary special,Married,House / apartment,-20953,-8684,1,1,1,0,Accountants,2.0,-14,0
6178,5009207,F,N,N,0,292500.0,State servant,Secondary / secondary special,Married,House / apartment,-20953,-8684,1,1,1,0,Accountants,2.0,-15,0
6179,5009207,F,N,N,0,292500.0,State servant,Secondary / secondary special,Married,House / apartment,-20953,-8684,1,1,1,0,Accountants,2.0,-16,0
6180,5009207,F,N,N,0,292500.0,State servant,Secondary / secondary special,Married,House / apartment,-20953,-8684,1,1,1,0,Accountants,2.0,-17,0
6181,5009207,F,N,N,0,292500.0,State servant,Secondary / secondary special,Married,House / apartment,-20953,-8684,1,1,1,0,Accountants,2.0,-18,0
6182,5009207,F,N,N,0,292500.0,State servant,Secondary / secondary special,Married,House / apartment,-20953,-8684,1,1,1,0,Accountants,2.0,-19,0
6183,5009207,F,N,N,0,292500.0,State servant,Secondary / secondary special,Married,House / apartment,-20953,-8684,1,1,1,0,Accountants,2.0,-20,0
6184,5009207,F,N,N,0,292500.0,State servant,Secondary / secondary special,Married,House / apartment,-20953,-8684,1,1,1,0,Accountants,2.0,-21,0
6185,5009207,F,N,N,0,292500.0,State servant,Secondary / secondary special,Married,House / apartment,-20953,-8684,1,1,1,0,Accountants,2.0,-22,0
6186,5009208,F,N,N,0,292500.0,State servant,Secondary / secondary special,Married,House / apartment,-20953,-8684,1,1,1,0,Accountants,2.0,0,C
6187,5009208,F,N,N,0,292500.0,State servant,Secondary / secondary special,Married,House / apartment,-20953,-8684,1,1,1,0,Accountants,2.0,-1,C
6188,5009208,F,N,N,0,292500.0,State servant,Secondary / secondary special,Married,House / apartment,-20953,-8684,1,1,1,0,Accountants,2.0,-2,C
6189,5009208,F,N,N,0,292500.0,State servant,Secondary / secondary special,Married,House / apartment,-20953,-8684,1,1,1,0,Accountants,2.0,-3,C
6190,5009208,F,N,N,0,292500.0,State servant,Secondary / secondary special,Married,House / apartment,-20953,-8684,1,1,1,0,Accountants,2.0,-4,C
6191,5009208,F,N,N,0,292500.0,State servant,Secondary / secondary special,Married,House / apartment,-20953,-8684,1,1,1,0,Accountants,2.0,-5,C
6192,5009208,F,N,N,0,292500.0,State servant,Secondary / secondary special,Married,House / apartment,-20953,-8684,1,1,1,0,Accountants,2.0,-6,C
6193,5009208,F,N,N,0,292500.0,State servant,Secondary / secondary special,Married,House / apartment,-20953,-8684,1,1,1,0,Accountants,2.0,-7,C
6194,5009208,F,N,N,0,292500.0,State servant,Secondary / secondary special,Married,House / apartment,-20953,-8684,1,1,1,0,Accountants,2.0,-8,C
6195,5009208,F,N,N,0,292500.0,State servant,Secondary / secondary special,Married,House / apartment,-20953,-8684,1,1,1,0,Accountants,2.0,-9,C
6196,5009208,F,N,N,0,292500.0,State servant,Secondary / secondary special,Married,House / apartment,-20953,-8684,1,1,1,0,Accountants,2.0,-10,C
6197,5009208,F,N,N,0,292500.0,State servant,Secondary / secondary special,Married,House / apartment,-20953,-8684,1,1,1,0,Accountants,2.0,-11,C
6198,5009208,F,N,N,0,292500.0,State servant,Secondary / secondary special,Married,House / apartment,-20953,-8684,1,1,1,0,Accountants,2.0,-12,C
6199,5009208,F,N,N,0,292500.0,State servant,Secondary / secondary special,Married,House / apartment,-20953,-8684,1,1,1,0,Accountants,2.0,-13,C
6200,5009208,F,N,N,0,292500.0,State servant,Secondary / secondary special,Married,House / apartment,-20953,-8684,1,1,1,0,Accountants,2.0,-14,C
6201,5009208,F,N,N,0,292500.0,State servant,Secondary / secondary special,Married,House / apartment,-20953,-8684,1,1,1,0,Accountants,2.0,-15,C
6202,5009208,F,N,N,0,292500.0,State servant,Secondary / secondary special,Married,House / apartment,-20953,-8684,1,1,1,0,Accountants,2.0,-16,C
6203,5009208,F,N,N,0,292500.0,State servant,Secondary / secondary special,Married,House / apartment,-20953,-8684,1,1,1,0,Accountants,2.0,-17,C
6204,5009208,F,N,N,0,292500.0,State servant,Secondary / secondary special,Married,House / apartment,-20953,-8684,1,1,1,0,Accountants,2.0,-18,C
6205,5009208,F,N,N,0,292500.0,State servant,Secondary / secondary special,Married,House / apartment,-20953,-8684,1,1,1,0,Accountants,2.0,-19,C
6206,5009208,F,N,N,0,292500.0,State servant,Secondary / secondary special,Married,House / apartment,-20953,-8684,1,1,1,0,Accountants,2.0,-20,C
6207,5009208,F,N,N,0,292500.0,State servant,Secondary / secondary special,Married,House / apartment,-20953,-8684,1,1,1,0,Accountants,2.0,-21,C
6208,5009208,F,N,N,0,292500.0,State servant,Secondary / secondary special,Married,House / apartment,-20953,-8684,1,1,1,0,Accountants,2.0,-22,C
6209,5009208,F,N,N,0,292500.0,State servant,Secondary / secondary special,Married,House / apartment,-20953,-8684,1,1,1,0,Accountants,2.0,-23,C
6210,5009208,F,N,N,0,292500.0,State servant,Secondary / secondary special,Married,House / apartment,-20953,-8684,1,1,1,0,Accountants,2.0,-24,X
6211,5009208,F,N,N,0,292500.0,State servant,Secondary / secondary special,Married,House / apartment,-20953,-8684,1,1,1,0,Accountants,2.0,-25,X
6212,5009208,F,N,N,0,292500.0,State servant,Secondary / secondary special,Married,House / apartment,-20953,-8684,1,1,1,0,Accountants,2.0,-26,X
6213,5009208,F,N,N,0,292500.0,State servant,Secondary / secondary special,Married,House / apartment,-20953,-8684,1,1,1,0,Accountants,2.0,-27,X
6214,5009208,F,N,N,0,292500.0,State servant,Secondary / secondary special,Married,House / apartment,-20953,-8684,1,1,1,0,Accountants,2.0,-28,X
6215,5009208,F,N,N,0,292500.0,State servant,Secondary / secondary special,Married,House / apartment,-20953,-8684,1,1,1,0,Accountants,2.0,-29,X
6216,5009208,F,N,N,0,292500.0,State servant,Secondary / secondary special,Married,House / apartment,-20953,-8684,1,1,1,0,Accountants,2.0,-30,X
6217,5009208,F,N,N,0,292500.0,State servant,Secondary / secondary special,Married,House / apartment,-20953,-8684,1,1,1,0,Accountants,2.0,-31,X
6218,5009208,F,N,N,0,292500.0,State servant,Secondary / secondary special,Married,House / apartment,-20953,-8684,1,1,1,0,Accountants,2.0,-32,X
6219,5009208,F,N,N,0,292500.0,State servant,Secondary / secondary special,Married,House / apartment,-20953,-8684,1,1,1,0,Accountants,2.0,-33,X
6220,5009208,F,N,N,0,292500.0,State servant,Secondary / secondary special,Married,House / apartment,-20953,-8684,1,1,1,0,Accountants,2.0,-34,X
6221,5009208,F,N,N,0,292500.0,State servant,Secondary / secondary special,Married,House / apartment,-20953,-8684,1,1,1,0,Accountants,2.0,-35,X
6222,5009208,F,N,N,0,292500.0,State servant,Secondary / secondary special,Married,House / apartment,-20953,-8684,1,1,1,0,Accountants,2.0,-36,X
6223,5009208,F,N,N,0,292500.0,State servant,Secondary / secondary special,Married,House / apartment,-20953,-8684,1,1,1,0,Accountants,2.0,-37,X
6224,5009208,F,N,N,0,292500.0,State servant,Secondary / secondary special,Married,House / apartment,-20953,-8684,1,1,1,0,Accountants,2.0,-38,X
6225,5009208,F,N,N,0,292500.0,State servant,Secondary / secondary special,Married,House / apartment,-20953,-8684,1,1,1,0,Accountants,2.0,-39,X
6226,5009208,F,N,N,0,292500.0,State servant,Secondary / secondary special,Married,House / apartment,-20953,-8684,1,1,1,0,Accountants,2.0,-40,X
6227,5009208,F,N,N,0,292500.0,State servant,Secondary / secondary special,Married,House / apartment,-20953,-8684,1,1,1,0,Accountants,2.0,-41,X
6228,5009209,F,N,N,0,292500.0,State servant,Secondary / secondary special,Married,House / apartment,-20953,-8684,1,1,1,0,Accountants,2.0,0,0
6229,5009209,F,N,N,0,292500.0,State servant,Secondary / secondary special,Married,House / apartment,-20953,-8684,1,1,1,0,Accountants,2.0,-1,0
6230,5009209,F,N,N,0,292500.0,State servant,Secondary / secondary special,Married,House / apartment,-20953,-8684,1,1,1,0,Accountants,2.0,-2,0
6231,5009209,F,N,N,0,292500.0,State servant,Secondary / secondary special,Married,House / apartment,-20953,-8684,1,1,1,0,Accountants,2.0,-3,0
6232,5009209,F,N,N,0,292500.0,State servant,Secondary / secondary special,Married,House / apartment,-20953,-8684,1,1,1,0,Accountants,2.0,-4,0
6233,5009209,F,N,N,0,292500.0,State servant,Secondary / secondary special,Married,House / apartment,-20953,-8684,1,1,1,0,Accountants,2.0,-5,0
6234,5009209,F,N,N,0,292500.0,State servant,Secondary / secondary special,Married,House / apartment,-20953,-8684,1,1,1,0,Accountants,2.0,-6,0
6235,5009209,F,N,N,0,292500.0,State servant,Secondary / secondary special,Married,House / apartment,-20953,-8684,1,1,1,0,Accountants,2.0,-7,0
6236,5009209,F,N,N,0,292500.0,State servant,Secondary / secondary special,Married,House / apartment,-20953,-8684,1,1,1,0,Accountants,2.0,-8,0
6237,5009209,F,N,N,0,292500.0,State servant,Secondary / secondary special,Married,House / apartment,-20953,-8684,1,1,1,0,Accountants,2.0,-9,0
6238,5009209,F,N,N,0,292500.0,State servant,Secondary / secondary special,Married,House / apartment,-20953,-8684,1,1,1,0,Accountants,2.0,-10,0
6239,5009209,F,N,N,0,292500.0,State servant,Secondary / secondary special,Married,House / apartment,-20953,-8684,1,1,1,0,Accountants,2.0,-11,0
6240,5009209,F,N,N,0,292500.0,State servant,Secondary / secondary special,Married,House / apartment,-20953,-8684,1,1,1,0,Accountants,2.0,-12,0
6241,5009209,F,N,N,0,292500.0,State servant,Secondary / secondary special,Married,House / apartment,-20953,-8684,1,1,1,0,Accountants,2.0,-13,0
6242,5009209,F,N,N,0,292500.0,State servant,Secondary / secondary special,Married,House / apartment,-20953,-8684,1,1,1,0,Accountants,2.0,-14,0
6243,5009209,F,N,N,0,292500.0,State servant,Secondary / secondary special,Married,House / apartment,-20953,-8684,1,1,1,0,Accountants,2.0,-15,0
6244,5009209,F,N,N,0,292500.0,State servant,Secondary / secondary special,Married,House / apartment,-20953,-8684,1,1,1,0,Accountants,2.0,-16,0
6245,5009209,F,N,N,0,292500.0,State servant,Secondary / secondary special,Married,House / apartment,-20953,-8684,1,1,1,0,Accountants,2.0,-17,0
6246,5009209,F,N,N,0,292500.0,State servant,Secondary / secondary special,Married,House / apartment,-20953,-8684,1,1,1,0,Accountants,2.0,-18,0
6247,5009209,F,N,N,0,292500.0,State servant,Secondary / secondary special,Married,House / apartment,-20953,-8684,1,1,1,0,Accountants,2.0,-19,0
6248,5009209,F,N,N,0,292500.0,State servant,Secondary / secondary special,Married,House / apartment,-20953,-8684,1,1,1,0,Accountants,2.0,-20,0
6249,5009209,F,N,N,0,292500.0,State servant,Secondary / secondary special,Married,House / apartment,-20953,-8684,1,1,1,0,Accountants,2.0,-21,0
6250,5009209,F,N,N,0,292500.0,State servant,Secondary / secondary special,Married,House / apartment,-20953,-8684,1,1,1,0,Accountants,2.0,-22,0
6251,5009209,F,N,N,0,292500.0,State servant,Secondary / secondary special,Married,House / apartment,-20953,-8684,1,1,1,0,Accountants,2.0,-23,0
6252,5009209,F,N,N,0,292500.0,State servant,Secondary / secondary special,Married,House / apartment,-20953,-8684,1,1,1,0,Accountants,2.0,-24,0
6253,5009209,F,N,N,0,292500.0,State servant,Secondary / secondary special,Married,House / apartment,-20953,-8684,1,1,1,0,Accountants,2.0,-25,0
6254,5009209,F,N,N,0,292500.0,State servant,Secondary / secondary special,Married,House / apartment,-20953,-8684,1,1,1,0,Accountants,2.0,-26,0
6255,5009209,F,N,N,0,292500.0,State servant,Secondary / secondary special,Married,House / apartment,-20953,-8684,1,1,1,0,Accountants,2.0,-27,0
6256,5009209,F,N,N,0,292500.0,State servant,Secondary / secondary special,Married,House / apartment,-20953,-8684,1,1,1,0,Accountants,2.0,-28,0
6257,5009209,F,N,N,0,292500.0,State servant,Secondary / secondary special,Married,House / apartment,-20953,-8684,1,1,1,0,Accountants,2.0,-29,0
6258,5009209,F,N,N,0,292500.0,State servant,Secondary / secondary special,Married,House / apartment,-20953,-8684,1,1,1,0,Accountants,2.0,-30,1
6259,5009209,F,N,N,0,292500.0,State servant,Secondary / secondary special,Married,House / apartment,-20953,-8684,1,1,1,0,Accountants,2.0,-31,0
6260,5009209,F,N,N,0,292500.0,State servant,Secondary / secondary special,Married,House / apartment,-20953,-8684,1,1,1,0,Accountants,2.0,-32,0
6261,5009209,F,N,N,0,292500.0,State servant,Secondary / secondary special,Married,House / apartment,-20953,-8684,1,1,1,0,Accountants,2.0,-33,0
6262,5009209,F,N,N,0,292500.0,State servant,Secondary / secondary special,Married,House / apartment,-20953,-8684,1,1,1,0,Accountants,2.0,-34,0
6263,5009209,F,N,N,0,292500.0,State servant,Secondary / secondary special,Married,House / apartment,-20953,-8684,1,1,1,0,Accountants,2.0,-35,0
6264,5009209,F,N,N,0,292500.0,State servant,Secondary / secondary special,Married,House / apartment,-20953,-8684,1,1,1,0,Accountants,2.0,-36,0
6265,5009209,F,N,N,0,292500.0,State servant,Secondary / secondary special,Married,House / apartment,-20953,-8684,1,1,1,0,Accountants,2.0,-37,0
6266,5009209,F,N,N,0,292500.0,State servant,Secondary / secondary special,Married,House / apartment,-20953,-8684,1,1,1,0,Accountants,2.0,-38,0
6267,5009209,F,N,N,0,292500.0,State servant,Secondary / secondary special,Married,House / apartment,-20953,-8684,1,1,1,0,Accountants,2.0,-39,0
6268,5009209,F,N,N,0,292500.0,State servant,Secondary / secondary special,Married,House / apartment,-20953,-8684,1,1,1,0,Accountants,2.0,-40,0
6269,5009209,F,N,N,0,292500.0,State servant,Secondary / secondary special,Married,House / apartment,-20953,-8684,1,1,1,0,Accountants,2.0,-41,0
6270,5009209,F,N,N,0,292500.0,State servant,Secondary / secondary special,Married,House / apartment,-20953,-8684,1,1,1,0,Accountants,2.0,-42,0
6271,5009209,F,N,N,0,292500.0,State servant,Secondary / secondary special,Married,House / apartment,-20953,-8684,1,1,1,0,Accountants,2.0,-43,0
6272,5009209,F,N,N,0,292500.0,State servant,Secondary / secondary special,Married,House / apartment,-20953,-8684,1,1,1,0,Accountants,2.0,-44,0
6273,5009209,F,N,N,0,292500.0,State servant,Secondary / secondary special,Married,House / apartment,-20953,-8684,1,1,1,0,Accountants,2.0,-45,0
6274,5009210,F,N,N,0,292500.0,State servant,Secondary / secondary special,Married,House / apartment,-20953,-8684,1,1,1,0,Accountants,2.0,-56,X
6275,5009210,F,N,N,0,292500.0,State servant,Secondary / secondary special,Married,House / apartment,-20953,-8684,1,1,1,0,Accountants,2.0,-57,0
6276,5009210,F,N,N,0,292500.0,State servant,Secondary / secondary special,Married,House / apartment,-20953,-8684,1,1,1,0,Accountants,2.0,-58,0
6277,5009210,F,N,N,0,292500.0,State servant,Secondary / secondary special,Married,House / apartment,-20953,-8684,1,1,1,0,Accountants,2.0,-59,0
6278,5009213,F,N,N,0,270000.0,Working,Higher education,Married,House / apartment,-12333,-860,1,1,1,0,Accountants,2.0,0,X
6279,5009213,F,N,N,0,270000.0,Working,Higher education,Married,House / apartment,-12333,-860,1,1,1,0,Accountants,2.0,-1,X
6280,5009213,F,N,N,0,270000.0,Working,Higher education,Married,House / apartment,-12333,-860,1,1,1,0,Accountants,2.0,-2,X
6281,5009213,F,N,N,0,270000.0,Working,Higher education,Married,House / apartment,-12333,-860,1,1,1,0,Accountants,2.0,-3,X
6282,5009213,F,N,N,0,270000.0,Working,Higher education,Married,House / apartment,-12333,-860,1,1,1,0,Accountants,2.0,-4,X
6283,5009213,F,N,N,0,270000.0,Working,Higher education,Married,House / apartment,-12333,-860,1,1,1,0,Accountants,2.0,-5,X
6284,5009213,F,N,N,0,270000.0,Working,Higher education,Married,House / apartment,-12333,-860,1,1,1,0,Accountants,2.0,-6,X
6285,5009213,F,N,N,0,270000.0,Working,Higher education,Married,House / apartment,-12333,-860,1,1,1,0,Accountants,2.0,-7,X
6286,5009213,F,N,N,0,270000.0,Working,Higher education,Married,House / apartment,-12333,-860,1,1,1,0,Accountants,2.0,-8,X
6287,5009213,F,N,N,0,270000.0,Working,Higher education,Married,House / apartment,-12333,-860,1,1,1,0,Accountants,2.0,-9,X
6288,5009213,F,N,N,0,270000.0,Working,Higher education,Married,House / apartment,-12333,-860,1,1,1,0,Accountants,2.0,-10,X
6289,5009213,F,N,N,0,270000.0,Working,Higher education,Married,House / apartment,-12333,-860,1,1,1,0,Accountants,2.0,-11,X
6290,5009213,F,N,N,0,270000.0,Working,Higher education,Married,House / apartment,-12333,-860,1,1,1,0,Accountants,2.0,-12,X
6291,5009213,F,N,N,0,270000.0,Working,Higher education,Married,House / apartment,-12333,-860,1,1,1,0,Accountants,2.0,-13,X
6292,5009213,F,N,N,0,270000.0,Working,Higher education,Married,House / apartment,-12333,-860,1,1,1,0,Accountants,2.0,-14,X
6293,5009213,F,N,N,0,270000.0,Working,Higher education,Married,House / apartment,-12333,-860,1,1,1,0,Accountants,2.0,-15,X
6294,5009213,F,N,N,0,270000.0,Working,Higher education,Married,House / apartment,-12333,-860,1,1,1,0,Accountants,2.0,-16,X
6295,5009213,F,N,N,0,270000.0,Working,Higher education,Married,House / apartment,-12333,-860,1,1,1,0,Accountants,2.0,-17,X
6296,5009213,F,N,N,0,270000.0,Working,Higher education,Married,House / apartment,-12333,-860,1,1,1,0,Accountants,2.0,-18,X
6297,5009213,F,N,N,0,270000.0,Working,Higher education,Married,House / apartment,-12333,-860,1,1,1,0,Accountants,2.0,-19,X
6298,5009213,F,N,N,0,270000.0,Working,Higher education,Married,House / apartment,-12333,-860,1,1,1,0,Accountants,2.0,-20,X
6299,5009213,F,N,N,0,270000.0,Working,Higher education,Married,House / apartment,-12333,-860,1,1,1,0,Accountants,2.0,-21,X
6300,5009213,F,N,N,0,270000.0,Working,Higher education,Married,House / apartment,-12333,-860,1,1,1,0,Accountants,2.0,-22,X
6301,5009215,F,N,N,0,270000.0,Working,Higher education,Married,House / apartment,-12333,-860,1,1,1,0,Accountants,2.0,0,C
6302,5009215,F,N,N,0,270000.0,Working,Higher education,Married,House / apartment,-12333,-860,1,1,1,0,Accountants,2.0,-1,C
6303,5009215,F,N,N,0,270000.0,Working,Higher education,Married,House / apartment,-12333,-860,1,1,1,0,Accountants,2.0,-2,C
6304,5009215,F,N,N,0,270000.0,Working,Higher education,Married,House / apartment,-12333,-860,1,1,1,0,Accountants,2.0,-3,C
6305,5009215,F,N,N,0,270000.0,Working,Higher education,Married,House / apartment,-12333,-860,1,1,1,0,Accountants,2.0,-4,C
6306,5009215,F,N,N,0,270000.0,Working,Higher education,Married,House / apartment,-12333,-860,1,1,1,0,Accountants,2.0,-5,C
6307,5009215,F,N,N,0,270000.0,Working,Higher education,Married,House / apartment,-12333,-860,1,1,1,0,Accountants,2.0,-6,C
6308,5009215,F,N,N,0,270000.0,Working,Higher education,Married,House / apartment,-12333,-860,1,1,1,0,Accountants,2.0,-7,C
6309,5009215,F,N,N,0,270000.0,Working,Higher education,Married,House / apartment,-12333,-860,1,1,1,0,Accountants,2.0,-8,C
6310,5009215,F,N,N,0,270000.0,Working,Higher education,Married,House / apartment,-12333,-860,1,1,1,0,Accountants,2.0,-9,C
6311,5009215,F,N,N,0,270000.0,Working,Higher education,Married,House / apartment,-12333,-860,1,1,1,0,Accountants,2.0,-10,C
6312,5009215,F,N,N,0,270000.0,Working,Higher education,Married,House / apartment,-12333,-860,1,1,1,0,Accountants,2.0,-11,C
6313,5009215,F,N,N,0,270000.0,Working,Higher education,Married,House / apartment,-12333,-860,1,1,1,0,Accountants,2.0,-12,C
6314,5009215,F,N,N,0,270000.0,Working,Higher education,Married,House / apartment,-12333,-860,1,1,1,0,Accountants,2.0,-13,C
6315,5009215,F,N,N,0,270000.0,Working,Higher education,Married,House / apartment,-12333,-860,1,1,1,0,Accountants,2.0,-14,C
6316,5009215,F,N,N,0,270000.0,Working,Higher education,Married,House / apartment,-12333,-860,1,1,1,0,Accountants,2.0,-15,C
6317,5009215,F,N,N,0,270000.0,Working,Higher education,Married,House / apartment,-12333,-860,1,1,1,0,Accountants,2.0,-16,C
6318,5009215,F,N,N,0,270000.0,Working,Higher education,Married,House / apartment,-12333,-860,1,1,1,0,Accountants,2.0,-17,C
6319,5009215,F,N,N,0,270000.0,Working,Higher education,Married,House / apartment,-12333,-860,1,1,1,0,Accountants,2.0,-18,C
6320,5009215,F,N,N,0,270000.0,Working,Higher education,Married,House / apartment,-12333,-860,1,1,1,0,Accountants,2.0,-19,C
6321,5009215,F,N,N,0,270000.0,Working,Higher education,Married,House / apartment,-12333,-860,1,1,1,0,Accountants,2.0,-20,C
6322,5009215,F,N,N,0,270000.0,Working,Higher education,Married,House / apartment,-12333,-860,1,1,1,0,Accountants,2.0,-21,C
6323,5009215,F,N,N,0,270000.0,Working,Higher education,Married,House / apartment,-12333,-860,1,1,1,0,Accountants,2.0,-22,C
6324,5009215,F,N,N,0,270000.0,Working,Higher education,Married,House / apartment,-12333,-860,1,1,1,0,Accountants,2.0,-23,C
6325,5009215,F,N,N,0,270000.0,Working,Higher education,Married,House / apartment,-12333,-860,1,1,1,0,Accountants,2.0,-24,C
6326,5009215,F,N,N,0,270000.0,Working,Higher education,Married,House / apartment,-12333,-860,1,1,1,0,Accountants,2.0,-25,C
6327,5009215,F,N,N,0,270000.0,Working,Higher education,Married,House / apartment,-12333,-860,1,1,1,0,Accountants,2.0,-26,C
6328,5009215,F,N,N,0,270000.0,Working,Higher education,Married,House / apartment,-12333,-860,1,1,1,0,Accountants,2.0,-27,C
6329,5009215,F,N,N,0,270000.0,Working,Higher education,Married,House / apartment,-12333,-860,1,1,1,0,Accountants,2.0,-28,C
6330,5009215,F,N,N,0,270000.0,Working,Higher education,Married,House / apartment,-12333,-860,1,1,1,0,Accountants,2.0,-29,C
6331,5009215,F,N,N,0,270000.0,Working,Higher education,Married,House / apartment,-12333,-860,1,1,1,0,Accountants,2.0,-30,C
6332,5009215,F,N,N,0,270000.0,Working,Higher education,Married,House / apartment,-12333,-860,1,1,1,0,Accountants,2.0,-31,C
6333,5009215,F,N,N,0,270000.0,Working,Higher education,Married,House / apartment,-12333,-860,1,1,1,0,Accountants,2.0,-32,C
6334,5009215,F,N,N,0,270000.0,Working,Higher education,Married,House / apartment,-12333,-860,1,1,1,0,Accountants,2.0,-33,C
6335,5009215,F,N,N,0,270000.0,Working,Higher education,Married,House / apartment,-12333,-860,1,1,1,0,Accountants,2.0,-34,C
6336,5009215,F,N,N,0,270000.0,Working,Higher education,Married,House / apartment,-12333,-860,1,1,1,0,Accountants,2.0,-35,C
6337,5009215,F,N,N,0,270000.0,Working,Higher education,Married,House / apartment,-12333,-860,1,1,1,0,Accountants,2.0,-36,C
6338,5009215,F,N,N,0,270000.0,Working,Higher education,Married,House / apartment,-12333,-860,1,1,1,0,Accountants,2.0,-37,C
6339,5009215,F,N,N,0,270000.0,Working,Higher education,Married,House / apartment,-12333,-860,1,1,1,0,Accountants,2.0,-38,C
6340,5009215,F,N,N,0,270000.0,Working,Higher education,Married,House / apartment,-12333,-860,1,1,1,0,Accountants,2.0,-39,C
6341,5009215,F,N,N,0,270000.0,Working,Higher education,Married,House / apartment,-12333,-860,1,1,1,0,Accountants,2.0,-40,0
6342,5009215,F,N,N,0,270000.0,Working,Higher education,Married,House / apartment,-12333,-860,1,1,1,0,Accountants,2.0,-41,0
6343,5009215,F,N,N,0,270000.0,Working,Higher education,Married,House / apartment,-12333,-860,1,1,1,0,Accountants,2.0,-42,0
6344,5009215,F,N,N,0,270000.0,Working,Higher education,Married,House / apartment,-12333,-860,1,1,1,0,Accountants,2.0,-43,0
6345,5009215,F,N,N,0,270000.0,Working,Higher education,Married,House / apartment,-12333,-860,1,1,1,0,Accountants,2.0,-44,0
6346,5009215,F,N,N,0,270000.0,Working,Higher education,Married,House / apartment,-12333,-860,1,1,1,0,Accountants,2.0,-45,0
6347,5009215,F,N,N,0,270000.0,Working,Higher education,Married,House / apartment,-12333,-860,1,1,1,0,Accountants,2.0,-46,0
6348,5009215,F,N,N,0,270000.0,Working,Higher education,Married,House / apartment,-12333,-860,1,1,1,0,Accountants,2.0,-47,0
6349,5009215,F,N,N,0,270000.0,Working,Higher education,Married,House / apartment,-12333,-860,1,1,1,0,Accountants,2.0,-48,1
6350,5009215,F,N,N,0,270000.0,Working,Higher education,Married,House / apartment,-12333,-860,1,1,1,0,Accountants,2.0,-49,0
6351,5009215,F,N,N,0,270000.0,Working,Higher education,Married,House / apartment,-12333,-860,1,1,1,0,Accountants,2.0,-50,0
6352,5009215,F,N,N,0,270000.0,Working,Higher education,Married,House / apartment,-12333,-860,1,1,1,0,Accountants,2.0,-51,0
6353,5009215,F,N,N,0,270000.0,Working,Higher education,Married,House / apartment,-12333,-860,1,1,1,0,Accountants,2.0,-52,0
6354,5009215,F,N,N,0,270000.0,Working,Higher education,Married,House / apartment,-12333,-860,1,1,1,0,Accountants,2.0,-53,0
6355,5009215,F,N,N,0,270000.0,Working,Higher education,Married,House / apartment,-12333,-860,1,1,1,0,Accountants,2.0,-54,0
6356,5009215,F,N,N,0,270000.0,Working,Higher education,Married,House / apartment,-12333,-860,1,1,1,0,Accountants,2.0,-55,0
6357,5009215,F,N,N,0,270000.0,Working,Higher education,Married,House / apartment,-12333,-860,1,1,1,0,Accountants,2.0,-56,0
6358,5009215,F,N,N,0,270000.0,Working,Higher education,Married,House / apartment,-12333,-860,1,1,1,0,Accountants,2.0,-57,0
6359,5009216,F,N,N,0,270000.0,Working,Higher education,Married,House / apartment,-12333,-860,1,1,1,0,Accountants,2.0,0,C
6360,5009216,F,N,N,0,270000.0,Working,Higher education,Married,House / apartment,-12333,-860,1,1,1,0,Accountants,2.0,-1,0
6361,5009216,F,N,N,0,270000.0,Working,Higher education,Married,House / apartment,-12333,-860,1,1,1,0,Accountants,2.0,-2,0
6362,5009216,F,N,N,0,270000.0,Working,Higher education,Married,House / apartment,-12333,-860,1,1,1,0,Accountants,2.0,-3,0
6363,5009216,F,N,N,0,270000.0,Working,Higher education,Married,House / apartment,-12333,-860,1,1,1,0,Accountants,2.0,-4,0
6364,5009216,F,N,N,0,270000.0,Working,Higher education,Married,House / apartment,-12333,-860,1,1,1,0,Accountants,2.0,-5,0
6365,5009216,F,N,N,0,270000.0,Working,Higher education,Married,House / apartment,-12333,-860,1,1,1,0,Accountants,2.0,-6,X
6366,5009217,F,N,N,0,270000.0,Working,Higher education,Married,House / apartment,-12333,-860,1,1,1,0,Accountants,2.0,0,X
6367,5009217,F,N,N,0,270000.0,Working,Higher education,Married,House / apartment,-12333,-860,1,1,1,0,Accountants,2.0,-1,0
6368,5009217,F,N,N,0,270000.0,Working,Higher education,Married,House / apartment,-12333,-860,1,1,1,0,Accountants,2.0,-2,0
6369,5009217,F,N,N,0,270000.0,Working,Higher education,Married,House / apartment,-12333,-860,1,1,1,0,Accountants,2.0,-3,0
6370,5009217,F,N,N,0,270000.0,Working,Higher education,Married,House / apartment,-12333,-860,1,1,1,0,Accountants,2.0,-4,0
6371,5009217,F,N,N,0,270000.0,Working,Higher education,Married,House / apartment,-12333,-860,1,1,1,0,Accountants,2.0,-5,0
6372,5009217,F,N,N,0,270000.0,Working,Higher education,Married,House / apartment,-12333,-860,1,1,1,0,Accountants,2.0,-6,0
6373,5009220,F,Y,N,0,225000.0,Working,Secondary / secondary special,Married,House / apartment,-14667,-798,1,1,0,0,Managers,2.0,0,C
6374,5009220,F,Y,N,0,225000.0,Working,Secondary / secondary special,Married,House / apartment,-14667,-798,1,1,0,0,Managers,2.0,-1,C
6375,5009220,F,Y,N,0,225000.0,Working,Secondary / secondary special,Married,House / apartment,-14667,-798,1,1,0,0,Managers,2.0,-2,C
6376,5009220,F,Y,N,0,225000.0,Working,Secondary / secondary special,Married,House / apartment,-14667,-798,1,1,0,0,Managers,2.0,-3,C
6377,5009220,F,Y,N,0,225000.0,Working,Secondary / secondary special,Married,House / apartment,-14667,-798,1,1,0,0,Managers,2.0,-4,C
6378,5009220,F,Y,N,0,225000.0,Working,Secondary / secondary special,Married,House / apartment,-14667,-798,1,1,0,0,Managers,2.0,-5,C
6379,5009220,F,Y,N,0,225000.0,Working,Secondary / secondary special,Married,House / apartment,-14667,-798,1,1,0,0,Managers,2.0,-6,C
6380,5009220,F,Y,N,0,225000.0,Working,Secondary / secondary special,Married,House / apartment,-14667,-798,1,1,0,0,Managers,2.0,-7,C
6381,5009220,F,Y,N,0,225000.0,Working,Secondary / secondary special,Married,House / apartment,-14667,-798,1,1,0,0,Managers,2.0,-8,C
6382,5009220,F,Y,N,0,225000.0,Working,Secondary / secondary special,Married,House / apartment,-14667,-798,1,1,0,0,Managers,2.0,-9,C
6383,5009220,F,Y,N,0,225000.0,Working,Secondary / secondary special,Married,House / apartment,-14667,-798,1,1,0,0,Managers,2.0,-10,C
6384,5009220,F,Y,N,0,225000.0,Working,Secondary / secondary special,Married,House / apartment,-14667,-798,1,1,0,0,Managers,2.0,-11,C
6385,5009220,F,Y,N,0,225000.0,Working,Secondary / secondary special,Married,House / apartment,-14667,-798,1,1,0,0,Managers,2.0,-12,C
6386,5009220,F,Y,N,0,225000.0,Working,Secondary / secondary special,Married,House / apartment,-14667,-798,1,1,0,0,Managers,2.0,-13,C
6387,5009220,F,Y,N,0,225000.0,Working,Secondary / secondary special,Married,House / apartment,-14667,-798,1,1,0,0,Managers,2.0,-14,C
6388,5009220,F,Y,N,0,225000.0,Working,Secondary / secondary special,Married,House / apartment,-14667,-798,1,1,0,0,Managers,2.0,-15,C
6389,5009220,F,Y,N,0,225000.0,Working,Secondary / secondary special,Married,House / apartment,-14667,-798,1,1,0,0,Managers,2.0,-16,C
6390,5009220,F,Y,N,0,225000.0,Working,Secondary / secondary special,Married,House / apartment,-14667,-798,1,1,0,0,Managers,2.0,-17,C
6391,5009220,F,Y,N,0,225000.0,Working,Secondary / secondary special,Married,House / apartment,-14667,-798,1,1,0,0,Managers,2.0,-18,C
6392,5009220,F,Y,N,0,225000.0,Working,Secondary / secondary special,Married,House / apartment,-14667,-798,1,1,0,0,Managers,2.0,-19,C
6393,5009220,F,Y,N,0,225000.0,Working,Secondary / secondary special,Married,House / apartment,-14667,-798,1,1,0,0,Managers,2.0,-20,C
6394,5009220,F,Y,N,0,225000.0,Working,Secondary / secondary special,Married,House / apartment,-14667,-798,1,1,0,0,Managers,2.0,-21,0
6395,5009220,F,Y,N,0,225000.0,Working,Secondary / secondary special,Married,House / apartment,-14667,-798,1,1,0,0,Managers,2.0,-22,0
6396,5009220,F,Y,N,0,225000.0,Working,Secondary / secondary special,Married,House / apartment,-14667,-798,1,1,0,0,Managers,2.0,-23,0
6397,5009220,F,Y,N,0,225000.0,Working,Secondary / secondary special,Married,House / apartment,-14667,-798,1,1,0,0,Managers,2.0,-24,0
6398,5009220,F,Y,N,0,225000.0,Working,Secondary / secondary special,Married,House / apartment,-14667,-798,1,1,0,0,Managers,2.0,-25,0
6399,5009220,F,Y,N,0,225000.0,Working,Secondary / secondary special,Married,House / apartment,-14667,-798,1,1,0,0,Managers,2.0,-26,0
6400,5009220,F,Y,N,0,225000.0,Working,Secondary / secondary special,Married,House / apartment,-14667,-798,1,1,0,0,Managers,2.0,-27,0
6401,5009222,F,Y,N,0,225000.0,Working,Secondary / secondary special,Married,House / apartment,-14667,-798,1,1,0,0,Managers,2.0,-12,C
6402,5009222,F,Y,N,0,225000.0,Working,Secondary / secondary special,Married,House / apartment,-14667,-798,1,1,0,0,Managers,2.0,-13,C
6403,5009222,F,Y,N,0,225000.0,Working,Secondary / secondary special,Married,House / apartment,-14667,-798,1,1,0,0,Managers,2.0,-14,C
6404,5009222,F,Y,N,0,225000.0,Working,Secondary / secondary special,Married,House / apartment,-14667,-798,1,1,0,0,Managers,2.0,-15,C
6405,5009222,F,Y,N,0,225000.0,Working,Secondary / secondary special,Married,House / apartment,-14667,-798,1,1,0,0,Managers,2.0,-16,C
6406,5009222,F,Y,N,0,225000.0,Working,Secondary / secondary special,Married,House / apartment,-14667,-798,1,1,0,0,Managers,2.0,-17,C
6407,5009222,F,Y,N,0,225000.0,Working,Secondary / secondary special,Married,House / apartment,-14667,-798,1,1,0,0,Managers,2.0,-18,C
6408,5009222,F,Y,N,0,225000.0,Working,Secondary / secondary special,Married,House / apartment,-14667,-798,1,1,0,0,Managers,2.0,-19,C
6409,5009222,F,Y,N,0,225000.0,Working,Secondary / secondary special,Married,House / apartment,-14667,-798,1,1,0,0,Managers,2.0,-20,0
6410,5009222,F,Y,N,0,225000.0,Working,Secondary / secondary special,Married,House / apartment,-14667,-798,1,1,0,0,Managers,2.0,-21,0
6411,5009222,F,Y,N,0,225000.0,Working,Secondary / secondary special,Married,House / apartment,-14667,-798,1,1,0,0,Managers,2.0,-22,X
6412,5009222,F,Y,N,0,225000.0,Working,Secondary / secondary special,Married,House / apartment,-14667,-798,1,1,0,0,Managers,2.0,-23,X
6413,5009222,F,Y,N,0,225000.0,Working,Secondary / secondary special,Married,House / apartment,-14667,-798,1,1,0,0,Managers,2.0,-24,X
6414,5009222,F,Y,N,0,225000.0,Working,Secondary / secondary special,Married,House / apartment,-14667,-798,1,1,0,0,Managers,2.0,-25,0
6415,5009222,F,Y,N,0,225000.0,Working,Secondary / secondary special,Married,House / apartment,-14667,-798,1,1,0,0,Managers,2.0,-26,0
6416,5009222,F,Y,N,0,225000.0,Working,Secondary / secondary special,Married,House / apartment,-14667,-798,1,1,0,0,Managers,2.0,-27,0
6417,5009222,F,Y,N,0,225000.0,Working,Secondary / secondary special,Married,House / apartment,-14667,-798,1,1,0,0,Managers,2.0,-28,0
6418,5009222,F,Y,N,0,225000.0,Working,Secondary / secondary special,Married,House / apartment,-14667,-798,1,1,0,0,Managers,2.0,-29,0
6419,5009222,F,Y,N,0,225000.0,Working,Secondary / secondary special,Married,House / apartment,-14667,-798,1,1,0,0,Managers,2.0,-30,0
6420,5009222,F,Y,N,0,225000.0,Working,Secondary / secondary special,Married,House / apartment,-14667,-798,1,1,0,0,Managers,2.0,-31,0
6421,5009222,F,Y,N,0,225000.0,Working,Secondary / secondary special,Married,House / apartment,-14667,-798,1,1,0,0,Managers,2.0,-32,0
6422,5009222,F,Y,N,0,225000.0,Working,Secondary / secondary special,Married,House / apartment,-14667,-798,1,1,0,0,Managers,2.0,-33,0
6423,5009222,F,Y,N,0,225000.0,Working,Secondary / secondary special,Married,House / apartment,-14667,-798,1,1,0,0,Managers,2.0,-34,0
6424,5009222,F,Y,N,0,225000.0,Working,Secondary / secondary special,Married,House / apartment,-14667,-798,1,1,0,0,Managers,2.0,-35,0
6425,5009222,F,Y,N,0,225000.0,Working,Secondary / secondary special,Married,House / apartment,-14667,-798,1,1,0,0,Managers,2.0,-36,0
6426,5009222,F,Y,N,0,225000.0,Working,Secondary / secondary special,Married,House / apartment,-14667,-798,1,1,0,0,Managers,2.0,-37,0
6427,5009222,F,Y,N,0,225000.0,Working,Secondary / secondary special,Married,House / apartment,-14667,-798,1,1,0,0,Managers,2.0,-38,0
6428,5009222,F,Y,N,0,225000.0,Working,Secondary / secondary special,Married,House / apartment,-14667,-798,1,1,0,0,Managers,2.0,-39,0
6429,5009222,F,Y,N,0,225000.0,Working,Secondary / secondary special,Married,House / apartment,-14667,-798,1,1,0,0,Managers,2.0,-40,0
6430,5009222,F,Y,N,0,225000.0,Working,Secondary / secondary special,Married,House / apartment,-14667,-798,1,1,0,0,Managers,2.0,-41,0
6431,5009222,F,Y,N,0,225000.0,Working,Secondary / secondary special,Married,House / apartment,-14667,-798,1,1,0,0,Managers,2.0,-42,0
6432,5009222,F,Y,N,0,225000.0,Working,Secondary / secondary special,Married,House / apartment,-14667,-798,1,1,0,0,Managers,2.0,-43,0
6433,5009222,F,Y,N,0,225000.0,Working,Secondary / secondary special,Married,House / apartment,-14667,-798,1,1,0,0,Managers,2.0,-44,0
6434,5009222,F,Y,N,0,225000.0,Working,Secondary / secondary special,Married,House / apartment,-14667,-798,1,1,0,0,Managers,2.0,-45,0
6435,5009222,F,Y,N,0,225000.0,Working,Secondary / secondary special,Married,House / apartment,-14667,-798,1,1,0,0,Managers,2.0,-46,0
6436,5009222,F,Y,N,0,225000.0,Working,Secondary / secondary special,Married,House / apartment,-14667,-798,1,1,0,0,Managers,2.0,-47,0
6437,5009222,F,Y,N,0,225000.0,Working,Secondary / secondary special,Married,House / apartment,-14667,-798,1,1,0,0,Managers,2.0,-48,0
6438,5009222,F,Y,N,0,225000.0,Working,Secondary / secondary special,Married,House / apartment,-14667,-798,1,1,0,0,Managers,2.0,-49,0
6439,5009222,F,Y,N,0,225000.0,Working,Secondary / secondary special,Married,House / apartment,-14667,-798,1,1,0,0,Managers,2.0,-50,0
6440,5009222,F,Y,N,0,225000.0,Working,Secondary / secondary special,Married,House / apartment,-14667,-798,1,1,0,0,Managers,2.0,-51,0
6441,5009222,F,Y,N,0,225000.0,Working,Secondary / secondary special,Married,House / apartment,-14667,-798,1,1,0,0,Managers,2.0,-52,0
6442,5009222,F,Y,N,0,225000.0,Working,Secondary / secondary special,Married,House / apartment,-14667,-798,1,1,0,0,Managers,2.0,-53,0
6443,5009222,F,Y,N,0,225000.0,Working,Secondary / secondary special,Married,House / apartment,-14667,-798,1,1,0,0,Managers,2.0,-54,0
6444,5009222,F,Y,N,0,225000.0,Working,Secondary / secondary special,Married,House / apartment,-14667,-798,1,1,0,0,Managers,2.0,-55,0
6445,5009222,F,Y,N,0,225000.0,Working,Secondary / secondary special,Married,House / apartment,-14667,-798,1,1,0,0,Managers,2.0,-56,0
6446,5009222,F,Y,N,0,225000.0,Working,Secondary / secondary special,Married,House / apartment,-14667,-798,1,1,0,0,Managers,2.0,-57,0
6447,5009222,F,Y,N,0,225000.0,Working,Secondary / secondary special,Married,House / apartment,-14667,-798,1,1,0,0,Managers,2.0,-58,0
6448,5009222,F,Y,N,0,225000.0,Working,Secondary / secondary special,Married,House / apartment,-14667,-798,1,1,0,0,Managers,2.0,-59,0
6449,5009223,F,Y,N,0,225000.0,Working,Secondary / secondary special,Married,House / apartment,-14667,-798,1,1,0,0,Managers,2.0,-10,C
6450,5009223,F,Y,N,0,225000.0,Working,Secondary / secondary special,Married,House / apartment,-14667,-798,1,1,0,0,Managers,2.0,-11,C
6451,5009223,F,Y,N,0,225000.0,Working,Secondary / secondary special,Married,House / apartment,-14667,-798,1,1,0,0,Managers,2.0,-12,C
6452,5009223,F,Y,N,0,225000.0,Working,Secondary / secondary special,Married,House / apartment,-14667,-798,1,1,0,0,Managers,2.0,-13,C
6453,5009223,F,Y,N,0,225000.0,Working,Secondary / secondary special,Married,House / apartment,-14667,-798,1,1,0,0,Managers,2.0,-14,C
6454,5009223,F,Y,N,0,225000.0,Working,Secondary / secondary special,Married,House / apartment,-14667,-798,1,1,0,0,Managers,2.0,-15,C
6455,5009223,F,Y,N,0,225000.0,Working,Secondary / secondary special,Married,House / apartment,-14667,-798,1,1,0,0,Managers,2.0,-16,C
6456,5009223,F,Y,N,0,225000.0,Working,Secondary / secondary special,Married,House / apartment,-14667,-798,1,1,0,0,Managers,2.0,-17,C
6457,5009223,F,Y,N,0,225000.0,Working,Secondary / secondary special,Married,House / apartment,-14667,-798,1,1,0,0,Managers,2.0,-18,C
6458,5009223,F,Y,N,0,225000.0,Working,Secondary / secondary special,Married,House / apartment,-14667,-798,1,1,0,0,Managers,2.0,-19,C
6459,5009223,F,Y,N,0,225000.0,Working,Secondary / secondary special,Married,House / apartment,-14667,-798,1,1,0,0,Managers,2.0,-20,C
6460,5009223,F,Y,N,0,225000.0,Working,Secondary / secondary special,Married,House / apartment,-14667,-798,1,1,0,0,Managers,2.0,-21,C
6461,5009223,F,Y,N,0,225000.0,Working,Secondary / secondary special,Married,House / apartment,-14667,-798,1,1,0,0,Managers,2.0,-22,C
6462,5009223,F,Y,N,0,225000.0,Working,Secondary / secondary special,Married,House / apartment,-14667,-798,1,1,0,0,Managers,2.0,-23,C
6463,5009223,F,Y,N,0,225000.0,Working,Secondary / secondary special,Married,House / apartment,-14667,-798,1,1,0,0,Managers,2.0,-24,C
6464,5009223,F,Y,N,0,225000.0,Working,Secondary / secondary special,Married,House / apartment,-14667,-798,1,1,0,0,Managers,2.0,-25,C
6465,5009223,F,Y,N,0,225000.0,Working,Secondary / secondary special,Married,House / apartment,-14667,-798,1,1,0,0,Managers,2.0,-26,C
6466,5009223,F,Y,N,0,225000.0,Working,Secondary / secondary special,Married,House / apartment,-14667,-798,1,1,0,0,Managers,2.0,-27,0
6467,5009223,F,Y,N,0,225000.0,Working,Secondary / secondary special,Married,House / apartment,-14667,-798,1,1,0,0,Managers,2.0,-28,0
6468,5009223,F,Y,N,0,225000.0,Working,Secondary / secondary special,Married,House / apartment,-14667,-798,1,1,0,0,Managers,2.0,-29,0
6469,5009223,F,Y,N,0,225000.0,Working,Secondary / secondary special,Married,House / apartment,-14667,-798,1,1,0,0,Managers,2.0,-30,0
6470,5009223,F,Y,N,0,225000.0,Working,Secondary / secondary special,Married,House / apartment,-14667,-798,1,1,0,0,Managers,2.0,-31,0
6471,5009223,F,Y,N,0,225000.0,Working,Secondary / secondary special,Married,House / apartment,-14667,-798,1,1,0,0,Managers,2.0,-32,0
6472,5009223,F,Y,N,0,225000.0,Working,Secondary / secondary special,Married,House / apartment,-14667,-798,1,1,0,0,Managers,2.0,-33,0
6473,5009223,F,Y,N,0,225000.0,Working,Secondary / secondary special,Married,House / apartment,-14667,-798,1,1,0,0,Managers,2.0,-34,0
6474,5009223,F,Y,N,0,225000.0,Working,Secondary / secondary special,Married,House / apartment,-14667,-798,1,1,0,0,Managers,2.0,-35,0
6475,5009223,F,Y,N,0,225000.0,Working,Secondary / secondary special,Married,House / apartment,-14667,-798,1,1,0,0,Managers,2.0,-36,0
6476,5009223,F,Y,N,0,225000.0,Working,Secondary / secondary special,Married,House / apartment,-14667,-798,1,1,0,0,Managers,2.0,-37,0
6477,5009223,F,Y,N,0,225000.0,Working,Secondary / secondary special,Married,House / apartment,-14667,-798,1,1,0,0,Managers,2.0,-38,0
6478,5009223,F,Y,N,0,225000.0,Working,Secondary / secondary special,Married,House / apartment,-14667,-798,1,1,0,0,Managers,2.0,-39,0
6479,5009223,F,Y,N,0,225000.0,Working,Secondary / secondary special,Married,House / apartment,-14667,-798,1,1,0,0,Managers,2.0,-40,0
6480,5009223,F,Y,N,0,225000.0,Working,Secondary / secondary special,Married,House / apartment,-14667,-798,1,1,0,0,Managers,2.0,-41,0
6481,5009223,F,Y,N,0,225000.0,Working,Secondary / secondary special,Married,House / apartment,-14667,-798,1,1,0,0,Managers,2.0,-42,0
6482,5009223,F,Y,N,0,225000.0,Working,Secondary / secondary special,Married,House / apartment,-14667,-798,1,1,0,0,Managers,2.0,-43,0
6483,5009223,F,Y,N,0,225000.0,Working,Secondary / secondary special,Married,House / apartment,-14667,-798,1,1,0,0,Managers,2.0,-44,0
6484,5009223,F,Y,N,0,225000.0,Working,Secondary / secondary special,Married,House / apartment,-14667,-798,1,1,0,0,Managers,2.0,-45,0
6485,5009223,F,Y,N,0,225000.0,Working,Secondary / secondary special,Married,House / apartment,-14667,-798,1,1,0,0,Managers,2.0,-46,0
6486,5009223,F,Y,N,0,225000.0,Working,Secondary / secondary special,Married,House / apartment,-14667,-798,1,1,0,0,Managers,2.0,-47,0
6487,5009223,F,Y,N,0,225000.0,Working,Secondary / secondary special,Married,House / apartment,-14667,-798,1,1,0,0,Managers,2.0,-48,0
6488,5009223,F,Y,N,0,225000.0,Working,Secondary / secondary special,Married,House / apartment,-14667,-798,1,1,0,0,Managers,2.0,-49,0
6489,5009223,F,Y,N,0,225000.0,Working,Secondary / secondary special,Married,House / apartment,-14667,-798,1,1,0,0,Managers,2.0,-50,0
6490,5009224,F,Y,N,0,225000.0,Working,Secondary / secondary special,Married,House / apartment,-14667,-798,1,1,0,0,Managers,2.0,0,C
6491,5009224,F,Y,N,0,225000.0,Working,Secondary / secondary special,Married,House / apartment,-14667,-798,1,1,0,0,Managers,2.0,-1,C
6492,5009224,F,Y,N,0,225000.0,Working,Secondary / secondary special,Married,House / apartment,-14667,-798,1,1,0,0,Managers,2.0,-2,C
6493,5009224,F,Y,N,0,225000.0,Working,Secondary / secondary special,Married,House / apartment,-14667,-798,1,1,0,0,Managers,2.0,-3,C
6494,5009224,F,Y,N,0,225000.0,Working,Secondary / secondary special,Married,House / apartment,-14667,-798,1,1,0,0,Managers,2.0,-4,C
6495,5009224,F,Y,N,0,225000.0,Working,Secondary / secondary special,Married,House / apartment,-14667,-798,1,1,0,0,Managers,2.0,-5,C
6496,5009224,F,Y,N,0,225000.0,Working,Secondary / secondary special,Married,House / apartment,-14667,-798,1,1,0,0,Managers,2.0,-6,C
6497,5009224,F,Y,N,0,225000.0,Working,Secondary / secondary special,Married,House / apartment,-14667,-798,1,1,0,0,Managers,2.0,-7,C
6498,5009224,F,Y,N,0,225000.0,Working,Secondary / secondary special,Married,House / apartment,-14667,-798,1,1,0,0,Managers,2.0,-8,C
6499,5009224,F,Y,N,0,225000.0,Working,Secondary / secondary special,Married,House / apartment,-14667,-798,1,1,0,0,Managers,2.0,-9,C
6500,5009224,F,Y,N,0,225000.0,Working,Secondary / secondary special,Married,House / apartment,-14667,-798,1,1,0,0,Managers,2.0,-10,C
6501,5009224,F,Y,N,0,225000.0,Working,Secondary / secondary special,Married,House / apartment,-14667,-798,1,1,0,0,Managers,2.0,-11,C
6502,5009224,F,Y,N,0,225000.0,Working,Secondary / secondary special,Married,House / apartment,-14667,-798,1,1,0,0,Managers,2.0,-12,C
6503,5009224,F,Y,N,0,225000.0,Working,Secondary / secondary special,Married,House / apartment,-14667,-798,1,1,0,0,Managers,2.0,-13,C
6504,5009224,F,Y,N,0,225000.0,Working,Secondary / secondary special,Married,House / apartment,-14667,-798,1,1,0,0,Managers,2.0,-14,C
6505,5009224,F,Y,N,0,225000.0,Working,Secondary / secondary special,Married,House / apartment,-14667,-798,1,1,0,0,Managers,2.0,-15,C
6506,5009224,F,Y,N,0,225000.0,Working,Secondary / secondary special,Married,House / apartment,-14667,-798,1,1,0,0,Managers,2.0,-16,C
6507,5009224,F,Y,N,0,225000.0,Working,Secondary / secondary special,Married,House / apartment,-14667,-798,1,1,0,0,Managers,2.0,-17,C
6508,5009224,F,Y,N,0,225000.0,Working,Secondary / secondary special,Married,House / apartment,-14667,-798,1,1,0,0,Managers,2.0,-18,C
6509,5009224,F,Y,N,0,225000.0,Working,Secondary / secondary special,Married,House / apartment,-14667,-798,1,1,0,0,Managers,2.0,-19,C
6510,5009224,F,Y,N,0,225000.0,Working,Secondary / secondary special,Married,House / apartment,-14667,-798,1,1,0,0,Managers,2.0,-20,C
6511,5009224,F,Y,N,0,225000.0,Working,Secondary / secondary special,Married,House / apartment,-14667,-798,1,1,0,0,Managers,2.0,-21,C
6512,5009224,F,Y,N,0,225000.0,Working,Secondary / secondary special,Married,House / apartment,-14667,-798,1,1,0,0,Managers,2.0,-22,C
6513,5009224,F,Y,N,0,225000.0,Working,Secondary / secondary special,Married,House / apartment,-14667,-798,1,1,0,0,Managers,2.0,-23,C
6514,5009224,F,Y,N,0,225000.0,Working,Secondary / secondary special,Married,House / apartment,-14667,-798,1,1,0,0,Managers,2.0,-24,C
6515,5009224,F,Y,N,0,225000.0,Working,Secondary / secondary special,Married,House / apartment,-14667,-798,1,1,0,0,Managers,2.0,-25,C
6516,5009224,F,Y,N,0,225000.0,Working,Secondary / secondary special,Married,House / apartment,-14667,-798,1,1,0,0,Managers,2.0,-26,C
6517,5009224,F,Y,N,0,225000.0,Working,Secondary / secondary special,Married,House / apartment,-14667,-798,1,1,0,0,Managers,2.0,-27,C
6518,5009224,F,Y,N,0,225000.0,Working,Secondary / secondary special,Married,House / apartment,-14667,-798,1,1,0,0,Managers,2.0,-28,C
6519,5009224,F,Y,N,0,225000.0,Working,Secondary / secondary special,Married,House / apartment,-14667,-798,1,1,0,0,Managers,2.0,-29,C
6520,5009224,F,Y,N,0,225000.0,Working,Secondary / secondary special,Married,House / apartment,-14667,-798,1,1,0,0,Managers,2.0,-30,C
6521,5009224,F,Y,N,0,225000.0,Working,Secondary / secondary special,Married,House / apartment,-14667,-798,1,1,0,0,Managers,2.0,-31,C
6522,5009224,F,Y,N,0,225000.0,Working,Secondary / secondary special,Married,House / apartment,-14667,-798,1,1,0,0,Managers,2.0,-32,C
6523,5009224,F,Y,N,0,225000.0,Working,Secondary / secondary special,Married,House / apartment,-14667,-798,1,1,0,0,Managers,2.0,-33,C
6524,5009224,F,Y,N,0,225000.0,Working,Secondary / secondary special,Married,House / apartment,-14667,-798,1,1,0,0,Managers,2.0,-34,C
6525,5009224,F,Y,N,0,225000.0,Working,Secondary / secondary special,Married,House / apartment,-14667,-798,1,1,0,0,Managers,2.0,-35,C
6526,5009224,F,Y,N,0,225000.0,Working,Secondary / secondary special,Married,House / apartment,-14667,-798,1,1,0,0,Managers,2.0,-36,C
6527,5009224,F,Y,N,0,225000.0,Working,Secondary / secondary special,Married,House / apartment,-14667,-798,1,1,0,0,Managers,2.0,-37,C
6528,5009224,F,Y,N,0,225000.0,Working,Secondary / secondary special,Married,House / apartment,-14667,-798,1,1,0,0,Managers,2.0,-38,C
6529,5009224,F,Y,N,0,225000.0,Working,Secondary / secondary special,Married,House / apartment,-14667,-798,1,1,0,0,Managers,2.0,-39,C
6530,5009224,F,Y,N,0,225000.0,Working,Secondary / secondary special,Married,House / apartment,-14667,-798,1,1,0,0,Managers,2.0,-40,C
6531,5009224,F,Y,N,0,225000.0,Working,Secondary / secondary special,Married,House / apartment,-14667,-798,1,1,0,0,Managers,2.0,-41,C
6532,5009224,F,Y,N,0,225000.0,Working,Secondary / secondary special,Married,House / apartment,-14667,-798,1,1,0,0,Managers,2.0,-42,C
6533,5009224,F,Y,N,0,225000.0,Working,Secondary / secondary special,Married,House / apartment,-14667,-798,1,1,0,0,Managers,2.0,-43,C
6534,5009224,F,Y,N,0,225000.0,Working,Secondary / secondary special,Married,House / apartment,-14667,-798,1,1,0,0,Managers,2.0,-44,0
6535,5009224,F,Y,N,0,225000.0,Working,Secondary / secondary special,Married,House / apartment,-14667,-798,1,1,0,0,Managers,2.0,-45,0
6536,5009224,F,Y,N,0,225000.0,Working,Secondary / secondary special,Married,House / apartment,-14667,-798,1,1,0,0,Managers,2.0,-46,0
6537,5009224,F,Y,N,0,225000.0,Working,Secondary / secondary special,Married,House / apartment,-14667,-798,1,1,0,0,Managers,2.0,-47,0
6538,5009224,F,Y,N,0,225000.0,Working,Secondary / secondary special,Married,House / apartment,-14667,-798,1,1,0,0,Managers,2.0,-48,0
6539,5009224,F,Y,N,0,225000.0,Working,Secondary / secondary special,Married,House / apartment,-14667,-798,1,1,0,0,Managers,2.0,-49,X
6540,5009224,F,Y,N,0,225000.0,Working,Secondary / secondary special,Married,House / apartment,-14667,-798,1,1,0,0,Managers,2.0,-50,X
6541,5009225,F,Y,N,0,225000.0,Working,Secondary / secondary special,Married,House / apartment,-14667,-798,1,1,0,0,Managers,2.0,-12,X
6542,5009225,F,Y,N,0,225000.0,Working,Secondary / secondary special,Married,House / apartment,-14667,-798,1,1,0,0,Managers,2.0,-13,X
6543,5009225,F,Y,N,0,225000.0,Working,Secondary / secondary special,Married,House / apartment,-14667,-798,1,1,0,0,Managers,2.0,-14,X
6544,5009225,F,Y,N,0,225000.0,Working,Secondary / secondary special,Married,House / apartment,-14667,-798,1,1,0,0,Managers,2.0,-15,X
6545,5009225,F,Y,N,0,225000.0,Working,Secondary / secondary special,Married,House / apartment,-14667,-798,1,1,0,0,Managers,2.0,-16,X
6546,5009225,F,Y,N,0,225000.0,Working,Secondary / secondary special,Married,House / apartment,-14667,-798,1,1,0,0,Managers,2.0,-17,X
6547,5009225,F,Y,N,0,225000.0,Working,Secondary / secondary special,Married,House / apartment,-14667,-798,1,1,0,0,Managers,2.0,-18,X
6548,5009225,F,Y,N,0,225000.0,Working,Secondary / secondary special,Married,House / apartment,-14667,-798,1,1,0,0,Managers,2.0,-19,X
6549,5009225,F,Y,N,0,225000.0,Working,Secondary / secondary special,Married,House / apartment,-14667,-798,1,1,0,0,Managers,2.0,-20,X
6550,5009225,F,Y,N,0,225000.0,Working,Secondary / secondary special,Married,House / apartment,-14667,-798,1,1,0,0,Managers,2.0,-21,X
6551,5009225,F,Y,N,0,225000.0,Working,Secondary / secondary special,Married,House / apartment,-14667,-798,1,1,0,0,Managers,2.0,-22,X
6552,5009225,F,Y,N,0,225000.0,Working,Secondary / secondary special,Married,House / apartment,-14667,-798,1,1,0,0,Managers,2.0,-23,X
6553,5009225,F,Y,N,0,225000.0,Working,Secondary / secondary special,Married,House / apartment,-14667,-798,1,1,0,0,Managers,2.0,-24,X
6554,5009225,F,Y,N,0,225000.0,Working,Secondary / secondary special,Married,House / apartment,-14667,-798,1,1,0,0,Managers,2.0,-25,X
6555,5009225,F,Y,N,0,225000.0,Working,Secondary / secondary special,Married,House / apartment,-14667,-798,1,1,0,0,Managers,2.0,-26,X
6556,5009225,F,Y,N,0,225000.0,Working,Secondary / secondary special,Married,House / apartment,-14667,-798,1,1,0,0,Managers,2.0,-27,X
6557,5009225,F,Y,N,0,225000.0,Working,Secondary / secondary special,Married,House / apartment,-14667,-798,1,1,0,0,Managers,2.0,-28,X
6558,5009225,F,Y,N,0,225000.0,Working,Secondary / secondary special,Married,House / apartment,-14667,-798,1,1,0,0,Managers,2.0,-29,X
6559,5009225,F,Y,N,0,225000.0,Working,Secondary / secondary special,Married,House / apartment,-14667,-798,1,1,0,0,Managers,2.0,-30,X
6560,5009225,F,Y,N,0,225000.0,Working,Secondary / secondary special,Married,House / apartment,-14667,-798,1,1,0,0,Managers,2.0,-31,X
6561,5009225,F,Y,N,0,225000.0,Working,Secondary / secondary special,Married,House / apartment,-14667,-798,1,1,0,0,Managers,2.0,-32,X
6562,5009225,F,Y,N,0,225000.0,Working,Secondary / secondary special,Married,House / apartment,-14667,-798,1,1,0,0,Managers,2.0,-33,X
6563,5009225,F,Y,N,0,225000.0,Working,Secondary / secondary special,Married,House / apartment,-14667,-798,1,1,0,0,Managers,2.0,-34,X
6564,5009225,F,Y,N,0,225000.0,Working,Secondary / secondary special,Married,House / apartment,-14667,-798,1,1,0,0,Managers,2.0,-35,X
6565,5009225,F,Y,N,0,225000.0,Working,Secondary / secondary special,Married,House / apartment,-14667,-798,1,1,0,0,Managers,2.0,-36,X
6566,5009225,F,Y,N,0,225000.0,Working,Secondary / secondary special,Married,House / apartment,-14667,-798,1,1,0,0,Managers,2.0,-37,X
6567,5009225,F,Y,N,0,225000.0,Working,Secondary / secondary special,Married,House / apartment,-14667,-798,1,1,0,0,Managers,2.0,-38,X
6568,5009225,F,Y,N,0,225000.0,Working,Secondary / secondary special,Married,House / apartment,-14667,-798,1,1,0,0,Managers,2.0,-39,X
6569,5009226,F,Y,N,0,225000.0,Working,Secondary / secondary special,Married,House / apartment,-14667,-798,1,1,0,0,Managers,2.0,0,C
6570,5009226,F,Y,N,0,225000.0,Working,Secondary / secondary special,Married,House / apartment,-14667,-798,1,1,0,0,Managers,2.0,-1,C
6571,5009226,F,Y,N,0,225000.0,Working,Secondary / secondary special,Married,House / apartment,-14667,-798,1,1,0,0,Managers,2.0,-2,C
6572,5009226,F,Y,N,0,225000.0,Working,Secondary / secondary special,Married,House / apartment,-14667,-798,1,1,0,0,Managers,2.0,-3,C
6573,5009226,F,Y,N,0,225000.0,Working,Secondary / secondary special,Married,House / apartment,-14667,-798,1,1,0,0,Managers,2.0,-4,0
6574,5009226,F,Y,N,0,225000.0,Working,Secondary / secondary special,Married,House / apartment,-14667,-798,1,1,0,0,Managers,2.0,-5,0
6575,5009226,F,Y,N,0,225000.0,Working,Secondary / secondary special,Married,House / apartment,-14667,-798,1,1,0,0,Managers,2.0,-6,0
6576,5009226,F,Y,N,0,225000.0,Working,Secondary / secondary special,Married,House / apartment,-14667,-798,1,1,0,0,Managers,2.0,-7,0
6577,5009226,F,Y,N,0,225000.0,Working,Secondary / secondary special,Married,House / apartment,-14667,-798,1,1,0,0,Managers,2.0,-8,0
6578,5009226,F,Y,N,0,225000.0,Working,Secondary / secondary special,Married,House / apartment,-14667,-798,1,1,0,0,Managers,2.0,-9,0
6579,5009226,F,Y,N,0,225000.0,Working,Secondary / secondary special,Married,House / apartment,-14667,-798,1,1,0,0,Managers,2.0,-10,0
6580,5009226,F,Y,N,0,225000.0,Working,Secondary / secondary special,Married,House / apartment,-14667,-798,1,1,0,0,Managers,2.0,-11,0
6581,5009226,F,Y,N,0,225000.0,Working,Secondary / secondary special,Married,House / apartment,-14667,-798,1,1,0,0,Managers,2.0,-12,0
6582,5009226,F,Y,N,0,225000.0,Working,Secondary / secondary special,Married,House / apartment,-14667,-798,1,1,0,0,Managers,2.0,-13,0
6583,5009226,F,Y,N,0,225000.0,Working,Secondary / secondary special,Married,House / apartment,-14667,-798,1,1,0,0,Managers,2.0,-14,0
6584,5009226,F,Y,N,0,225000.0,Working,Secondary / secondary special,Married,House / apartment,-14667,-798,1,1,0,0,Managers,2.0,-15,0
6585,5009226,F,Y,N,0,225000.0,Working,Secondary / secondary special,Married,House / apartment,-14667,-798,1,1,0,0,Managers,2.0,-16,0
6586,5009226,F,Y,N,0,225000.0,Working,Secondary / secondary special,Married,House / apartment,-14667,-798,1,1,0,0,Managers,2.0,-17,0
6587,5009226,F,Y,N,0,225000.0,Working,Secondary / secondary special,Married,House / apartment,-14667,-798,1,1,0,0,Managers,2.0,-18,0
6588,5009226,F,Y,N,0,225000.0,Working,Secondary / secondary special,Married,House / apartment,-14667,-798,1,1,0,0,Managers,2.0,-19,0
6589,5009226,F,Y,N,0,225000.0,Working,Secondary / secondary special,Married,House / apartment,-14667,-798,1,1,0,0,Managers,2.0,-20,0
6590,5009226,F,Y,N,0,225000.0,Working,Secondary / secondary special,Married,House / apartment,-14667,-798,1,1,0,0,Managers,2.0,-21,0
6591,5009226,F,Y,N,0,225000.0,Working,Secondary / secondary special,Married,House / apartment,-14667,-798,1,1,0,0,Managers,2.0,-22,0
6592,5009226,F,Y,N,0,225000.0,Working,Secondary / secondary special,Married,House / apartment,-14667,-798,1,1,0,0,Managers,2.0,-23,0
6593,5009226,F,Y,N,0,225000.0,Working,Secondary / secondary special,Married,House / apartment,-14667,-798,1,1,0,0,Managers,2.0,-24,0
6594,5009226,F,Y,N,0,225000.0,Working,Secondary / secondary special,Married,House / apartment,-14667,-798,1,1,0,0,Managers,2.0,-25,0
6595,5009226,F,Y,N,0,225000.0,Working,Secondary / secondary special,Married,House / apartment,-14667,-798,1,1,0,0,Managers,2.0,-26,0
6596,5009226,F,Y,N,0,225000.0,Working,Secondary / secondary special,Married,House / apartment,-14667,-798,1,1,0,0,Managers,2.0,-27,0
6597,5009226,F,Y,N,0,225000.0,Working,Secondary / secondary special,Married,House / apartment,-14667,-798,1,1,0,0,Managers,2.0,-28,0
6598,5009226,F,Y,N,0,225000.0,Working,Secondary / secondary special,Married,House / apartment,-14667,-798,1,1,0,0,Managers,2.0,-29,0
6599,5009226,F,Y,N,0,225000.0,Working,Secondary / secondary special,Married,House / apartment,-14667,-798,1,1,0,0,Managers,2.0,-30,0
6600,5009226,F,Y,N,0,225000.0,Working,Secondary / secondary special,Married,House / apartment,-14667,-798,1,1,0,0,Managers,2.0,-31,0
6601,5009226,F,Y,N,0,225000.0,Working,Secondary / secondary special,Married,House / apartment,-14667,-798,1,1,0,0,Managers,2.0,-32,0
6602,5009226,F,Y,N,0,225000.0,Working,Secondary / secondary special,Married,House / apartment,-14667,-798,1,1,0,0,Managers,2.0,-33,0
6603,5009226,F,Y,N,0,225000.0,Working,Secondary / secondary special,Married,House / apartment,-14667,-798,1,1,0,0,Managers,2.0,-34,0
6604,5009226,F,Y,N,0,225000.0,Working,Secondary / secondary special,Married,House / apartment,-14667,-798,1,1,0,0,Managers,2.0,-35,0
6605,5009226,F,Y,N,0,225000.0,Working,Secondary / secondary special,Married,House / apartment,-14667,-798,1,1,0,0,Managers,2.0,-36,0
6606,5009226,F,Y,N,0,225000.0,Working,Secondary / secondary special,Married,House / apartment,-14667,-798,1,1,0,0,Managers,2.0,-37,0
6607,5009226,F,Y,N,0,225000.0,Working,Secondary / secondary special,Married,House / apartment,-14667,-798,1,1,0,0,Managers,2.0,-38,0
6608,5009226,F,Y,N,0,225000.0,Working,Secondary / secondary special,Married,House / apartment,-14667,-798,1,1,0,0,Managers,2.0,-39,0
6609,5009226,F,Y,N,0,225000.0,Working,Secondary / secondary special,Married,House / apartment,-14667,-798,1,1,0,0,Managers,2.0,-40,0
6610,5009226,F,Y,N,0,225000.0,Working,Secondary / secondary special,Married,House / apartment,-14667,-798,1,1,0,0,Managers,2.0,-41,0
6611,5009226,F,Y,N,0,225000.0,Working,Secondary / secondary special,Married,House / apartment,-14667,-798,1,1,0,0,Managers,2.0,-42,0
6612,5009226,F,Y,N,0,225000.0,Working,Secondary / secondary special,Married,House / apartment,-14667,-798,1,1,0,0,Managers,2.0,-43,0
6613,5009226,F,Y,N,0,225000.0,Working,Secondary / secondary special,Married,House / apartment,-14667,-798,1,1,0,0,Managers,2.0,-44,0
6614,5009226,F,Y,N,0,225000.0,Working,Secondary / secondary special,Married,House / apartment,-14667,-798,1,1,0,0,Managers,2.0,-45,0
6615,5009226,F,Y,N,0,225000.0,Working,Secondary / secondary special,Married,House / apartment,-14667,-798,1,1,0,0,Managers,2.0,-46,0
6616,5009226,F,Y,N,0,225000.0,Working,Secondary / secondary special,Married,House / apartment,-14667,-798,1,1,0,0,Managers,2.0,-47,0
6617,5009227,F,Y,N,0,225000.0,Working,Secondary / secondary special,Married,House / apartment,-14667,-798,1,1,0,0,Managers,2.0,0,0
6618,5009227,F,Y,N,0,225000.0,Working,Secondary / secondary special,Married,House / apartment,-14667,-798,1,1,0,0,Managers,2.0,-1,0
6619,5009227,F,Y,N,0,225000.0,Working,Secondary / secondary special,Married,House / apartment,-14667,-798,1,1,0,0,Managers,2.0,-2,0
6620,5009227,F,Y,N,0,225000.0,Working,Secondary / secondary special,Married,House / apartment,-14667,-798,1,1,0,0,Managers,2.0,-3,0
6621,5009227,F,Y,N,0,225000.0,Working,Secondary / secondary special,Married,House / apartment,-14667,-798,1,1,0,0,Managers,2.0,-4,0
6622,5009227,F,Y,N,0,225000.0,Working,Secondary / secondary special,Married,House / apartment,-14667,-798,1,1,0,0,Managers,2.0,-5,0
6623,5009227,F,Y,N,0,225000.0,Working,Secondary / secondary special,Married,House / apartment,-14667,-798,1,1,0,0,Managers,2.0,-6,0
6624,5009227,F,Y,N,0,225000.0,Working,Secondary / secondary special,Married,House / apartment,-14667,-798,1,1,0,0,Managers,2.0,-7,0
6625,5009227,F,Y,N,0,225000.0,Working,Secondary / secondary special,Married,House / apartment,-14667,-798,1,1,0,0,Managers,2.0,-8,0
6626,5009227,F,Y,N,0,225000.0,Working,Secondary / secondary special,Married,House / apartment,-14667,-798,1,1,0,0,Managers,2.0,-9,0
6627,5009227,F,Y,N,0,225000.0,Working,Secondary / secondary special,Married,House / apartment,-14667,-798,1,1,0,0,Managers,2.0,-10,0
6628,5009227,F,Y,N,0,225000.0,Working,Secondary / secondary special,Married,House / apartment,-14667,-798,1,1,0,0,Managers,2.0,-11,0
6629,5009227,F,Y,N,0,225000.0,Working,Secondary / secondary special,Married,House / apartment,-14667,-798,1,1,0,0,Managers,2.0,-12,0
6630,5009227,F,Y,N,0,225000.0,Working,Secondary / secondary special,Married,House / apartment,-14667,-798,1,1,0,0,Managers,2.0,-13,0
6631,5009227,F,Y,N,0,225000.0,Working,Secondary / secondary special,Married,House / apartment,-14667,-798,1,1,0,0,Managers,2.0,-14,0
6632,5009227,F,Y,N,0,225000.0,Working,Secondary / secondary special,Married,House / apartment,-14667,-798,1,1,0,0,Managers,2.0,-15,0
6633,5009227,F,Y,N,0,225000.0,Working,Secondary / secondary special,Married,House / apartment,-14667,-798,1,1,0,0,Managers,2.0,-16,0
6634,5009227,F,Y,N,0,225000.0,Working,Secondary / secondary special,Married,House / apartment,-14667,-798,1,1,0,0,Managers,2.0,-17,0
6635,5009227,F,Y,N,0,225000.0,Working,Secondary / secondary special,Married,House / apartment,-14667,-798,1,1,0,0,Managers,2.0,-18,0
6636,5009227,F,Y,N,0,225000.0,Working,Secondary / secondary special,Married,House / apartment,-14667,-798,1,1,0,0,Managers,2.0,-19,0
6637,5009227,F,Y,N,0,225000.0,Working,Secondary / secondary special,Married,House / apartment,-14667,-798,1,1,0,0,Managers,2.0,-20,0
6638,5009232,F,Y,N,0,225000.0,Working,Secondary / secondary special,Married,House / apartment,-14667,-798,1,1,0,0,Managers,2.0,0,C
6639,5009232,F,Y,N,0,225000.0,Working,Secondary / secondary special,Married,House / apartment,-14667,-798,1,1,0,0,Managers,2.0,-1,C
6640,5009232,F,Y,N,0,225000.0,Working,Secondary / secondary special,Married,House / apartment,-14667,-798,1,1,0,0,Managers,2.0,-2,C
6641,5009232,F,Y,N,0,225000.0,Working,Secondary / secondary special,Married,House / apartment,-14667,-798,1,1,0,0,Managers,2.0,-3,C
6642,5009232,F,Y,N,0,225000.0,Working,Secondary / secondary special,Married,House / apartment,-14667,-798,1,1,0,0,Managers,2.0,-4,C
6643,5009232,F,Y,N,0,225000.0,Working,Secondary / secondary special,Married,House / apartment,-14667,-798,1,1,0,0,Managers,2.0,-5,C
6644,5009232,F,Y,N,0,225000.0,Working,Secondary / secondary special,Married,House / apartment,-14667,-798,1,1,0,0,Managers,2.0,-6,C
6645,5009232,F,Y,N,0,225000.0,Working,Secondary / secondary special,Married,House / apartment,-14667,-798,1,1,0,0,Managers,2.0,-7,C
6646,5009232,F,Y,N,0,225000.0,Working,Secondary / secondary special,Married,House / apartment,-14667,-798,1,1,0,0,Managers,2.0,-8,C
6647,5009232,F,Y,N,0,225000.0,Working,Secondary / secondary special,Married,House / apartment,-14667,-798,1,1,0,0,Managers,2.0,-9,C
6648,5009232,F,Y,N,0,225000.0,Working,Secondary / secondary special,Married,House / apartment,-14667,-798,1,1,0,0,Managers,2.0,-10,C
6649,5009232,F,Y,N,0,225000.0,Working,Secondary / secondary special,Married,House / apartment,-14667,-798,1,1,0,0,Managers,2.0,-11,C
6650,5009232,F,Y,N,0,225000.0,Working,Secondary / secondary special,Married,House / apartment,-14667,-798,1,1,0,0,Managers,2.0,-12,C
6651,5009232,F,Y,N,0,225000.0,Working,Secondary / secondary special,Married,House / apartment,-14667,-798,1,1,0,0,Managers,2.0,-13,C
6652,5009232,F,Y,N,0,225000.0,Working,Secondary / secondary special,Married,House / apartment,-14667,-798,1,1,0,0,Managers,2.0,-14,C
6653,5009232,F,Y,N,0,225000.0,Working,Secondary / secondary special,Married,House / apartment,-14667,-798,1,1,0,0,Managers,2.0,-15,C
6654,5009232,F,Y,N,0,225000.0,Working,Secondary / secondary special,Married,House / apartment,-14667,-798,1,1,0,0,Managers,2.0,-16,C
6655,5009232,F,Y,N,0,225000.0,Working,Secondary / secondary special,Married,House / apartment,-14667,-798,1,1,0,0,Managers,2.0,-17,C
6656,5009232,F,Y,N,0,225000.0,Working,Secondary / secondary special,Married,House / apartment,-14667,-798,1,1,0,0,Managers,2.0,-18,C
6657,5009232,F,Y,N,0,225000.0,Working,Secondary / secondary special,Married,House / apartment,-14667,-798,1,1,0,0,Managers,2.0,-19,C
6658,5009232,F,Y,N,0,225000.0,Working,Secondary / secondary special,Married,House / apartment,-14667,-798,1,1,0,0,Managers,2.0,-20,C
6659,5009232,F,Y,N,0,225000.0,Working,Secondary / secondary special,Married,House / apartment,-14667,-798,1,1,0,0,Managers,2.0,-21,C
6660,5009232,F,Y,N,0,225000.0,Working,Secondary / secondary special,Married,House / apartment,-14667,-798,1,1,0,0,Managers,2.0,-22,C
6661,5009232,F,Y,N,0,225000.0,Working,Secondary / secondary special,Married,House / apartment,-14667,-798,1,1,0,0,Managers,2.0,-23,C
6662,5009232,F,Y,N,0,225000.0,Working,Secondary / secondary special,Married,House / apartment,-14667,-798,1,1,0,0,Managers,2.0,-24,C
6663,5009232,F,Y,N,0,225000.0,Working,Secondary / secondary special,Married,House / apartment,-14667,-798,1,1,0,0,Managers,2.0,-25,C
6664,5009232,F,Y,N,0,225000.0,Working,Secondary / secondary special,Married,House / apartment,-14667,-798,1,1,0,0,Managers,2.0,-26,C
6665,5009232,F,Y,N,0,225000.0,Working,Secondary / secondary special,Married,House / apartment,-14667,-798,1,1,0,0,Managers,2.0,-27,C
6666,5009232,F,Y,N,0,225000.0,Working,Secondary / secondary special,Married,House / apartment,-14667,-798,1,1,0,0,Managers,2.0,-28,C
6667,5009232,F,Y,N,0,225000.0,Working,Secondary / secondary special,Married,House / apartment,-14667,-798,1,1,0,0,Managers,2.0,-29,C
6668,5009232,F,Y,N,0,225000.0,Working,Secondary / secondary special,Married,House / apartment,-14667,-798,1,1,0,0,Managers,2.0,-30,C
6669,5009232,F,Y,N,0,225000.0,Working,Secondary / secondary special,Married,House / apartment,-14667,-798,1,1,0,0,Managers,2.0,-31,C
6670,5009232,F,Y,N,0,225000.0,Working,Secondary / secondary special,Married,House / apartment,-14667,-798,1,1,0,0,Managers,2.0,-32,C
6671,5009232,F,Y,N,0,225000.0,Working,Secondary / secondary special,Married,House / apartment,-14667,-798,1,1,0,0,Managers,2.0,-33,C
6672,5009232,F,Y,N,0,225000.0,Working,Secondary / secondary special,Married,House / apartment,-14667,-798,1,1,0,0,Managers,2.0,-34,C
6673,5009232,F,Y,N,0,225000.0,Working,Secondary / secondary special,Married,House / apartment,-14667,-798,1,1,0,0,Managers,2.0,-35,0
6674,5009233,F,Y,N,0,225000.0,Working,Secondary / secondary special,Married,House / apartment,-14667,-798,1,1,0,0,Managers,2.0,-3,C
6675,5009233,F,Y,N,0,225000.0,Working,Secondary / secondary special,Married,House / apartment,-14667,-798,1,1,0,0,Managers,2.0,-4,C
6676,5009233,F,Y,N,0,225000.0,Working,Secondary / secondary special,Married,House / apartment,-14667,-798,1,1,0,0,Managers,2.0,-5,C
6677,5009233,F,Y,N,0,225000.0,Working,Secondary / secondary special,Married,House / apartment,-14667,-798,1,1,0,0,Managers,2.0,-6,C
6678,5009233,F,Y,N,0,225000.0,Working,Secondary / secondary special,Married,House / apartment,-14667,-798,1,1,0,0,Managers,2.0,-7,C
6679,5009233,F,Y,N,0,225000.0,Working,Secondary / secondary special,Married,House / apartment,-14667,-798,1,1,0,0,Managers,2.0,-8,C
6680,5009233,F,Y,N,0,225000.0,Working,Secondary / secondary special,Married,House / apartment,-14667,-798,1,1,0,0,Managers,2.0,-9,C
6681,5009233,F,Y,N,0,225000.0,Working,Secondary / secondary special,Married,House / apartment,-14667,-798,1,1,0,0,Managers,2.0,-10,C
6682,5009233,F,Y,N,0,225000.0,Working,Secondary / secondary special,Married,House / apartment,-14667,-798,1,1,0,0,Managers,2.0,-11,0
6683,5009233,F,Y,N,0,225000.0,Working,Secondary / secondary special,Married,House / apartment,-14667,-798,1,1,0,0,Managers,2.0,-12,0
6684,5009233,F,Y,N,0,225000.0,Working,Secondary / secondary special,Married,House / apartment,-14667,-798,1,1,0,0,Managers,2.0,-13,X
6685,5009233,F,Y,N,0,225000.0,Working,Secondary / secondary special,Married,House / apartment,-14667,-798,1,1,0,0,Managers,2.0,-14,X
6686,5009233,F,Y,N,0,225000.0,Working,Secondary / secondary special,Married,House / apartment,-14667,-798,1,1,0,0,Managers,2.0,-15,X
6687,5009233,F,Y,N,0,225000.0,Working,Secondary / secondary special,Married,House / apartment,-14667,-798,1,1,0,0,Managers,2.0,-16,0
6688,5009233,F,Y,N,0,225000.0,Working,Secondary / secondary special,Married,House / apartment,-14667,-798,1,1,0,0,Managers,2.0,-17,0
6689,5009233,F,Y,N,0,225000.0,Working,Secondary / secondary special,Married,House / apartment,-14667,-798,1,1,0,0,Managers,2.0,-18,0
6690,5009233,F,Y,N,0,225000.0,Working,Secondary / secondary special,Married,House / apartment,-14667,-798,1,1,0,0,Managers,2.0,-19,0
6691,5009233,F,Y,N,0,225000.0,Working,Secondary / secondary special,Married,House / apartment,-14667,-798,1,1,0,0,Managers,2.0,-20,0
6692,5009233,F,Y,N,0,225000.0,Working,Secondary / secondary special,Married,House / apartment,-14667,-798,1,1,0,0,Managers,2.0,-21,0
6693,5009233,F,Y,N,0,225000.0,Working,Secondary / secondary special,Married,House / apartment,-14667,-798,1,1,0,0,Managers,2.0,-22,0
6694,5009233,F,Y,N,0,225000.0,Working,Secondary / secondary special,Married,House / apartment,-14667,-798,1,1,0,0,Managers,2.0,-23,0
6695,5009233,F,Y,N,0,225000.0,Working,Secondary / secondary special,Married,House / apartment,-14667,-798,1,1,0,0,Managers,2.0,-24,0
6696,5009233,F,Y,N,0,225000.0,Working,Secondary / secondary special,Married,House / apartment,-14667,-798,1,1,0,0,Managers,2.0,-25,0
6697,5009233,F,Y,N,0,225000.0,Working,Secondary / secondary special,Married,House / apartment,-14667,-798,1,1,0,0,Managers,2.0,-26,0
6698,5009233,F,Y,N,0,225000.0,Working,Secondary / secondary special,Married,House / apartment,-14667,-798,1,1,0,0,Managers,2.0,-27,0
6699,5009233,F,Y,N,0,225000.0,Working,Secondary / secondary special,Married,House / apartment,-14667,-798,1,1,0,0,Managers,2.0,-28,0
6700,5009233,F,Y,N,0,225000.0,Working,Secondary / secondary special,Married,House / apartment,-14667,-798,1,1,0,0,Managers,2.0,-29,0
6701,5009233,F,Y,N,0,225000.0,Working,Secondary / secondary special,Married,House / apartment,-14667,-798,1,1,0,0,Managers,2.0,-30,0
6702,5009233,F,Y,N,0,225000.0,Working,Secondary / secondary special,Married,House / apartment,-14667,-798,1,1,0,0,Managers,2.0,-31,0
6703,5009233,F,Y,N,0,225000.0,Working,Secondary / secondary special,Married,House / apartment,-14667,-798,1,1,0,0,Managers,2.0,-32,0
6704,5009233,F,Y,N,0,225000.0,Working,Secondary / secondary special,Married,House / apartment,-14667,-798,1,1,0,0,Managers,2.0,-33,0
6705,5009233,F,Y,N,0,225000.0,Working,Secondary / secondary special,Married,House / apartment,-14667,-798,1,1,0,0,Managers,2.0,-34,0
6706,5009233,F,Y,N,0,225000.0,Working,Secondary / secondary special,Married,House / apartment,-14667,-798,1,1,0,0,Managers,2.0,-35,0
6707,5009233,F,Y,N,0,225000.0,Working,Secondary / secondary special,Married,House / apartment,-14667,-798,1,1,0,0,Managers,2.0,-36,0
6708,5009233,F,Y,N,0,225000.0,Working,Secondary / secondary special,Married,House / apartment,-14667,-798,1,1,0,0,Managers,2.0,-37,0
6709,5009233,F,Y,N,0,225000.0,Working,Secondary / secondary special,Married,House / apartment,-14667,-798,1,1,0,0,Managers,2.0,-38,0
6710,5009233,F,Y,N,0,225000.0,Working,Secondary / secondary special,Married,House / apartment,-14667,-798,1,1,0,0,Managers,2.0,-39,0
6711,5009233,F,Y,N,0,225000.0,Working,Secondary / secondary special,Married,House / apartment,-14667,-798,1,1,0,0,Managers,2.0,-40,0
6712,5009233,F,Y,N,0,225000.0,Working,Secondary / secondary special,Married,House / apartment,-14667,-798,1,1,0,0,Managers,2.0,-41,0
6713,5009233,F,Y,N,0,225000.0,Working,Secondary / secondary special,Married,House / apartment,-14667,-798,1,1,0,0,Managers,2.0,-42,0
6714,5009233,F,Y,N,0,225000.0,Working,Secondary / secondary special,Married,House / apartment,-14667,-798,1,1,0,0,Managers,2.0,-43,0
6715,5009233,F,Y,N,0,225000.0,Working,Secondary / secondary special,Married,House / apartment,-14667,-798,1,1,0,0,Managers,2.0,-44,0
6716,5009233,F,Y,N,0,225000.0,Working,Secondary / secondary special,Married,House / apartment,-14667,-798,1,1,0,0,Managers,2.0,-45,0
6717,5009233,F,Y,N,0,225000.0,Working,Secondary / secondary special,Married,House / apartment,-14667,-798,1,1,0,0,Managers,2.0,-46,0
6718,5009233,F,Y,N,0,225000.0,Working,Secondary / secondary special,Married,House / apartment,-14667,-798,1,1,0,0,Managers,2.0,-47,0
6719,5009233,F,Y,N,0,225000.0,Working,Secondary / secondary special,Married,House / apartment,-14667,-798,1,1,0,0,Managers,2.0,-48,0
6720,5009233,F,Y,N,0,225000.0,Working,Secondary / secondary special,Married,House / apartment,-14667,-798,1,1,0,0,Managers,2.0,-49,0
6721,5009233,F,Y,N,0,225000.0,Working,Secondary / secondary special,Married,House / apartment,-14667,-798,1,1,0,0,Managers,2.0,-50,0
6722,5009234,F,Y,N,0,225000.0,Working,Secondary / secondary special,Married,House / apartment,-14667,-798,1,1,0,0,Managers,2.0,0,X
6723,5009234,F,Y,N,0,225000.0,Working,Secondary / secondary special,Married,House / apartment,-14667,-798,1,1,0,0,Managers,2.0,-1,X
6724,5009234,F,Y,N,0,225000.0,Working,Secondary / secondary special,Married,House / apartment,-14667,-798,1,1,0,0,Managers,2.0,-2,X
6725,5009234,F,Y,N,0,225000.0,Working,Secondary / secondary special,Married,House / apartment,-14667,-798,1,1,0,0,Managers,2.0,-3,X
6726,5009234,F,Y,N,0,225000.0,Working,Secondary / secondary special,Married,House / apartment,-14667,-798,1,1,0,0,Managers,2.0,-4,X
6727,5009234,F,Y,N,0,225000.0,Working,Secondary / secondary special,Married,House / apartment,-14667,-798,1,1,0,0,Managers,2.0,-5,X
6728,5009234,F,Y,N,0,225000.0,Working,Secondary / secondary special,Married,House / apartment,-14667,-798,1,1,0,0,Managers,2.0,-6,X
6729,5009234,F,Y,N,0,225000.0,Working,Secondary / secondary special,Married,House / apartment,-14667,-798,1,1,0,0,Managers,2.0,-7,X
6730,5009234,F,Y,N,0,225000.0,Working,Secondary / secondary special,Married,House / apartment,-14667,-798,1,1,0,0,Managers,2.0,-8,X
6731,5009234,F,Y,N,0,225000.0,Working,Secondary / secondary special,Married,House / apartment,-14667,-798,1,1,0,0,Managers,2.0,-9,X
6732,5009234,F,Y,N,0,225000.0,Working,Secondary / secondary special,Married,House / apartment,-14667,-798,1,1,0,0,Managers,2.0,-10,X
6733,5009234,F,Y,N,0,225000.0,Working,Secondary / secondary special,Married,House / apartment,-14667,-798,1,1,0,0,Managers,2.0,-11,X
6734,5009234,F,Y,N,0,225000.0,Working,Secondary / secondary special,Married,House / apartment,-14667,-798,1,1,0,0,Managers,2.0,-12,X
6735,5009234,F,Y,N,0,225000.0,Working,Secondary / secondary special,Married,House / apartment,-14667,-798,1,1,0,0,Managers,2.0,-13,X
6736,5009236,F,Y,N,0,225000.0,Working,Secondary / secondary special,Married,House / apartment,-14667,-798,1,1,0,0,Managers,2.0,0,0
6737,5009236,F,Y,N,0,225000.0,Working,Secondary / secondary special,Married,House / apartment,-14667,-798,1,1,0,0,Managers,2.0,-1,0
6738,5009236,F,Y,N,0,225000.0,Working,Secondary / secondary special,Married,House / apartment,-14667,-798,1,1,0,0,Managers,2.0,-2,0
6739,5009236,F,Y,N,0,225000.0,Working,Secondary / secondary special,Married,House / apartment,-14667,-798,1,1,0,0,Managers,2.0,-3,0
6740,5009236,F,Y,N,0,225000.0,Working,Secondary / secondary special,Married,House / apartment,-14667,-798,1,1,0,0,Managers,2.0,-4,0
6741,5009236,F,Y,N,0,225000.0,Working,Secondary / secondary special,Married,House / apartment,-14667,-798,1,1,0,0,Managers,2.0,-5,0
6742,5009236,F,Y,N,0,225000.0,Working,Secondary / secondary special,Married,House / apartment,-14667,-798,1,1,0,0,Managers,2.0,-6,0
6743,5009236,F,Y,N,0,225000.0,Working,Secondary / secondary special,Married,House / apartment,-14667,-798,1,1,0,0,Managers,2.0,-7,0
6744,5009236,F,Y,N,0,225000.0,Working,Secondary / secondary special,Married,House / apartment,-14667,-798,1,1,0,0,Managers,2.0,-8,0
6745,5009236,F,Y,N,0,225000.0,Working,Secondary / secondary special,Married,House / apartment,-14667,-798,1,1,0,0,Managers,2.0,-9,0
6746,5009236,F,Y,N,0,225000.0,Working,Secondary / secondary special,Married,House / apartment,-14667,-798,1,1,0,0,Managers,2.0,-10,0
6747,5009236,F,Y,N,0,225000.0,Working,Secondary / secondary special,Married,House / apartment,-14667,-798,1,1,0,0,Managers,2.0,-11,0
6748,5009236,F,Y,N,0,225000.0,Working,Secondary / secondary special,Married,House / apartment,-14667,-798,1,1,0,0,Managers,2.0,-12,0
6749,5009236,F,Y,N,0,225000.0,Working,Secondary / secondary special,Married,House / apartment,-14667,-798,1,1,0,0,Managers,2.0,-13,0
6750,5009236,F,Y,N,0,225000.0,Working,Secondary / secondary special,Married,House / apartment,-14667,-798,1,1,0,0,Managers,2.0,-14,0
6751,5009236,F,Y,N,0,225000.0,Working,Secondary / secondary special,Married,House / apartment,-14667,-798,1,1,0,0,Managers,2.0,-15,0
6752,5009236,F,Y,N,0,225000.0,Working,Secondary / secondary special,Married,House / apartment,-14667,-798,1,1,0,0,Managers,2.0,-16,0
6753,5009236,F,Y,N,0,225000.0,Working,Secondary / secondary special,Married,House / apartment,-14667,-798,1,1,0,0,Managers,2.0,-17,0
6754,5009236,F,Y,N,0,225000.0,Working,Secondary / secondary special,Married,House / apartment,-14667,-798,1,1,0,0,Managers,2.0,-18,0
6755,5009236,F,Y,N,0,225000.0,Working,Secondary / secondary special,Married,House / apartment,-14667,-798,1,1,0,0,Managers,2.0,-19,0
6756,5009236,F,Y,N,0,225000.0,Working,Secondary / secondary special,Married,House / apartment,-14667,-798,1,1,0,0,Managers,2.0,-20,0
6757,5009236,F,Y,N,0,225000.0,Working,Secondary / secondary special,Married,House / apartment,-14667,-798,1,1,0,0,Managers,2.0,-21,0
6758,5009236,F,Y,N,0,225000.0,Working,Secondary / secondary special,Married,House / apartment,-14667,-798,1,1,0,0,Managers,2.0,-22,0
6759,5009236,F,Y,N,0,225000.0,Working,Secondary / secondary special,Married,House / apartment,-14667,-798,1,1,0,0,Managers,2.0,-23,0
6760,5009236,F,Y,N,0,225000.0,Working,Secondary / secondary special,Married,House / apartment,-14667,-798,1,1,0,0,Managers,2.0,-24,0
6761,5009236,F,Y,N,0,225000.0,Working,Secondary / secondary special,Married,House / apartment,-14667,-798,1,1,0,0,Managers,2.0,-25,0
6762,5009236,F,Y,N,0,225000.0,Working,Secondary / secondary special,Married,House / apartment,-14667,-798,1,1,0,0,Managers,2.0,-26,0
6763,5009236,F,Y,N,0,225000.0,Working,Secondary / secondary special,Married,House / apartment,-14667,-798,1,1,0,0,Managers,2.0,-27,0
6764,5009236,F,Y,N,0,225000.0,Working,Secondary / secondary special,Married,House / apartment,-14667,-798,1,1,0,0,Managers,2.0,-28,0
6765,5009236,F,Y,N,0,225000.0,Working,Secondary / secondary special,Married,House / apartment,-14667,-798,1,1,0,0,Managers,2.0,-29,0
6766,5009236,F,Y,N,0,225000.0,Working,Secondary / secondary special,Married,House / apartment,-14667,-798,1,1,0,0,Managers,2.0,-30,X
6767,5009238,M,Y,N,0,157500.0,Working,Incomplete higher,Married,With parents,-10611,-982,1,0,1,0,Drivers,2.0,-4,C
6768,5009238,M,Y,N,0,157500.0,Working,Incomplete higher,Married,With parents,-10611,-982,1,0,1,0,Drivers,2.0,-5,C
6769,5009238,M,Y,N,0,157500.0,Working,Incomplete higher,Married,With parents,-10611,-982,1,0,1,0,Drivers,2.0,-6,C
6770,5009238,M,Y,N,0,157500.0,Working,Incomplete higher,Married,With parents,-10611,-982,1,0,1,0,Drivers,2.0,-7,C
6771,5009238,M,Y,N,0,157500.0,Working,Incomplete higher,Married,With parents,-10611,-982,1,0,1,0,Drivers,2.0,-8,C
6772,5009238,M,Y,N,0,157500.0,Working,Incomplete higher,Married,With parents,-10611,-982,1,0,1,0,Drivers,2.0,-9,C
6773,5009238,M,Y,N,0,157500.0,Working,Incomplete higher,Married,With parents,-10611,-982,1,0,1,0,Drivers,2.0,-10,C
6774,5009238,M,Y,N,0,157500.0,Working,Incomplete higher,Married,With parents,-10611,-982,1,0,1,0,Drivers,2.0,-11,C
6775,5009238,M,Y,N,0,157500.0,Working,Incomplete higher,Married,With parents,-10611,-982,1,0,1,0,Drivers,2.0,-12,C
6776,5009238,M,Y,N,0,157500.0,Working,Incomplete higher,Married,With parents,-10611,-982,1,0,1,0,Drivers,2.0,-13,C
6777,5009238,M,Y,N,0,157500.0,Working,Incomplete higher,Married,With parents,-10611,-982,1,0,1,0,Drivers,2.0,-14,C
6778,5009238,M,Y,N,0,157500.0,Working,Incomplete higher,Married,With parents,-10611,-982,1,0,1,0,Drivers,2.0,-15,C
6779,5009238,M,Y,N,0,157500.0,Working,Incomplete higher,Married,With parents,-10611,-982,1,0,1,0,Drivers,2.0,-16,C
6780,5009238,M,Y,N,0,157500.0,Working,Incomplete higher,Married,With parents,-10611,-982,1,0,1,0,Drivers,2.0,-17,C
6781,5009238,M,Y,N,0,157500.0,Working,Incomplete higher,Married,With parents,-10611,-982,1,0,1,0,Drivers,2.0,-18,C
6782,5009238,M,Y,N,0,157500.0,Working,Incomplete higher,Married,With parents,-10611,-982,1,0,1,0,Drivers,2.0,-19,0
6783,5009238,M,Y,N,0,157500.0,Working,Incomplete higher,Married,With parents,-10611,-982,1,0,1,0,Drivers,2.0,-20,0
6784,5009238,M,Y,N,0,157500.0,Working,Incomplete higher,Married,With parents,-10611,-982,1,0,1,0,Drivers,2.0,-21,0
6785,5009238,M,Y,N,0,157500.0,Working,Incomplete higher,Married,With parents,-10611,-982,1,0,1,0,Drivers,2.0,-22,0
6786,5009238,M,Y,N,0,157500.0,Working,Incomplete higher,Married,With parents,-10611,-982,1,0,1,0,Drivers,2.0,-23,0
6787,5009238,M,Y,N,0,157500.0,Working,Incomplete higher,Married,With parents,-10611,-982,1,0,1,0,Drivers,2.0,-24,X
6788,5009239,M,Y,N,0,157500.0,Working,Incomplete higher,Married,With parents,-10611,-982,1,0,1,0,Drivers,2.0,0,C
6789,5009239,M,Y,N,0,157500.0,Working,Incomplete higher,Married,With parents,-10611,-982,1,0,1,0,Drivers,2.0,-1,C
6790,5009239,M,Y,N,0,157500.0,Working,Incomplete higher,Married,With parents,-10611,-982,1,0,1,0,Drivers,2.0,-2,C
6791,5009239,M,Y,N,0,157500.0,Working,Incomplete higher,Married,With parents,-10611,-982,1,0,1,0,Drivers,2.0,-3,C
6792,5009239,M,Y,N,0,157500.0,Working,Incomplete higher,Married,With parents,-10611,-982,1,0,1,0,Drivers,2.0,-4,C
6793,5009239,M,Y,N,0,157500.0,Working,Incomplete higher,Married,With parents,-10611,-982,1,0,1,0,Drivers,2.0,-5,C
6794,5009239,M,Y,N,0,157500.0,Working,Incomplete higher,Married,With parents,-10611,-982,1,0,1,0,Drivers,2.0,-6,C
6795,5009239,M,Y,N,0,157500.0,Working,Incomplete higher,Married,With parents,-10611,-982,1,0,1,0,Drivers,2.0,-7,C
6796,5009239,M,Y,N,0,157500.0,Working,Incomplete higher,Married,With parents,-10611,-982,1,0,1,0,Drivers,2.0,-8,C
6797,5009239,M,Y,N,0,157500.0,Working,Incomplete higher,Married,With parents,-10611,-982,1,0,1,0,Drivers,2.0,-9,0
6798,5009239,M,Y,N,0,157500.0,Working,Incomplete higher,Married,With parents,-10611,-982,1,0,1,0,Drivers,2.0,-10,0
6799,5009239,M,Y,N,0,157500.0,Working,Incomplete higher,Married,With parents,-10611,-982,1,0,1,0,Drivers,2.0,-11,0
6800,5009239,M,Y,N,0,157500.0,Working,Incomplete higher,Married,With parents,-10611,-982,1,0,1,0,Drivers,2.0,-12,0
6801,5009239,M,Y,N,0,157500.0,Working,Incomplete higher,Married,With parents,-10611,-982,1,0,1,0,Drivers,2.0,-13,0
6802,5009239,M,Y,N,0,157500.0,Working,Incomplete higher,Married,With parents,-10611,-982,1,0,1,0,Drivers,2.0,-14,X
6803,5009240,M,Y,N,0,157500.0,Working,Incomplete higher,Married,With parents,-10611,-982,1,0,1,0,Drivers,2.0,-9,C
6804,5009240,M,Y,N,0,157500.0,Working,Incomplete higher,Married,With parents,-10611,-982,1,0,1,0,Drivers,2.0,-10,C
6805,5009240,M,Y,N,0,157500.0,Working,Incomplete higher,Married,With parents,-10611,-982,1,0,1,0,Drivers,2.0,-11,C
6806,5009240,M,Y,N,0,157500.0,Working,Incomplete higher,Married,With parents,-10611,-982,1,0,1,0,Drivers,2.0,-12,C
6807,5009240,M,Y,N,0,157500.0,Working,Incomplete higher,Married,With parents,-10611,-982,1,0,1,0,Drivers,2.0,-13,C
6808,5009240,M,Y,N,0,157500.0,Working,Incomplete higher,Married,With parents,-10611,-982,1,0,1,0,Drivers,2.0,-14,C
6809,5009240,M,Y,N,0,157500.0,Working,Incomplete higher,Married,With parents,-10611,-982,1,0,1,0,Drivers,2.0,-15,C
6810,5009240,M,Y,N,0,157500.0,Working,Incomplete higher,Married,With parents,-10611,-982,1,0,1,0,Drivers,2.0,-16,C
6811,5009240,M,Y,N,0,157500.0,Working,Incomplete higher,Married,With parents,-10611,-982,1,0,1,0,Drivers,2.0,-17,C
6812,5009240,M,Y,N,0,157500.0,Working,Incomplete higher,Married,With parents,-10611,-982,1,0,1,0,Drivers,2.0,-18,C
6813,5009240,M,Y,N,0,157500.0,Working,Incomplete higher,Married,With parents,-10611,-982,1,0,1,0,Drivers,2.0,-19,C
6814,5009240,M,Y,N,0,157500.0,Working,Incomplete higher,Married,With parents,-10611,-982,1,0,1,0,Drivers,2.0,-20,C
6815,5009240,M,Y,N,0,157500.0,Working,Incomplete higher,Married,With parents,-10611,-982,1,0,1,0,Drivers,2.0,-21,C
6816,5009240,M,Y,N,0,157500.0,Working,Incomplete higher,Married,With parents,-10611,-982,1,0,1,0,Drivers,2.0,-22,C
6817,5009240,M,Y,N,0,157500.0,Working,Incomplete higher,Married,With parents,-10611,-982,1,0,1,0,Drivers,2.0,-23,C
6818,5009240,M,Y,N,0,157500.0,Working,Incomplete higher,Married,With parents,-10611,-982,1,0,1,0,Drivers,2.0,-24,C
6819,5009240,M,Y,N,0,157500.0,Working,Incomplete higher,Married,With parents,-10611,-982,1,0,1,0,Drivers,2.0,-25,C
6820,5009240,M,Y,N,0,157500.0,Working,Incomplete higher,Married,With parents,-10611,-982,1,0,1,0,Drivers,2.0,-26,C
6821,5009240,M,Y,N,0,157500.0,Working,Incomplete higher,Married,With parents,-10611,-982,1,0,1,0,Drivers,2.0,-27,C
6822,5009240,M,Y,N,0,157500.0,Working,Incomplete higher,Married,With parents,-10611,-982,1,0,1,0,Drivers,2.0,-28,C
6823,5009240,M,Y,N,0,157500.0,Working,Incomplete higher,Married,With parents,-10611,-982,1,0,1,0,Drivers,2.0,-29,C
6824,5009240,M,Y,N,0,157500.0,Working,Incomplete higher,Married,With parents,-10611,-982,1,0,1,0,Drivers,2.0,-30,C
6825,5009240,M,Y,N,0,157500.0,Working,Incomplete higher,Married,With parents,-10611,-982,1,0,1,0,Drivers,2.0,-31,C
6826,5009240,M,Y,N,0,157500.0,Working,Incomplete higher,Married,With parents,-10611,-982,1,0,1,0,Drivers,2.0,-32,C
6827,5009240,M,Y,N,0,157500.0,Working,Incomplete higher,Married,With parents,-10611,-982,1,0,1,0,Drivers,2.0,-33,C
6828,5009240,M,Y,N,0,157500.0,Working,Incomplete higher,Married,With parents,-10611,-982,1,0,1,0,Drivers,2.0,-34,C
6829,5009240,M,Y,N,0,157500.0,Working,Incomplete higher,Married,With parents,-10611,-982,1,0,1,0,Drivers,2.0,-35,C
6830,5009240,M,Y,N,0,157500.0,Working,Incomplete higher,Married,With parents,-10611,-982,1,0,1,0,Drivers,2.0,-36,C
6831,5009240,M,Y,N,0,157500.0,Working,Incomplete higher,Married,With parents,-10611,-982,1,0,1,0,Drivers,2.0,-37,C
6832,5009240,M,Y,N,0,157500.0,Working,Incomplete higher,Married,With parents,-10611,-982,1,0,1,0,Drivers,2.0,-38,C
6833,5009240,M,Y,N,0,157500.0,Working,Incomplete higher,Married,With parents,-10611,-982,1,0,1,0,Drivers,2.0,-39,C
6834,5009240,M,Y,N,0,157500.0,Working,Incomplete higher,Married,With parents,-10611,-982,1,0,1,0,Drivers,2.0,-40,0
6835,5009240,M,Y,N,0,157500.0,Working,Incomplete higher,Married,With parents,-10611,-982,1,0,1,0,Drivers,2.0,-41,0
6836,5009240,M,Y,N,0,157500.0,Working,Incomplete higher,Married,With parents,-10611,-982,1,0,1,0,Drivers,2.0,-42,0
6837,5009241,M,Y,N,0,157500.0,Working,Incomplete higher,Married,With parents,-10611,-982,1,0,1,0,Drivers,2.0,0,C
6838,5009241,M,Y,N,0,157500.0,Working,Incomplete higher,Married,With parents,-10611,-982,1,0,1,0,Drivers,2.0,-1,C
6839,5009241,M,Y,N,0,157500.0,Working,Incomplete higher,Married,With parents,-10611,-982,1,0,1,0,Drivers,2.0,-2,C
6840,5009241,M,Y,N,0,157500.0,Working,Incomplete higher,Married,With parents,-10611,-982,1,0,1,0,Drivers,2.0,-3,C
6841,5009241,M,Y,N,0,157500.0,Working,Incomplete higher,Married,With parents,-10611,-982,1,0,1,0,Drivers,2.0,-4,C
6842,5009241,M,Y,N,0,157500.0,Working,Incomplete higher,Married,With parents,-10611,-982,1,0,1,0,Drivers,2.0,-5,0
6843,5009241,M,Y,N,0,157500.0,Working,Incomplete higher,Married,With parents,-10611,-982,1,0,1,0,Drivers,2.0,-6,0
6844,5009241,M,Y,N,0,157500.0,Working,Incomplete higher,Married,With parents,-10611,-982,1,0,1,0,Drivers,2.0,-7,0
6845,5009241,M,Y,N,0,157500.0,Working,Incomplete higher,Married,With parents,-10611,-982,1,0,1,0,Drivers,2.0,-8,0
6846,5009241,M,Y,N,0,157500.0,Working,Incomplete higher,Married,With parents,-10611,-982,1,0,1,0,Drivers,2.0,-9,0
6847,5009241,M,Y,N,0,157500.0,Working,Incomplete higher,Married,With parents,-10611,-982,1,0,1,0,Drivers,2.0,-10,X
6848,5009242,F,N,N,0,74250.0,Working,Higher education,Separated,Municipal apartment,-19082,-5243,1,0,1,0,Core staff,1.0,0,C
6849,5009242,F,N,N,0,74250.0,Working,Higher education,Separated,Municipal apartment,-19082,-5243,1,0,1,0,Core staff,1.0,-1,C
6850,5009242,F,N,N,0,74250.0,Working,Higher education,Separated,Municipal apartment,-19082,-5243,1,0,1,0,Core staff,1.0,-2,C
6851,5009242,F,N,N,0,74250.0,Working,Higher education,Separated,Municipal apartment,-19082,-5243,1,0,1,0,Core staff,1.0,-3,C
6852,5009242,F,N,N,0,74250.0,Working,Higher education,Separated,Municipal apartment,-19082,-5243,1,0,1,0,Core staff,1.0,-4,C
6853,5009242,F,N,N,0,74250.0,Working,Higher education,Separated,Municipal apartment,-19082,-5243,1,0,1,0,Core staff,1.0,-5,C
6854,5009242,F,N,N,0,74250.0,Working,Higher education,Separated,Municipal apartment,-19082,-5243,1,0,1,0,Core staff,1.0,-6,C
6855,5009242,F,N,N,0,74250.0,Working,Higher education,Separated,Municipal apartment,-19082,-5243,1,0,1,0,Core staff,1.0,-7,C
6856,5009242,F,N,N,0,74250.0,Working,Higher education,Separated,Municipal apartment,-19082,-5243,1,0,1,0,Core staff,1.0,-8,C
6857,5009242,F,N,N,0,74250.0,Working,Higher education,Separated,Municipal apartment,-19082,-5243,1,0,1,0,Core staff,1.0,-9,C
6858,5009242,F,N,N,0,74250.0,Working,Higher education,Separated,Municipal apartment,-19082,-5243,1,0,1,0,Core staff,1.0,-10,C
6859,5009242,F,N,N,0,74250.0,Working,Higher education,Separated,Municipal apartment,-19082,-5243,1,0,1,0,Core staff,1.0,-11,C
6860,5009242,F,N,N,0,74250.0,Working,Higher education,Separated,Municipal apartment,-19082,-5243,1,0,1,0,Core staff,1.0,-12,C
6861,5009242,F,N,N,0,74250.0,Working,Higher education,Separated,Municipal apartment,-19082,-5243,1,0,1,0,Core staff,1.0,-13,C
6862,5009242,F,N,N,0,74250.0,Working,Higher education,Separated,Municipal apartment,-19082,-5243,1,0,1,0,Core staff,1.0,-14,C
6863,5009242,F,N,N,0,74250.0,Working,Higher education,Separated,Municipal apartment,-19082,-5243,1,0,1,0,Core staff,1.0,-15,C
6864,5009242,F,N,N,0,74250.0,Working,Higher education,Separated,Municipal apartment,-19082,-5243,1,0,1,0,Core staff,1.0,-16,C
6865,5009242,F,N,N,0,74250.0,Working,Higher education,Separated,Municipal apartment,-19082,-5243,1,0,1,0,Core staff,1.0,-17,C
6866,5009242,F,N,N,0,74250.0,Working,Higher education,Separated,Municipal apartment,-19082,-5243,1,0,1,0,Core staff,1.0,-18,C
6867,5009242,F,N,N,0,74250.0,Working,Higher education,Separated,Municipal apartment,-19082,-5243,1,0,1,0,Core staff,1.0,-19,C
6868,5009242,F,N,N,0,74250.0,Working,Higher education,Separated,Municipal apartment,-19082,-5243,1,0,1,0,Core staff,1.0,-20,C
6869,5009242,F,N,N,0,74250.0,Working,Higher education,Separated,Municipal apartment,-19082,-5243,1,0,1,0,Core staff,1.0,-21,C
6870,5009242,F,N,N,0,74250.0,Working,Higher education,Separated,Municipal apartment,-19082,-5243,1,0,1,0,Core staff,1.0,-22,C
6871,5009242,F,N,N,0,74250.0,Working,Higher education,Separated,Municipal apartment,-19082,-5243,1,0,1,0,Core staff,1.0,-23,C
6872,5009242,F,N,N,0,74250.0,Working,Higher education,Separated,Municipal apartment,-19082,-5243,1,0,1,0,Core staff,1.0,-24,C
6873,5009242,F,N,N,0,74250.0,Working,Higher education,Separated,Municipal apartment,-19082,-5243,1,0,1,0,Core staff,1.0,-25,C
6874,5009242,F,N,N,0,74250.0,Working,Higher education,Separated,Municipal apartment,-19082,-5243,1,0,1,0,Core staff,1.0,-26,C
6875,5009242,F,N,N,0,74250.0,Working,Higher education,Separated,Municipal apartment,-19082,-5243,1,0,1,0,Core staff,1.0,-27,C
6876,5009242,F,N,N,0,74250.0,Working,Higher education,Separated,Municipal apartment,-19082,-5243,1,0,1,0,Core staff,1.0,-28,0
6877,5009242,F,N,N,0,74250.0,Working,Higher education,Separated,Municipal apartment,-19082,-5243,1,0,1,0,Core staff,1.0,-29,0
6878,5009242,F,N,N,0,74250.0,Working,Higher education,Separated,Municipal apartment,-19082,-5243,1,0,1,0,Core staff,1.0,-30,0
6879,5009242,F,N,N,0,74250.0,Working,Higher education,Separated,Municipal apartment,-19082,-5243,1,0,1,0,Core staff,1.0,-31,0
6880,5009242,F,N,N,0,74250.0,Working,Higher education,Separated,Municipal apartment,-19082,-5243,1,0,1,0,Core staff,1.0,-32,0
6881,5009242,F,N,N,0,74250.0,Working,Higher education,Separated,Municipal apartment,-19082,-5243,1,0,1,0,Core staff,1.0,-33,0
6882,5009242,F,N,N,0,74250.0,Working,Higher education,Separated,Municipal apartment,-19082,-5243,1,0,1,0,Core staff,1.0,-34,X
6883,5009243,F,N,N,0,74250.0,Working,Higher education,Separated,Municipal apartment,-19082,-5243,1,0,1,0,Core staff,1.0,0,C
6884,5009243,F,N,N,0,74250.0,Working,Higher education,Separated,Municipal apartment,-19082,-5243,1,0,1,0,Core staff,1.0,-1,0
6885,5009243,F,N,N,0,74250.0,Working,Higher education,Separated,Municipal apartment,-19082,-5243,1,0,1,0,Core staff,1.0,-2,0
6886,5009243,F,N,N,0,74250.0,Working,Higher education,Separated,Municipal apartment,-19082,-5243,1,0,1,0,Core staff,1.0,-3,0
6887,5009243,F,N,N,0,74250.0,Working,Higher education,Separated,Municipal apartment,-19082,-5243,1,0,1,0,Core staff,1.0,-4,0
6888,5009243,F,N,N,0,74250.0,Working,Higher education,Separated,Municipal apartment,-19082,-5243,1,0,1,0,Core staff,1.0,-5,0
6889,5009243,F,N,N,0,74250.0,Working,Higher education,Separated,Municipal apartment,-19082,-5243,1,0,1,0,Core staff,1.0,-6,0
6890,5009243,F,N,N,0,74250.0,Working,Higher education,Separated,Municipal apartment,-19082,-5243,1,0,1,0,Core staff,1.0,-7,X
6891,5009244,F,N,N,0,74250.0,Working,Higher education,Separated,Municipal apartment,-19082,-5243,1,0,1,0,Core staff,1.0,0,C
6892,5009244,F,N,N,0,74250.0,Working,Higher education,Separated,Municipal apartment,-19082,-5243,1,0,1,0,Core staff,1.0,-1,C
6893,5009244,F,N,N,0,74250.0,Working,Higher education,Separated,Municipal apartment,-19082,-5243,1,0,1,0,Core staff,1.0,-2,C
6894,5009244,F,N,N,0,74250.0,Working,Higher education,Separated,Municipal apartment,-19082,-5243,1,0,1,0,Core staff,1.0,-3,C
6895,5009244,F,N,N,0,74250.0,Working,Higher education,Separated,Municipal apartment,-19082,-5243,1,0,1,0,Core staff,1.0,-4,C
6896,5009244,F,N,N,0,74250.0,Working,Higher education,Separated,Municipal apartment,-19082,-5243,1,0,1,0,Core staff,1.0,-5,C
6897,5009244,F,N,N,0,74250.0,Working,Higher education,Separated,Municipal apartment,-19082,-5243,1,0,1,0,Core staff,1.0,-6,C
6898,5009244,F,N,N,0,74250.0,Working,Higher education,Separated,Municipal apartment,-19082,-5243,1,0,1,0,Core staff,1.0,-7,X
6899,5009244,F,N,N,0,74250.0,Working,Higher education,Separated,Municipal apartment,-19082,-5243,1,0,1,0,Core staff,1.0,-8,X
6900,5009246,F,N,N,0,135000.0,Commercial associate,Secondary / secondary special,Married,House / apartment,-14201,-2139,1,0,1,0,,2.0,0,X
6901,5009246,F,N,N,0,135000.0,Commercial associate,Secondary / secondary special,Married,House / apartment,-14201,-2139,1,0,1,0,,2.0,-1,X
6902,5009246,F,N,N,0,135000.0,Commercial associate,Secondary / secondary special,Married,House / apartment,-14201,-2139,1,0,1,0,,2.0,-2,X
6903,5009246,F,N,N,0,135000.0,Commercial associate,Secondary / secondary special,Married,House / apartment,-14201,-2139,1,0,1,0,,2.0,-3,X
6904,5009246,F,N,N,0,135000.0,Commercial associate,Secondary / secondary special,Married,House / apartment,-14201,-2139,1,0,1,0,,2.0,-4,X
6905,5009246,F,N,N,0,135000.0,Commercial associate,Secondary / secondary special,Married,House / apartment,-14201,-2139,1,0,1,0,,2.0,-5,X
6906,5009246,F,N,N,0,135000.0,Commercial associate,Secondary / secondary special,Married,House / apartment,-14201,-2139,1,0,1,0,,2.0,-6,X
6907,5009246,F,N,N,0,135000.0,Commercial associate,Secondary / secondary special,Married,House / apartment,-14201,-2139,1,0,1,0,,2.0,-7,X
6908,5009246,F,N,N,0,135000.0,Commercial associate,Secondary / secondary special,Married,House / apartment,-14201,-2139,1,0,1,0,,2.0,-8,X
6909,5009246,F,N,N,0,135000.0,Commercial associate,Secondary / secondary special,Married,House / apartment,-14201,-2139,1,0,1,0,,2.0,-9,X
6910,5009246,F,N,N,0,135000.0,Commercial associate,Secondary / secondary special,Married,House / apartment,-14201,-2139,1,0,1,0,,2.0,-10,X
6911,5009246,F,N,N,0,135000.0,Commercial associate,Secondary / secondary special,Married,House / apartment,-14201,-2139,1,0,1,0,,2.0,-11,X
6912,5009246,F,N,N,0,135000.0,Commercial associate,Secondary / secondary special,Married,House / apartment,-14201,-2139,1,0,1,0,,2.0,-12,X
6913,5009246,F,N,N,0,135000.0,Commercial associate,Secondary / secondary special,Married,House / apartment,-14201,-2139,1,0,1,0,,2.0,-13,X
6914,5009246,F,N,N,0,135000.0,Commercial associate,Secondary / secondary special,Married,House / apartment,-14201,-2139,1,0,1,0,,2.0,-14,X
6915,5009246,F,N,N,0,135000.0,Commercial associate,Secondary / secondary special,Married,House / apartment,-14201,-2139,1,0,1,0,,2.0,-15,X
6916,5009246,F,N,N,0,135000.0,Commercial associate,Secondary / secondary special,Married,House / apartment,-14201,-2139,1,0,1,0,,2.0,-16,X
6917,5009246,F,N,N,0,135000.0,Commercial associate,Secondary / secondary special,Married,House / apartment,-14201,-2139,1,0,1,0,,2.0,-17,X
6918,5009246,F,N,N,0,135000.0,Commercial associate,Secondary / secondary special,Married,House / apartment,-14201,-2139,1,0,1,0,,2.0,-18,X
6919,5009246,F,N,N,0,135000.0,Commercial associate,Secondary / secondary special,Married,House / apartment,-14201,-2139,1,0,1,0,,2.0,-19,X
6920,5009246,F,N,N,0,135000.0,Commercial associate,Secondary / secondary special,Married,House / apartment,-14201,-2139,1,0,1,0,,2.0,-20,X
6921,5009246,F,N,N,0,135000.0,Commercial associate,Secondary / secondary special,Married,House / apartment,-14201,-2139,1,0,1,0,,2.0,-21,X
6922,5009246,F,N,N,0,135000.0,Commercial associate,Secondary / secondary special,Married,House / apartment,-14201,-2139,1,0,1,0,,2.0,-22,X
6923,5009246,F,N,N,0,135000.0,Commercial associate,Secondary / secondary special,Married,House / apartment,-14201,-2139,1,0,1,0,,2.0,-23,X
6924,5009246,F,N,N,0,135000.0,Commercial associate,Secondary / secondary special,Married,House / apartment,-14201,-2139,1,0,1,0,,2.0,-24,X
6925,5009246,F,N,N,0,135000.0,Commercial associate,Secondary / secondary special,Married,House / apartment,-14201,-2139,1,0,1,0,,2.0,-25,X
6926,5009246,F,N,N,0,135000.0,Commercial associate,Secondary / secondary special,Married,House / apartment,-14201,-2139,1,0,1,0,,2.0,-26,X
6927,5009246,F,N,N,0,135000.0,Commercial associate,Secondary / secondary special,Married,House / apartment,-14201,-2139,1,0,1,0,,2.0,-27,X
6928,5009246,F,N,N,0,135000.0,Commercial associate,Secondary / secondary special,Married,House / apartment,-14201,-2139,1,0,1,0,,2.0,-28,X
6929,5009246,F,N,N,0,135000.0,Commercial associate,Secondary / secondary special,Married,House / apartment,-14201,-2139,1,0,1,0,,2.0,-29,X
6930,5009246,F,N,N,0,135000.0,Commercial associate,Secondary / secondary special,Married,House / apartment,-14201,-2139,1,0,1,0,,2.0,-30,X
6931,5009246,F,N,N,0,135000.0,Commercial associate,Secondary / secondary special,Married,House / apartment,-14201,-2139,1,0,1,0,,2.0,-31,X
6932,5009247,F,N,N,0,135000.0,Commercial associate,Secondary / secondary special,Married,House / apartment,-14201,-2139,1,0,1,0,,2.0,-36,C
6933,5009247,F,N,N,0,135000.0,Commercial associate,Secondary / secondary special,Married,House / apartment,-14201,-2139,1,0,1,0,,2.0,-37,C
6934,5009247,F,N,N,0,135000.0,Commercial associate,Secondary / secondary special,Married,House / apartment,-14201,-2139,1,0,1,0,,2.0,-38,C
6935,5009247,F,N,N,0,135000.0,Commercial associate,Secondary / secondary special,Married,House / apartment,-14201,-2139,1,0,1,0,,2.0,-39,C
6936,5009247,F,N,N,0,135000.0,Commercial associate,Secondary / secondary special,Married,House / apartment,-14201,-2139,1,0,1,0,,2.0,-40,C
6937,5009247,F,N,N,0,135000.0,Commercial associate,Secondary / secondary special,Married,House / apartment,-14201,-2139,1,0,1,0,,2.0,-41,C
6938,5009247,F,N,N,0,135000.0,Commercial associate,Secondary / secondary special,Married,House / apartment,-14201,-2139,1,0,1,0,,2.0,-42,C
6939,5009247,F,N,N,0,135000.0,Commercial associate,Secondary / secondary special,Married,House / apartment,-14201,-2139,1,0,1,0,,2.0,-43,C
6940,5009247,F,N,N,0,135000.0,Commercial associate,Secondary / secondary special,Married,House / apartment,-14201,-2139,1,0,1,0,,2.0,-44,C
6941,5009247,F,N,N,0,135000.0,Commercial associate,Secondary / secondary special,Married,House / apartment,-14201,-2139,1,0,1,0,,2.0,-45,C
6942,5009247,F,N,N,0,135000.0,Commercial associate,Secondary / secondary special,Married,House / apartment,-14201,-2139,1,0,1,0,,2.0,-46,C
6943,5009247,F,N,N,0,135000.0,Commercial associate,Secondary / secondary special,Married,House / apartment,-14201,-2139,1,0,1,0,,2.0,-47,C
6944,5009247,F,N,N,0,135000.0,Commercial associate,Secondary / secondary special,Married,House / apartment,-14201,-2139,1,0,1,0,,2.0,-48,C
6945,5009247,F,N,N,0,135000.0,Commercial associate,Secondary / secondary special,Married,House / apartment,-14201,-2139,1,0,1,0,,2.0,-49,0
6946,5009247,F,N,N,0,135000.0,Commercial associate,Secondary / secondary special,Married,House / apartment,-14201,-2139,1,0,1,0,,2.0,-50,0
6947,5009247,F,N,N,0,135000.0,Commercial associate,Secondary / secondary special,Married,House / apartment,-14201,-2139,1,0,1,0,,2.0,-51,0
6948,5009247,F,N,N,0,135000.0,Commercial associate,Secondary / secondary special,Married,House / apartment,-14201,-2139,1,0,1,0,,2.0,-52,0
6949,5009247,F,N,N,0,135000.0,Commercial associate,Secondary / secondary special,Married,House / apartment,-14201,-2139,1,0,1,0,,2.0,-53,0
6950,5009247,F,N,N,0,135000.0,Commercial associate,Secondary / secondary special,Married,House / apartment,-14201,-2139,1,0,1,0,,2.0,-54,0
6951,5009248,F,N,N,0,135000.0,Commercial associate,Secondary / secondary special,Married,House / apartment,-14201,-2139,1,0,1,0,,2.0,0,C
6952,5009248,F,N,N,0,135000.0,Commercial associate,Secondary / secondary special,Married,House / apartment,-14201,-2139,1,0,1,0,,2.0,-1,C
6953,5009248,F,N,N,0,135000.0,Commercial associate,Secondary / secondary special,Married,House / apartment,-14201,-2139,1,0,1,0,,2.0,-2,C
6954,5009248,F,N,N,0,135000.0,Commercial associate,Secondary / secondary special,Married,House / apartment,-14201,-2139,1,0,1,0,,2.0,-3,C
6955,5009248,F,N,N,0,135000.0,Commercial associate,Secondary / secondary special,Married,House / apartment,-14201,-2139,1,0,1,0,,2.0,-4,C
6956,5009248,F,N,N,0,135000.0,Commercial associate,Secondary / secondary special,Married,House / apartment,-14201,-2139,1,0,1,0,,2.0,-5,C
6957,5009248,F,N,N,0,135000.0,Commercial associate,Secondary / secondary special,Married,House / apartment,-14201,-2139,1,0,1,0,,2.0,-6,C
6958,5009248,F,N,N,0,135000.0,Commercial associate,Secondary / secondary special,Married,House / apartment,-14201,-2139,1,0,1,0,,2.0,-7,C
6959,5009248,F,N,N,0,135000.0,Commercial associate,Secondary / secondary special,Married,House / apartment,-14201,-2139,1,0,1,0,,2.0,-8,0
6960,5009248,F,N,N,0,135000.0,Commercial associate,Secondary / secondary special,Married,House / apartment,-14201,-2139,1,0,1,0,,2.0,-9,0
6961,5009248,F,N,N,0,135000.0,Commercial associate,Secondary / secondary special,Married,House / apartment,-14201,-2139,1,0,1,0,,2.0,-10,0
6962,5009248,F,N,N,0,135000.0,Commercial associate,Secondary / secondary special,Married,House / apartment,-14201,-2139,1,0,1,0,,2.0,-11,0
6963,5009248,F,N,N,0,135000.0,Commercial associate,Secondary / secondary special,Married,House / apartment,-14201,-2139,1,0,1,0,,2.0,-12,0
6964,5009248,F,N,N,0,135000.0,Commercial associate,Secondary / secondary special,Married,House / apartment,-14201,-2139,1,0,1,0,,2.0,-13,0
6965,5009248,F,N,N,0,135000.0,Commercial associate,Secondary / secondary special,Married,House / apartment,-14201,-2139,1,0,1,0,,2.0,-14,0
6966,5009248,F,N,N,0,135000.0,Commercial associate,Secondary / secondary special,Married,House / apartment,-14201,-2139,1,0,1,0,,2.0,-15,X
6967,5009248,F,N,N,0,135000.0,Commercial associate,Secondary / secondary special,Married,House / apartment,-14201,-2139,1,0,1,0,,2.0,-16,0
6968,5009248,F,N,N,0,135000.0,Commercial associate,Secondary / secondary special,Married,House / apartment,-14201,-2139,1,0,1,0,,2.0,-17,0
6969,5009249,M,Y,N,1,135000.0,Working,Secondary / secondary special,Married,House / apartment,-9957,-921,1,1,0,0,Drivers,3.0,0,C
6970,5009249,M,Y,N,1,135000.0,Working,Secondary / secondary special,Married,House / apartment,-9957,-921,1,1,0,0,Drivers,3.0,-1,C
6971,5009249,M,Y,N,1,135000.0,Working,Secondary / secondary special,Married,House / apartment,-9957,-921,1,1,0,0,Drivers,3.0,-2,C
6972,5009249,M,Y,N,1,135000.0,Working,Secondary / secondary special,Married,House / apartment,-9957,-921,1,1,0,0,Drivers,3.0,-3,C
6973,5009249,M,Y,N,1,135000.0,Working,Secondary / secondary special,Married,House / apartment,-9957,-921,1,1,0,0,Drivers,3.0,-4,C
6974,5009249,M,Y,N,1,135000.0,Working,Secondary / secondary special,Married,House / apartment,-9957,-921,1,1,0,0,Drivers,3.0,-5,C
6975,5009249,M,Y,N,1,135000.0,Working,Secondary / secondary special,Married,House / apartment,-9957,-921,1,1,0,0,Drivers,3.0,-6,C
6976,5009249,M,Y,N,1,135000.0,Working,Secondary / secondary special,Married,House / apartment,-9957,-921,1,1,0,0,Drivers,3.0,-7,C
6977,5009249,M,Y,N,1,135000.0,Working,Secondary / secondary special,Married,House / apartment,-9957,-921,1,1,0,0,Drivers,3.0,-8,C
6978,5009249,M,Y,N,1,135000.0,Working,Secondary / secondary special,Married,House / apartment,-9957,-921,1,1,0,0,Drivers,3.0,-9,C
6979,5009249,M,Y,N,1,135000.0,Working,Secondary / secondary special,Married,House / apartment,-9957,-921,1,1,0,0,Drivers,3.0,-10,C
6980,5009249,M,Y,N,1,135000.0,Working,Secondary / secondary special,Married,House / apartment,-9957,-921,1,1,0,0,Drivers,3.0,-11,C
6981,5009249,M,Y,N,1,135000.0,Working,Secondary / secondary special,Married,House / apartment,-9957,-921,1,1,0,0,Drivers,3.0,-12,C
6982,5009249,M,Y,N,1,135000.0,Working,Secondary / secondary special,Married,House / apartment,-9957,-921,1,1,0,0,Drivers,3.0,-13,C
6983,5009249,M,Y,N,1,135000.0,Working,Secondary / secondary special,Married,House / apartment,-9957,-921,1,1,0,0,Drivers,3.0,-14,C
6984,5009249,M,Y,N,1,135000.0,Working,Secondary / secondary special,Married,House / apartment,-9957,-921,1,1,0,0,Drivers,3.0,-15,C
6985,5009249,M,Y,N,1,135000.0,Working,Secondary / secondary special,Married,House / apartment,-9957,-921,1,1,0,0,Drivers,3.0,-16,C
6986,5009249,M,Y,N,1,135000.0,Working,Secondary / secondary special,Married,House / apartment,-9957,-921,1,1,0,0,Drivers,3.0,-17,C
6987,5009249,M,Y,N,1,135000.0,Working,Secondary / secondary special,Married,House / apartment,-9957,-921,1,1,0,0,Drivers,3.0,-18,C
6988,5009249,M,Y,N,1,135000.0,Working,Secondary / secondary special,Married,House / apartment,-9957,-921,1,1,0,0,Drivers,3.0,-19,C
6989,5009249,M,Y,N,1,135000.0,Working,Secondary / secondary special,Married,House / apartment,-9957,-921,1,1,0,0,Drivers,3.0,-20,C
6990,5009249,M,Y,N,1,135000.0,Working,Secondary / secondary special,Married,House / apartment,-9957,-921,1,1,0,0,Drivers,3.0,-21,C
6991,5009249,M,Y,N,1,135000.0,Working,Secondary / secondary special,Married,House / apartment,-9957,-921,1,1,0,0,Drivers,3.0,-22,C
6992,5009249,M,Y,N,1,135000.0,Working,Secondary / secondary special,Married,House / apartment,-9957,-921,1,1,0,0,Drivers,3.0,-23,0
6993,5009249,M,Y,N,1,135000.0,Working,Secondary / secondary special,Married,House / apartment,-9957,-921,1,1,0,0,Drivers,3.0,-24,0
6994,5009249,M,Y,N,1,135000.0,Working,Secondary / secondary special,Married,House / apartment,-9957,-921,1,1,0,0,Drivers,3.0,-25,0
6995,5009249,M,Y,N,1,135000.0,Working,Secondary / secondary special,Married,House / apartment,-9957,-921,1,1,0,0,Drivers,3.0,-26,0
6996,5009250,M,Y,N,1,135000.0,Working,Secondary / secondary special,Married,House / apartment,-9957,-921,1,1,0,0,Drivers,3.0,0,C
6997,5009250,M,Y,N,1,135000.0,Working,Secondary / secondary special,Married,House / apartment,-9957,-921,1,1,0,0,Drivers,3.0,-1,C
6998,5009250,M,Y,N,1,135000.0,Working,Secondary / secondary special,Married,House / apartment,-9957,-921,1,1,0,0,Drivers,3.0,-2,C
6999,5009250,M,Y,N,1,135000.0,Working,Secondary / secondary special,Married,House / apartment,-9957,-921,1,1,0,0,Drivers,3.0,-3,C
7000,5009250,M,Y,N,1,135000.0,Working,Secondary / secondary special,Married,House / apartment,-9957,-921,1,1,0,0,Drivers,3.0,-4,C
7001,5009250,M,Y,N,1,135000.0,Working,Secondary / secondary special,Married,House / apartment,-9957,-921,1,1,0,0,Drivers,3.0,-5,C
7002,5009250,M,Y,N,1,135000.0,Working,Secondary / secondary special,Married,House / apartment,-9957,-921,1,1,0,0,Drivers,3.0,-6,0
7003,5009250,M,Y,N,1,135000.0,Working,Secondary / secondary special,Married,House / apartment,-9957,-921,1,1,0,0,Drivers,3.0,-7,0
7004,5009250,M,Y,N,1,135000.0,Working,Secondary / secondary special,Married,House / apartment,-9957,-921,1,1,0,0,Drivers,3.0,-8,0
7005,5009250,M,Y,N,1,135000.0,Working,Secondary / secondary special,Married,House / apartment,-9957,-921,1,1,0,0,Drivers,3.0,-9,0
7006,5009251,M,Y,N,1,135000.0,Working,Secondary / secondary special,Married,House / apartment,-9957,-921,1,1,0,0,Drivers,3.0,0,C
7007,5009251,M,Y,N,1,135000.0,Working,Secondary / secondary special,Married,House / apartment,-9957,-921,1,1,0,0,Drivers,3.0,-1,C
7008,5009251,M,Y,N,1,135000.0,Working,Secondary / secondary special,Married,House / apartment,-9957,-921,1,1,0,0,Drivers,3.0,-2,C
7009,5009251,M,Y,N,1,135000.0,Working,Secondary / secondary special,Married,House / apartment,-9957,-921,1,1,0,0,Drivers,3.0,-3,C
7010,5009251,M,Y,N,1,135000.0,Working,Secondary / secondary special,Married,House / apartment,-9957,-921,1,1,0,0,Drivers,3.0,-4,C
7011,5009251,M,Y,N,1,135000.0,Working,Secondary / secondary special,Married,House / apartment,-9957,-921,1,1,0,0,Drivers,3.0,-5,C
7012,5009251,M,Y,N,1,135000.0,Working,Secondary / secondary special,Married,House / apartment,-9957,-921,1,1,0,0,Drivers,3.0,-6,C
7013,5009251,M,Y,N,1,135000.0,Working,Secondary / secondary special,Married,House / apartment,-9957,-921,1,1,0,0,Drivers,3.0,-7,C
7014,5009251,M,Y,N,1,135000.0,Working,Secondary / secondary special,Married,House / apartment,-9957,-921,1,1,0,0,Drivers,3.0,-8,C
7015,5009251,M,Y,N,1,135000.0,Working,Secondary / secondary special,Married,House / apartment,-9957,-921,1,1,0,0,Drivers,3.0,-9,C
7016,5009251,M,Y,N,1,135000.0,Working,Secondary / secondary special,Married,House / apartment,-9957,-921,1,1,0,0,Drivers,3.0,-10,C
7017,5009251,M,Y,N,1,135000.0,Working,Secondary / secondary special,Married,House / apartment,-9957,-921,1,1,0,0,Drivers,3.0,-11,C
7018,5009251,M,Y,N,1,135000.0,Working,Secondary / secondary special,Married,House / apartment,-9957,-921,1,1,0,0,Drivers,3.0,-12,C
7019,5009251,M,Y,N,1,135000.0,Working,Secondary / secondary special,Married,House / apartment,-9957,-921,1,1,0,0,Drivers,3.0,-13,C
7020,5009251,M,Y,N,1,135000.0,Working,Secondary / secondary special,Married,House / apartment,-9957,-921,1,1,0,0,Drivers,3.0,-14,C
7021,5009251,M,Y,N,1,135000.0,Working,Secondary / secondary special,Married,House / apartment,-9957,-921,1,1,0,0,Drivers,3.0,-15,C
7022,5009251,M,Y,N,1,135000.0,Working,Secondary / secondary special,Married,House / apartment,-9957,-921,1,1,0,0,Drivers,3.0,-16,C
7023,5009251,M,Y,N,1,135000.0,Working,Secondary / secondary special,Married,House / apartment,-9957,-921,1,1,0,0,Drivers,3.0,-17,C
7024,5009251,M,Y,N,1,135000.0,Working,Secondary / secondary special,Married,House / apartment,-9957,-921,1,1,0,0,Drivers,3.0,-18,C
7025,5009251,M,Y,N,1,135000.0,Working,Secondary / secondary special,Married,House / apartment,-9957,-921,1,1,0,0,Drivers,3.0,-19,C
7026,5009251,M,Y,N,1,135000.0,Working,Secondary / secondary special,Married,House / apartment,-9957,-921,1,1,0,0,Drivers,3.0,-20,C
7027,5009251,M,Y,N,1,135000.0,Working,Secondary / secondary special,Married,House / apartment,-9957,-921,1,1,0,0,Drivers,3.0,-21,C
7028,5009251,M,Y,N,1,135000.0,Working,Secondary / secondary special,Married,House / apartment,-9957,-921,1,1,0,0,Drivers,3.0,-22,C
7029,5009251,M,Y,N,1,135000.0,Working,Secondary / secondary special,Married,House / apartment,-9957,-921,1,1,0,0,Drivers,3.0,-23,0
7030,5009251,M,Y,N,1,135000.0,Working,Secondary / secondary special,Married,House / apartment,-9957,-921,1,1,0,0,Drivers,3.0,-24,0
7031,5009251,M,Y,N,1,135000.0,Working,Secondary / secondary special,Married,House / apartment,-9957,-921,1,1,0,0,Drivers,3.0,-25,0
7032,5009251,M,Y,N,1,135000.0,Working,Secondary / secondary special,Married,House / apartment,-9957,-921,1,1,0,0,Drivers,3.0,-26,0
7033,5009252,M,Y,N,1,135000.0,Working,Secondary / secondary special,Married,House / apartment,-9957,-921,1,1,0,0,Drivers,3.0,0,C
7034,5009252,M,Y,N,1,135000.0,Working,Secondary / secondary special,Married,House / apartment,-9957,-921,1,1,0,0,Drivers,3.0,-1,C
7035,5009252,M,Y,N,1,135000.0,Working,Secondary / secondary special,Married,House / apartment,-9957,-921,1,1,0,0,Drivers,3.0,-2,C
7036,5009252,M,Y,N,1,135000.0,Working,Secondary / secondary special,Married,House / apartment,-9957,-921,1,1,0,0,Drivers,3.0,-3,C
7037,5009252,M,Y,N,1,135000.0,Working,Secondary / secondary special,Married,House / apartment,-9957,-921,1,1,0,0,Drivers,3.0,-4,C
7038,5009252,M,Y,N,1,135000.0,Working,Secondary / secondary special,Married,House / apartment,-9957,-921,1,1,0,0,Drivers,3.0,-5,C
7039,5009252,M,Y,N,1,135000.0,Working,Secondary / secondary special,Married,House / apartment,-9957,-921,1,1,0,0,Drivers,3.0,-6,C
7040,5009252,M,Y,N,1,135000.0,Working,Secondary / secondary special,Married,House / apartment,-9957,-921,1,1,0,0,Drivers,3.0,-7,C
7041,5009252,M,Y,N,1,135000.0,Working,Secondary / secondary special,Married,House / apartment,-9957,-921,1,1,0,0,Drivers,3.0,-8,0
7042,5009252,M,Y,N,1,135000.0,Working,Secondary / secondary special,Married,House / apartment,-9957,-921,1,1,0,0,Drivers,3.0,-9,0
7043,5009252,M,Y,N,1,135000.0,Working,Secondary / secondary special,Married,House / apartment,-9957,-921,1,1,0,0,Drivers,3.0,-10,0
7044,5009252,M,Y,N,1,135000.0,Working,Secondary / secondary special,Married,House / apartment,-9957,-921,1,1,0,0,Drivers,3.0,-11,0
7045,5009252,M,Y,N,1,135000.0,Working,Secondary / secondary special,Married,House / apartment,-9957,-921,1,1,0,0,Drivers,3.0,-12,0
7046,5009253,M,Y,N,1,135000.0,Working,Secondary / secondary special,Married,House / apartment,-9957,-921,1,1,0,0,Drivers,3.0,0,C
7047,5009253,M,Y,N,1,135000.0,Working,Secondary / secondary special,Married,House / apartment,-9957,-921,1,1,0,0,Drivers,3.0,-1,C
7048,5009253,M,Y,N,1,135000.0,Working,Secondary / secondary special,Married,House / apartment,-9957,-921,1,1,0,0,Drivers,3.0,-2,C
7049,5009253,M,Y,N,1,135000.0,Working,Secondary / secondary special,Married,House / apartment,-9957,-921,1,1,0,0,Drivers,3.0,-3,C
7050,5009253,M,Y,N,1,135000.0,Working,Secondary / secondary special,Married,House / apartment,-9957,-921,1,1,0,0,Drivers,3.0,-4,C
7051,5009253,M,Y,N,1,135000.0,Working,Secondary / secondary special,Married,House / apartment,-9957,-921,1,1,0,0,Drivers,3.0,-5,C
7052,5009253,M,Y,N,1,135000.0,Working,Secondary / secondary special,Married,House / apartment,-9957,-921,1,1,0,0,Drivers,3.0,-6,C
7053,5009253,M,Y,N,1,135000.0,Working,Secondary / secondary special,Married,House / apartment,-9957,-921,1,1,0,0,Drivers,3.0,-7,C
7054,5009253,M,Y,N,1,135000.0,Working,Secondary / secondary special,Married,House / apartment,-9957,-921,1,1,0,0,Drivers,3.0,-8,C
7055,5009253,M,Y,N,1,135000.0,Working,Secondary / secondary special,Married,House / apartment,-9957,-921,1,1,0,0,Drivers,3.0,-9,C
7056,5009253,M,Y,N,1,135000.0,Working,Secondary / secondary special,Married,House / apartment,-9957,-921,1,1,0,0,Drivers,3.0,-10,C
7057,5009253,M,Y,N,1,135000.0,Working,Secondary / secondary special,Married,House / apartment,-9957,-921,1,1,0,0,Drivers,3.0,-11,C
7058,5009253,M,Y,N,1,135000.0,Working,Secondary / secondary special,Married,House / apartment,-9957,-921,1,1,0,0,Drivers,3.0,-12,C
7059,5009253,M,Y,N,1,135000.0,Working,Secondary / secondary special,Married,House / apartment,-9957,-921,1,1,0,0,Drivers,3.0,-13,C
7060,5009253,M,Y,N,1,135000.0,Working,Secondary / secondary special,Married,House / apartment,-9957,-921,1,1,0,0,Drivers,3.0,-14,C
7061,5009253,M,Y,N,1,135000.0,Working,Secondary / secondary special,Married,House / apartment,-9957,-921,1,1,0,0,Drivers,3.0,-15,C
7062,5009253,M,Y,N,1,135000.0,Working,Secondary / secondary special,Married,House / apartment,-9957,-921,1,1,0,0,Drivers,3.0,-16,C
7063,5009253,M,Y,N,1,135000.0,Working,Secondary / secondary special,Married,House / apartment,-9957,-921,1,1,0,0,Drivers,3.0,-17,C
7064,5009253,M,Y,N,1,135000.0,Working,Secondary / secondary special,Married,House / apartment,-9957,-921,1,1,0,0,Drivers,3.0,-18,C
7065,5009253,M,Y,N,1,135000.0,Working,Secondary / secondary special,Married,House / apartment,-9957,-921,1,1,0,0,Drivers,3.0,-19,0
7066,5009253,M,Y,N,1,135000.0,Working,Secondary / secondary special,Married,House / apartment,-9957,-921,1,1,0,0,Drivers,3.0,-20,0
7067,5009253,M,Y,N,1,135000.0,Working,Secondary / secondary special,Married,House / apartment,-9957,-921,1,1,0,0,Drivers,3.0,-21,0
7068,5009253,M,Y,N,1,135000.0,Working,Secondary / secondary special,Married,House / apartment,-9957,-921,1,1,0,0,Drivers,3.0,-22,0
7069,5009255,F,N,N,0,144000.0,Working,Secondary / secondary special,Single / not married,House / apartment,-15970,-8987,1,0,0,0,Cleaning staff,1.0,0,0
7070,5009255,F,N,N,0,144000.0,Working,Secondary / secondary special,Single / not married,House / apartment,-15970,-8987,1,0,0,0,Cleaning staff,1.0,-1,0
7071,5009255,F,N,N,0,144000.0,Working,Secondary / secondary special,Single / not married,House / apartment,-15970,-8987,1,0,0,0,Cleaning staff,1.0,-2,0
7072,5009255,F,N,N,0,144000.0,Working,Secondary / secondary special,Single / not married,House / apartment,-15970,-8987,1,0,0,0,Cleaning staff,1.0,-3,0
7073,5009255,F,N,N,0,144000.0,Working,Secondary / secondary special,Single / not married,House / apartment,-15970,-8987,1,0,0,0,Cleaning staff,1.0,-4,0
7074,5009255,F,N,N,0,144000.0,Working,Secondary / secondary special,Single / not married,House / apartment,-15970,-8987,1,0,0,0,Cleaning staff,1.0,-5,0
7075,5009255,F,N,N,0,144000.0,Working,Secondary / secondary special,Single / not married,House / apartment,-15970,-8987,1,0,0,0,Cleaning staff,1.0,-6,0
7076,5009257,F,N,N,0,144000.0,Working,Secondary / secondary special,Single / not married,House / apartment,-15970,-8987,1,0,0,0,Cleaning staff,1.0,-10,X
7077,5009257,F,N,N,0,144000.0,Working,Secondary / secondary special,Single / not married,House / apartment,-15970,-8987,1,0,0,0,Cleaning staff,1.0,-11,0
7078,5009257,F,N,N,0,144000.0,Working,Secondary / secondary special,Single / not married,House / apartment,-15970,-8987,1,0,0,0,Cleaning staff,1.0,-12,0
7079,5009257,F,N,N,0,144000.0,Working,Secondary / secondary special,Single / not married,House / apartment,-15970,-8987,1,0,0,0,Cleaning staff,1.0,-13,0
7080,5009257,F,N,N,0,144000.0,Working,Secondary / secondary special,Single / not married,House / apartment,-15970,-8987,1,0,0,0,Cleaning staff,1.0,-14,0
7081,5009257,F,N,N,0,144000.0,Working,Secondary / secondary special,Single / not married,House / apartment,-15970,-8987,1,0,0,0,Cleaning staff,1.0,-15,0
7082,5009257,F,N,N,0,144000.0,Working,Secondary / secondary special,Single / not married,House / apartment,-15970,-8987,1,0,0,0,Cleaning staff,1.0,-16,0
7083,5009257,F,N,N,0,144000.0,Working,Secondary / secondary special,Single / not married,House / apartment,-15970,-8987,1,0,0,0,Cleaning staff,1.0,-17,0
7084,5009258,F,N,N,0,144000.0,Working,Secondary / secondary special,Single / not married,House / apartment,-15970,-8987,1,0,0,0,Cleaning staff,1.0,-31,X
7085,5009258,F,N,N,0,144000.0,Working,Secondary / secondary special,Single / not married,House / apartment,-15970,-8987,1,0,0,0,Cleaning staff,1.0,-32,0
7086,5009258,F,N,N,0,144000.0,Working,Secondary / secondary special,Single / not married,House / apartment,-15970,-8987,1,0,0,0,Cleaning staff,1.0,-33,0
7087,5009258,F,N,N,0,144000.0,Working,Secondary / secondary special,Single / not married,House / apartment,-15970,-8987,1,0,0,0,Cleaning staff,1.0,-34,0
7088,5009258,F,N,N,0,144000.0,Working,Secondary / secondary special,Single / not married,House / apartment,-15970,-8987,1,0,0,0,Cleaning staff,1.0,-35,0
7089,5009258,F,N,N,0,144000.0,Working,Secondary / secondary special,Single / not married,House / apartment,-15970,-8987,1,0,0,0,Cleaning staff,1.0,-36,0
7090,5009258,F,N,N,0,144000.0,Working,Secondary / secondary special,Single / not married,House / apartment,-15970,-8987,1,0,0,0,Cleaning staff,1.0,-37,0
7091,5009258,F,N,N,0,144000.0,Working,Secondary / secondary special,Single / not married,House / apartment,-15970,-8987,1,0,0,0,Cleaning staff,1.0,-38,X
7092,5009260,F,N,N,0,202500.0,State servant,Higher education,Married,With parents,-14562,-1287,1,0,1,0,Core staff,2.0,0,C
7093,5009260,F,N,N,0,202500.0,State servant,Higher education,Married,With parents,-14562,-1287,1,0,1,0,Core staff,2.0,-1,C
7094,5009260,F,N,N,0,202500.0,State servant,Higher education,Married,With parents,-14562,-1287,1,0,1,0,Core staff,2.0,-2,C
7095,5009260,F,N,N,0,202500.0,State servant,Higher education,Married,With parents,-14562,-1287,1,0,1,0,Core staff,2.0,-3,C
7096,5009260,F,N,N,0,202500.0,State servant,Higher education,Married,With parents,-14562,-1287,1,0,1,0,Core staff,2.0,-4,C
7097,5009260,F,N,N,0,202500.0,State servant,Higher education,Married,With parents,-14562,-1287,1,0,1,0,Core staff,2.0,-5,C
7098,5009260,F,N,N,0,202500.0,State servant,Higher education,Married,With parents,-14562,-1287,1,0,1,0,Core staff,2.0,-6,C
7099,5009260,F,N,N,0,202500.0,State servant,Higher education,Married,With parents,-14562,-1287,1,0,1,0,Core staff,2.0,-7,C
7100,5009260,F,N,N,0,202500.0,State servant,Higher education,Married,With parents,-14562,-1287,1,0,1,0,Core staff,2.0,-8,C
7101,5009260,F,N,N,0,202500.0,State servant,Higher education,Married,With parents,-14562,-1287,1,0,1,0,Core staff,2.0,-9,C
7102,5009260,F,N,N,0,202500.0,State servant,Higher education,Married,With parents,-14562,-1287,1,0,1,0,Core staff,2.0,-10,C
7103,5009260,F,N,N,0,202500.0,State servant,Higher education,Married,With parents,-14562,-1287,1,0,1,0,Core staff,2.0,-11,C
7104,5009260,F,N,N,0,202500.0,State servant,Higher education,Married,With parents,-14562,-1287,1,0,1,0,Core staff,2.0,-12,C
7105,5009260,F,N,N,0,202500.0,State servant,Higher education,Married,With parents,-14562,-1287,1,0,1,0,Core staff,2.0,-13,C
7106,5009260,F,N,N,0,202500.0,State servant,Higher education,Married,With parents,-14562,-1287,1,0,1,0,Core staff,2.0,-14,C
7107,5009260,F,N,N,0,202500.0,State servant,Higher education,Married,With parents,-14562,-1287,1,0,1,0,Core staff,2.0,-15,C
7108,5009260,F,N,N,0,202500.0,State servant,Higher education,Married,With parents,-14562,-1287,1,0,1,0,Core staff,2.0,-16,0
7109,5009260,F,N,N,0,202500.0,State servant,Higher education,Married,With parents,-14562,-1287,1,0,1,0,Core staff,2.0,-17,0
7110,5009260,F,N,N,0,202500.0,State servant,Higher education,Married,With parents,-14562,-1287,1,0,1,0,Core staff,2.0,-18,0
7111,5009260,F,N,N,0,202500.0,State servant,Higher education,Married,With parents,-14562,-1287,1,0,1,0,Core staff,2.0,-19,0
7112,5009261,F,N,N,0,202500.0,State servant,Higher education,Married,With parents,-14562,-1287,1,0,1,0,Core staff,2.0,-2,C
7113,5009261,F,N,N,0,202500.0,State servant,Higher education,Married,With parents,-14562,-1287,1,0,1,0,Core staff,2.0,-3,C
7114,5009261,F,N,N,0,202500.0,State servant,Higher education,Married,With parents,-14562,-1287,1,0,1,0,Core staff,2.0,-4,C
7115,5009261,F,N,N,0,202500.0,State servant,Higher education,Married,With parents,-14562,-1287,1,0,1,0,Core staff,2.0,-5,C
7116,5009261,F,N,N,0,202500.0,State servant,Higher education,Married,With parents,-14562,-1287,1,0,1,0,Core staff,2.0,-6,C
7117,5009261,F,N,N,0,202500.0,State servant,Higher education,Married,With parents,-14562,-1287,1,0,1,0,Core staff,2.0,-7,C
7118,5009261,F,N,N,0,202500.0,State servant,Higher education,Married,With parents,-14562,-1287,1,0,1,0,Core staff,2.0,-8,C
7119,5009261,F,N,N,0,202500.0,State servant,Higher education,Married,With parents,-14562,-1287,1,0,1,0,Core staff,2.0,-9,C
7120,5009261,F,N,N,0,202500.0,State servant,Higher education,Married,With parents,-14562,-1287,1,0,1,0,Core staff,2.0,-10,C
7121,5009261,F,N,N,0,202500.0,State servant,Higher education,Married,With parents,-14562,-1287,1,0,1,0,Core staff,2.0,-11,C
7122,5009261,F,N,N,0,202500.0,State servant,Higher education,Married,With parents,-14562,-1287,1,0,1,0,Core staff,2.0,-12,C
7123,5009261,F,N,N,0,202500.0,State servant,Higher education,Married,With parents,-14562,-1287,1,0,1,0,Core staff,2.0,-13,C
7124,5009261,F,N,N,0,202500.0,State servant,Higher education,Married,With parents,-14562,-1287,1,0,1,0,Core staff,2.0,-14,C
7125,5009261,F,N,N,0,202500.0,State servant,Higher education,Married,With parents,-14562,-1287,1,0,1,0,Core staff,2.0,-15,C
7126,5009261,F,N,N,0,202500.0,State servant,Higher education,Married,With parents,-14562,-1287,1,0,1,0,Core staff,2.0,-16,C
7127,5009261,F,N,N,0,202500.0,State servant,Higher education,Married,With parents,-14562,-1287,1,0,1,0,Core staff,2.0,-17,C
7128,5009261,F,N,N,0,202500.0,State servant,Higher education,Married,With parents,-14562,-1287,1,0,1,0,Core staff,2.0,-18,C
7129,5009261,F,N,N,0,202500.0,State servant,Higher education,Married,With parents,-14562,-1287,1,0,1,0,Core staff,2.0,-19,C
7130,5009261,F,N,N,0,202500.0,State servant,Higher education,Married,With parents,-14562,-1287,1,0,1,0,Core staff,2.0,-20,0
7131,5009261,F,N,N,0,202500.0,State servant,Higher education,Married,With parents,-14562,-1287,1,0,1,0,Core staff,2.0,-21,1
7132,5009261,F,N,N,0,202500.0,State servant,Higher education,Married,With parents,-14562,-1287,1,0,1,0,Core staff,2.0,-22,0
7133,5009261,F,N,N,0,202500.0,State servant,Higher education,Married,With parents,-14562,-1287,1,0,1,0,Core staff,2.0,-23,0
7134,5009262,F,N,N,0,202500.0,State servant,Higher education,Married,With parents,-14562,-1287,1,0,1,0,Core staff,2.0,0,C
7135,5009262,F,N,N,0,202500.0,State servant,Higher education,Married,With parents,-14562,-1287,1,0,1,0,Core staff,2.0,-1,C
7136,5009262,F,N,N,0,202500.0,State servant,Higher education,Married,With parents,-14562,-1287,1,0,1,0,Core staff,2.0,-2,C
7137,5009262,F,N,N,0,202500.0,State servant,Higher education,Married,With parents,-14562,-1287,1,0,1,0,Core staff,2.0,-3,C
7138,5009262,F,N,N,0,202500.0,State servant,Higher education,Married,With parents,-14562,-1287,1,0,1,0,Core staff,2.0,-4,C
7139,5009262,F,N,N,0,202500.0,State servant,Higher education,Married,With parents,-14562,-1287,1,0,1,0,Core staff,2.0,-5,0
7140,5009262,F,N,N,0,202500.0,State servant,Higher education,Married,With parents,-14562,-1287,1,0,1,0,Core staff,2.0,-6,0
7141,5009262,F,N,N,0,202500.0,State servant,Higher education,Married,With parents,-14562,-1287,1,0,1,0,Core staff,2.0,-7,0
7142,5009262,F,N,N,0,202500.0,State servant,Higher education,Married,With parents,-14562,-1287,1,0,1,0,Core staff,2.0,-8,0
7143,5009263,F,N,N,0,202500.0,State servant,Higher education,Married,With parents,-14562,-1287,1,0,1,0,Core staff,2.0,0,C
7144,5009263,F,N,N,0,202500.0,State servant,Higher education,Married,With parents,-14562,-1287,1,0,1,0,Core staff,2.0,-1,C
7145,5009263,F,N,N,0,202500.0,State servant,Higher education,Married,With parents,-14562,-1287,1,0,1,0,Core staff,2.0,-2,C
7146,5009263,F,N,N,0,202500.0,State servant,Higher education,Married,With parents,-14562,-1287,1,0,1,0,Core staff,2.0,-3,C
7147,5009263,F,N,N,0,202500.0,State servant,Higher education,Married,With parents,-14562,-1287,1,0,1,0,Core staff,2.0,-4,C
7148,5009263,F,N,N,0,202500.0,State servant,Higher education,Married,With parents,-14562,-1287,1,0,1,0,Core staff,2.0,-5,0
7149,5009263,F,N,N,0,202500.0,State servant,Higher education,Married,With parents,-14562,-1287,1,0,1,0,Core staff,2.0,-6,0
7150,5009263,F,N,N,0,202500.0,State servant,Higher education,Married,With parents,-14562,-1287,1,0,1,0,Core staff,2.0,-7,0
7151,5009263,F,N,N,0,202500.0,State servant,Higher education,Married,With parents,-14562,-1287,1,0,1,0,Core staff,2.0,-8,0
7152,5009263,F,N,N,0,202500.0,State servant,Higher education,Married,With parents,-14562,-1287,1,0,1,0,Core staff,2.0,-9,0
7153,5009263,F,N,N,0,202500.0,State servant,Higher education,Married,With parents,-14562,-1287,1,0,1,0,Core staff,2.0,-10,0
7154,5009263,F,N,N,0,202500.0,State servant,Higher education,Married,With parents,-14562,-1287,1,0,1,0,Core staff,2.0,-11,0
7155,5009263,F,N,N,0,202500.0,State servant,Higher education,Married,With parents,-14562,-1287,1,0,1,0,Core staff,2.0,-12,1
7156,5009263,F,N,N,0,202500.0,State servant,Higher education,Married,With parents,-14562,-1287,1,0,1,0,Core staff,2.0,-13,0
7157,5009263,F,N,N,0,202500.0,State servant,Higher education,Married,With parents,-14562,-1287,1,0,1,0,Core staff,2.0,-14,0
7158,5009263,F,N,N,0,202500.0,State servant,Higher education,Married,With parents,-14562,-1287,1,0,1,0,Core staff,2.0,-15,0
7159,5009263,F,N,N,0,202500.0,State servant,Higher education,Married,With parents,-14562,-1287,1,0,1,0,Core staff,2.0,-16,0
7160,5009264,F,N,N,0,40500.0,Pensioner,Secondary / secondary special,Single / not married,House / apartment,-21091,365243,1,0,0,0,,1.0,-10,C
7161,5009264,F,N,N,0,40500.0,Pensioner,Secondary / secondary special,Single / not married,House / apartment,-21091,365243,1,0,0,0,,1.0,-11,C
7162,5009264,F,N,N,0,40500.0,Pensioner,Secondary / secondary special,Single / not married,House / apartment,-21091,365243,1,0,0,0,,1.0,-12,C
7163,5009264,F,N,N,0,40500.0,Pensioner,Secondary / secondary special,Single / not married,House / apartment,-21091,365243,1,0,0,0,,1.0,-13,C
7164,5009264,F,N,N,0,40500.0,Pensioner,Secondary / secondary special,Single / not married,House / apartment,-21091,365243,1,0,0,0,,1.0,-14,C
7165,5009264,F,N,N,0,40500.0,Pensioner,Secondary / secondary special,Single / not married,House / apartment,-21091,365243,1,0,0,0,,1.0,-15,1
7166,5009264,F,N,N,0,40500.0,Pensioner,Secondary / secondary special,Single / not married,House / apartment,-21091,365243,1,0,0,0,,1.0,-16,0
7167,5009264,F,N,N,0,40500.0,Pensioner,Secondary / secondary special,Single / not married,House / apartment,-21091,365243,1,0,0,0,,1.0,-17,1
7168,5009264,F,N,N,0,40500.0,Pensioner,Secondary / secondary special,Single / not married,House / apartment,-21091,365243,1,0,0,0,,1.0,-18,0
7169,5009264,F,N,N,0,40500.0,Pensioner,Secondary / secondary special,Single / not married,House / apartment,-21091,365243,1,0,0,0,,1.0,-19,0
7170,5009264,F,N,N,0,40500.0,Pensioner,Secondary / secondary special,Single / not married,House / apartment,-21091,365243,1,0,0,0,,1.0,-20,0
7171,5009264,F,N,N,0,40500.0,Pensioner,Secondary / secondary special,Single / not married,House / apartment,-21091,365243,1,0,0,0,,1.0,-21,0
7172,5009265,M,Y,N,0,337500.0,State servant,Higher education,Married,With parents,-10266,-1652,1,1,1,0,Managers,2.0,-12,C
7173,5009265,M,Y,N,0,337500.0,State servant,Higher education,Married,With parents,-10266,-1652,1,1,1,0,Managers,2.0,-13,C
7174,5009265,M,Y,N,0,337500.0,State servant,Higher education,Married,With parents,-10266,-1652,1,1,1,0,Managers,2.0,-14,C
7175,5009265,M,Y,N,0,337500.0,State servant,Higher education,Married,With parents,-10266,-1652,1,1,1,0,Managers,2.0,-15,C
7176,5009265,M,Y,N,0,337500.0,State servant,Higher education,Married,With parents,-10266,-1652,1,1,1,0,Managers,2.0,-16,C
7177,5009265,M,Y,N,0,337500.0,State servant,Higher education,Married,With parents,-10266,-1652,1,1,1,0,Managers,2.0,-17,C
7178,5009265,M,Y,N,0,337500.0,State servant,Higher education,Married,With parents,-10266,-1652,1,1,1,0,Managers,2.0,-18,C
7179,5009265,M,Y,N,0,337500.0,State servant,Higher education,Married,With parents,-10266,-1652,1,1,1,0,Managers,2.0,-19,C
7180,5009265,M,Y,N,0,337500.0,State servant,Higher education,Married,With parents,-10266,-1652,1,1,1,0,Managers,2.0,-20,C
7181,5009265,M,Y,N,0,337500.0,State servant,Higher education,Married,With parents,-10266,-1652,1,1,1,0,Managers,2.0,-21,C
7182,5009265,M,Y,N,0,337500.0,State servant,Higher education,Married,With parents,-10266,-1652,1,1,1,0,Managers,2.0,-22,C
7183,5009265,M,Y,N,0,337500.0,State servant,Higher education,Married,With parents,-10266,-1652,1,1,1,0,Managers,2.0,-23,C
7184,5009265,M,Y,N,0,337500.0,State servant,Higher education,Married,With parents,-10266,-1652,1,1,1,0,Managers,2.0,-24,C
7185,5009265,M,Y,N,0,337500.0,State servant,Higher education,Married,With parents,-10266,-1652,1,1,1,0,Managers,2.0,-25,C
7186,5009265,M,Y,N,0,337500.0,State servant,Higher education,Married,With parents,-10266,-1652,1,1,1,0,Managers,2.0,-26,C
7187,5009265,M,Y,N,0,337500.0,State servant,Higher education,Married,With parents,-10266,-1652,1,1,1,0,Managers,2.0,-27,C
7188,5009265,M,Y,N,0,337500.0,State servant,Higher education,Married,With parents,-10266,-1652,1,1,1,0,Managers,2.0,-28,C
7189,5009265,M,Y,N,0,337500.0,State servant,Higher education,Married,With parents,-10266,-1652,1,1,1,0,Managers,2.0,-29,C
7190,5009265,M,Y,N,0,337500.0,State servant,Higher education,Married,With parents,-10266,-1652,1,1,1,0,Managers,2.0,-30,C
7191,5009265,M,Y,N,0,337500.0,State servant,Higher education,Married,With parents,-10266,-1652,1,1,1,0,Managers,2.0,-31,C
7192,5009265,M,Y,N,0,337500.0,State servant,Higher education,Married,With parents,-10266,-1652,1,1,1,0,Managers,2.0,-32,C
7193,5009265,M,Y,N,0,337500.0,State servant,Higher education,Married,With parents,-10266,-1652,1,1,1,0,Managers,2.0,-33,C
7194,5009265,M,Y,N,0,337500.0,State servant,Higher education,Married,With parents,-10266,-1652,1,1,1,0,Managers,2.0,-34,C
7195,5009265,M,Y,N,0,337500.0,State servant,Higher education,Married,With parents,-10266,-1652,1,1,1,0,Managers,2.0,-35,C
7196,5009265,M,Y,N,0,337500.0,State servant,Higher education,Married,With parents,-10266,-1652,1,1,1,0,Managers,2.0,-36,C
7197,5009265,M,Y,N,0,337500.0,State servant,Higher education,Married,With parents,-10266,-1652,1,1,1,0,Managers,2.0,-37,C
7198,5009265,M,Y,N,0,337500.0,State servant,Higher education,Married,With parents,-10266,-1652,1,1,1,0,Managers,2.0,-38,0
7199,5009265,M,Y,N,0,337500.0,State servant,Higher education,Married,With parents,-10266,-1652,1,1,1,0,Managers,2.0,-39,0
7200,5009265,M,Y,N,0,337500.0,State servant,Higher education,Married,With parents,-10266,-1652,1,1,1,0,Managers,2.0,-40,0
7201,5009265,M,Y,N,0,337500.0,State servant,Higher education,Married,With parents,-10266,-1652,1,1,1,0,Managers,2.0,-41,0
7202,5009265,M,Y,N,0,337500.0,State servant,Higher education,Married,With parents,-10266,-1652,1,1,1,0,Managers,2.0,-42,0
7203,5009265,M,Y,N,0,337500.0,State servant,Higher education,Married,With parents,-10266,-1652,1,1,1,0,Managers,2.0,-43,0
7204,5009265,M,Y,N,0,337500.0,State servant,Higher education,Married,With parents,-10266,-1652,1,1,1,0,Managers,2.0,-44,0
7205,5009265,M,Y,N,0,337500.0,State servant,Higher education,Married,With parents,-10266,-1652,1,1,1,0,Managers,2.0,-45,0
7206,5009265,M,Y,N,0,337500.0,State servant,Higher education,Married,With parents,-10266,-1652,1,1,1,0,Managers,2.0,-46,0
7207,5009265,M,Y,N,0,337500.0,State servant,Higher education,Married,With parents,-10266,-1652,1,1,1,0,Managers,2.0,-47,0
7208,5009266,M,Y,N,0,337500.0,State servant,Higher education,Married,With parents,-10266,-1652,1,1,1,0,Managers,2.0,0,C
7209,5009266,M,Y,N,0,337500.0,State servant,Higher education,Married,With parents,-10266,-1652,1,1,1,0,Managers,2.0,-1,C
7210,5009266,M,Y,N,0,337500.0,State servant,Higher education,Married,With parents,-10266,-1652,1,1,1,0,Managers,2.0,-2,C
7211,5009266,M,Y,N,0,337500.0,State servant,Higher education,Married,With parents,-10266,-1652,1,1,1,0,Managers,2.0,-3,C
7212,5009266,M,Y,N,0,337500.0,State servant,Higher education,Married,With parents,-10266,-1652,1,1,1,0,Managers,2.0,-4,C
7213,5009266,M,Y,N,0,337500.0,State servant,Higher education,Married,With parents,-10266,-1652,1,1,1,0,Managers,2.0,-5,C
7214,5009266,M,Y,N,0,337500.0,State servant,Higher education,Married,With parents,-10266,-1652,1,1,1,0,Managers,2.0,-6,0
7215,5009266,M,Y,N,0,337500.0,State servant,Higher education,Married,With parents,-10266,-1652,1,1,1,0,Managers,2.0,-7,0
7216,5009266,M,Y,N,0,337500.0,State servant,Higher education,Married,With parents,-10266,-1652,1,1,1,0,Managers,2.0,-8,0
7217,5009266,M,Y,N,0,337500.0,State servant,Higher education,Married,With parents,-10266,-1652,1,1,1,0,Managers,2.0,-9,0
7218,5009266,M,Y,N,0,337500.0,State servant,Higher education,Married,With parents,-10266,-1652,1,1,1,0,Managers,2.0,-10,0
7219,5009266,M,Y,N,0,337500.0,State servant,Higher education,Married,With parents,-10266,-1652,1,1,1,0,Managers,2.0,-11,0
7220,5009266,M,Y,N,0,337500.0,State servant,Higher education,Married,With parents,-10266,-1652,1,1,1,0,Managers,2.0,-12,0
7221,5009266,M,Y,N,0,337500.0,State servant,Higher education,Married,With parents,-10266,-1652,1,1,1,0,Managers,2.0,-13,0
7222,5009266,M,Y,N,0,337500.0,State servant,Higher education,Married,With parents,-10266,-1652,1,1,1,0,Managers,2.0,-14,0
7223,5009266,M,Y,N,0,337500.0,State servant,Higher education,Married,With parents,-10266,-1652,1,1,1,0,Managers,2.0,-15,0
7224,5009267,M,Y,N,0,337500.0,State servant,Higher education,Married,With parents,-10266,-1652,1,1,1,0,Managers,2.0,0,C
7225,5009267,M,Y,N,0,337500.0,State servant,Higher education,Married,With parents,-10266,-1652,1,1,1,0,Managers,2.0,-1,C
7226,5009267,M,Y,N,0,337500.0,State servant,Higher education,Married,With parents,-10266,-1652,1,1,1,0,Managers,2.0,-2,C
7227,5009267,M,Y,N,0,337500.0,State servant,Higher education,Married,With parents,-10266,-1652,1,1,1,0,Managers,2.0,-3,C
7228,5009267,M,Y,N,0,337500.0,State servant,Higher education,Married,With parents,-10266,-1652,1,1,1,0,Managers,2.0,-4,C
7229,5009267,M,Y,N,0,337500.0,State servant,Higher education,Married,With parents,-10266,-1652,1,1,1,0,Managers,2.0,-5,C
7230,5009267,M,Y,N,0,337500.0,State servant,Higher education,Married,With parents,-10266,-1652,1,1,1,0,Managers,2.0,-6,C
7231,5009267,M,Y,N,0,337500.0,State servant,Higher education,Married,With parents,-10266,-1652,1,1,1,0,Managers,2.0,-7,C
7232,5009267,M,Y,N,0,337500.0,State servant,Higher education,Married,With parents,-10266,-1652,1,1,1,0,Managers,2.0,-8,0
7233,5009267,M,Y,N,0,337500.0,State servant,Higher education,Married,With parents,-10266,-1652,1,1,1,0,Managers,2.0,-9,0
7234,5009267,M,Y,N,0,337500.0,State servant,Higher education,Married,With parents,-10266,-1652,1,1,1,0,Managers,2.0,-10,0
7235,5009267,M,Y,N,0,337500.0,State servant,Higher education,Married,With parents,-10266,-1652,1,1,1,0,Managers,2.0,-11,0
7236,5009267,M,Y,N,0,337500.0,State servant,Higher education,Married,With parents,-10266,-1652,1,1,1,0,Managers,2.0,-12,0
7237,5009267,M,Y,N,0,337500.0,State servant,Higher education,Married,With parents,-10266,-1652,1,1,1,0,Managers,2.0,-13,0
7238,5009267,M,Y,N,0,337500.0,State servant,Higher education,Married,With parents,-10266,-1652,1,1,1,0,Managers,2.0,-14,0
7239,5009267,M,Y,N,0,337500.0,State servant,Higher education,Married,With parents,-10266,-1652,1,1,1,0,Managers,2.0,-15,0
7240,5009267,M,Y,N,0,337500.0,State servant,Higher education,Married,With parents,-10266,-1652,1,1,1,0,Managers,2.0,-16,0
7241,5009267,M,Y,N,0,337500.0,State servant,Higher education,Married,With parents,-10266,-1652,1,1,1,0,Managers,2.0,-17,0
7242,5009268,M,Y,N,0,337500.0,State servant,Higher education,Married,With parents,-10266,-1652,1,1,1,0,Managers,2.0,0,C
7243,5009268,M,Y,N,0,337500.0,State servant,Higher education,Married,With parents,-10266,-1652,1,1,1,0,Managers,2.0,-1,C
7244,5009268,M,Y,N,0,337500.0,State servant,Higher education,Married,With parents,-10266,-1652,1,1,1,0,Managers,2.0,-2,C
7245,5009268,M,Y,N,0,337500.0,State servant,Higher education,Married,With parents,-10266,-1652,1,1,1,0,Managers,2.0,-3,C
7246,5009268,M,Y,N,0,337500.0,State servant,Higher education,Married,With parents,-10266,-1652,1,1,1,0,Managers,2.0,-4,C
7247,5009268,M,Y,N,0,337500.0,State servant,Higher education,Married,With parents,-10266,-1652,1,1,1,0,Managers,2.0,-5,C
7248,5009268,M,Y,N,0,337500.0,State servant,Higher education,Married,With parents,-10266,-1652,1,1,1,0,Managers,2.0,-6,C
7249,5009268,M,Y,N,0,337500.0,State servant,Higher education,Married,With parents,-10266,-1652,1,1,1,0,Managers,2.0,-7,C
7250,5009268,M,Y,N,0,337500.0,State servant,Higher education,Married,With parents,-10266,-1652,1,1,1,0,Managers,2.0,-8,C
7251,5009268,M,Y,N,0,337500.0,State servant,Higher education,Married,With parents,-10266,-1652,1,1,1,0,Managers,2.0,-9,C
7252,5009268,M,Y,N,0,337500.0,State servant,Higher education,Married,With parents,-10266,-1652,1,1,1,0,Managers,2.0,-10,C
7253,5009268,M,Y,N,0,337500.0,State servant,Higher education,Married,With parents,-10266,-1652,1,1,1,0,Managers,2.0,-11,C
7254,5009268,M,Y,N,0,337500.0,State servant,Higher education,Married,With parents,-10266,-1652,1,1,1,0,Managers,2.0,-12,C
7255,5009268,M,Y,N,0,337500.0,State servant,Higher education,Married,With parents,-10266,-1652,1,1,1,0,Managers,2.0,-13,C
7256,5009268,M,Y,N,0,337500.0,State servant,Higher education,Married,With parents,-10266,-1652,1,1,1,0,Managers,2.0,-14,C
7257,5009268,M,Y,N,0,337500.0,State servant,Higher education,Married,With parents,-10266,-1652,1,1,1,0,Managers,2.0,-15,C
7258,5009268,M,Y,N,0,337500.0,State servant,Higher education,Married,With parents,-10266,-1652,1,1,1,0,Managers,2.0,-16,C
7259,5009268,M,Y,N,0,337500.0,State servant,Higher education,Married,With parents,-10266,-1652,1,1,1,0,Managers,2.0,-17,C
7260,5009268,M,Y,N,0,337500.0,State servant,Higher education,Married,With parents,-10266,-1652,1,1,1,0,Managers,2.0,-18,C
7261,5009268,M,Y,N,0,337500.0,State servant,Higher education,Married,With parents,-10266,-1652,1,1,1,0,Managers,2.0,-19,C
7262,5009268,M,Y,N,0,337500.0,State servant,Higher education,Married,With parents,-10266,-1652,1,1,1,0,Managers,2.0,-20,C
7263,5009268,M,Y,N,0,337500.0,State servant,Higher education,Married,With parents,-10266,-1652,1,1,1,0,Managers,2.0,-21,0
7264,5009268,M,Y,N,0,337500.0,State servant,Higher education,Married,With parents,-10266,-1652,1,1,1,0,Managers,2.0,-22,0
7265,5009268,M,Y,N,0,337500.0,State servant,Higher education,Married,With parents,-10266,-1652,1,1,1,0,Managers,2.0,-23,0
7266,5009268,M,Y,N,0,337500.0,State servant,Higher education,Married,With parents,-10266,-1652,1,1,1,0,Managers,2.0,-24,0
7267,5009268,M,Y,N,0,337500.0,State servant,Higher education,Married,With parents,-10266,-1652,1,1,1,0,Managers,2.0,-25,0
7268,5009268,M,Y,N,0,337500.0,State servant,Higher education,Married,With parents,-10266,-1652,1,1,1,0,Managers,2.0,-26,0
7269,5009269,M,Y,N,0,337500.0,State servant,Higher education,Married,With parents,-10266,-1652,1,1,1,0,Managers,2.0,0,C
7270,5009269,M,Y,N,0,337500.0,State servant,Higher education,Married,With parents,-10266,-1652,1,1,1,0,Managers,2.0,-1,C
7271,5009269,M,Y,N,0,337500.0,State servant,Higher education,Married,With parents,-10266,-1652,1,1,1,0,Managers,2.0,-2,C
7272,5009269,M,Y,N,0,337500.0,State servant,Higher education,Married,With parents,-10266,-1652,1,1,1,0,Managers,2.0,-3,C
7273,5009269,M,Y,N,0,337500.0,State servant,Higher education,Married,With parents,-10266,-1652,1,1,1,0,Managers,2.0,-4,C
7274,5009269,M,Y,N,0,337500.0,State servant,Higher education,Married,With parents,-10266,-1652,1,1,1,0,Managers,2.0,-5,C
7275,5009269,M,Y,N,0,337500.0,State servant,Higher education,Married,With parents,-10266,-1652,1,1,1,0,Managers,2.0,-6,C
7276,5009269,M,Y,N,0,337500.0,State servant,Higher education,Married,With parents,-10266,-1652,1,1,1,0,Managers,2.0,-7,C
7277,5009269,M,Y,N,0,337500.0,State servant,Higher education,Married,With parents,-10266,-1652,1,1,1,0,Managers,2.0,-8,C
7278,5009269,M,Y,N,0,337500.0,State servant,Higher education,Married,With parents,-10266,-1652,1,1,1,0,Managers,2.0,-9,C
7279,5009269,M,Y,N,0,337500.0,State servant,Higher education,Married,With parents,-10266,-1652,1,1,1,0,Managers,2.0,-10,C
7280,5009269,M,Y,N,0,337500.0,State servant,Higher education,Married,With parents,-10266,-1652,1,1,1,0,Managers,2.0,-11,C
7281,5009269,M,Y,N,0,337500.0,State servant,Higher education,Married,With parents,-10266,-1652,1,1,1,0,Managers,2.0,-12,C
7282,5009269,M,Y,N,0,337500.0,State servant,Higher education,Married,With parents,-10266,-1652,1,1,1,0,Managers,2.0,-13,C
7283,5009269,M,Y,N,0,337500.0,State servant,Higher education,Married,With parents,-10266,-1652,1,1,1,0,Managers,2.0,-14,C
7284,5009269,M,Y,N,0,337500.0,State servant,Higher education,Married,With parents,-10266,-1652,1,1,1,0,Managers,2.0,-15,C
7285,5009269,M,Y,N,0,337500.0,State servant,Higher education,Married,With parents,-10266,-1652,1,1,1,0,Managers,2.0,-16,C
7286,5009269,M,Y,N,0,337500.0,State servant,Higher education,Married,With parents,-10266,-1652,1,1,1,0,Managers,2.0,-17,C
7287,5009269,M,Y,N,0,337500.0,State servant,Higher education,Married,With parents,-10266,-1652,1,1,1,0,Managers,2.0,-18,C
7288,5009269,M,Y,N,0,337500.0,State servant,Higher education,Married,With parents,-10266,-1652,1,1,1,0,Managers,2.0,-19,C
7289,5009269,M,Y,N,0,337500.0,State servant,Higher education,Married,With parents,-10266,-1652,1,1,1,0,Managers,2.0,-20,C
7290,5009269,M,Y,N,0,337500.0,State servant,Higher education,Married,With parents,-10266,-1652,1,1,1,0,Managers,2.0,-21,C
7291,5009269,M,Y,N,0,337500.0,State servant,Higher education,Married,With parents,-10266,-1652,1,1,1,0,Managers,2.0,-22,C
7292,5009269,M,Y,N,0,337500.0,State servant,Higher education,Married,With parents,-10266,-1652,1,1,1,0,Managers,2.0,-23,C
7293,5009269,M,Y,N,0,337500.0,State servant,Higher education,Married,With parents,-10266,-1652,1,1,1,0,Managers,2.0,-24,C
7294,5009269,M,Y,N,0,337500.0,State servant,Higher education,Married,With parents,-10266,-1652,1,1,1,0,Managers,2.0,-25,0
7295,5009269,M,Y,N,0,337500.0,State servant,Higher education,Married,With parents,-10266,-1652,1,1,1,0,Managers,2.0,-26,0
7296,5009269,M,Y,N,0,337500.0,State servant,Higher education,Married,With parents,-10266,-1652,1,1,1,0,Managers,2.0,-27,0
7297,5009269,M,Y,N,0,337500.0,State servant,Higher education,Married,With parents,-10266,-1652,1,1,1,0,Managers,2.0,-28,0
7298,5009269,M,Y,N,0,337500.0,State servant,Higher education,Married,With parents,-10266,-1652,1,1,1,0,Managers,2.0,-29,0
7299,5009269,M,Y,N,0,337500.0,State servant,Higher education,Married,With parents,-10266,-1652,1,1,1,0,Managers,2.0,-30,0
7300,5009269,M,Y,N,0,337500.0,State servant,Higher education,Married,With parents,-10266,-1652,1,1,1,0,Managers,2.0,-31,0
7301,5009269,M,Y,N,0,337500.0,State servant,Higher education,Married,With parents,-10266,-1652,1,1,1,0,Managers,2.0,-32,0
7302,5009269,M,Y,N,0,337500.0,State servant,Higher education,Married,With parents,-10266,-1652,1,1,1,0,Managers,2.0,-33,0
7303,5009269,M,Y,N,0,337500.0,State servant,Higher education,Married,With parents,-10266,-1652,1,1,1,0,Managers,2.0,-34,0
7304,5009270,M,N,N,0,180000.0,Commercial associate,Secondary / secondary special,Married,Municipal apartment,-14781,-2443,1,0,1,0,Laborers,2.0,0,0
7305,5009270,M,N,N,0,180000.0,Commercial associate,Secondary / secondary special,Married,Municipal apartment,-14781,-2443,1,0,1,0,Laborers,2.0,-1,0
7306,5009270,M,N,N,0,180000.0,Commercial associate,Secondary / secondary special,Married,Municipal apartment,-14781,-2443,1,0,1,0,Laborers,2.0,-2,0
7307,5009270,M,N,N,0,180000.0,Commercial associate,Secondary / secondary special,Married,Municipal apartment,-14781,-2443,1,0,1,0,Laborers,2.0,-3,0
7308,5009270,M,N,N,0,180000.0,Commercial associate,Secondary / secondary special,Married,Municipal apartment,-14781,-2443,1,0,1,0,Laborers,2.0,-4,0
7309,5009270,M,N,N,0,180000.0,Commercial associate,Secondary / secondary special,Married,Municipal apartment,-14781,-2443,1,0,1,0,Laborers,2.0,-5,0
7310,5009270,M,N,N,0,180000.0,Commercial associate,Secondary / secondary special,Married,Municipal apartment,-14781,-2443,1,0,1,0,Laborers,2.0,-6,0
7311,5009270,M,N,N,0,180000.0,Commercial associate,Secondary / secondary special,Married,Municipal apartment,-14781,-2443,1,0,1,0,Laborers,2.0,-7,0
7312,5009270,M,N,N,0,180000.0,Commercial associate,Secondary / secondary special,Married,Municipal apartment,-14781,-2443,1,0,1,0,Laborers,2.0,-8,0
7313,5009270,M,N,N,0,180000.0,Commercial associate,Secondary / secondary special,Married,Municipal apartment,-14781,-2443,1,0,1,0,Laborers,2.0,-9,0
7314,5009270,M,N,N,0,180000.0,Commercial associate,Secondary / secondary special,Married,Municipal apartment,-14781,-2443,1,0,1,0,Laborers,2.0,-10,0
7315,5009270,M,N,N,0,180000.0,Commercial associate,Secondary / secondary special,Married,Municipal apartment,-14781,-2443,1,0,1,0,Laborers,2.0,-11,0
7316,5009270,M,N,N,0,180000.0,Commercial associate,Secondary / secondary special,Married,Municipal apartment,-14781,-2443,1,0,1,0,Laborers,2.0,-12,0
7317,5009270,M,N,N,0,180000.0,Commercial associate,Secondary / secondary special,Married,Municipal apartment,-14781,-2443,1,0,1,0,Laborers,2.0,-13,0
7318,5009270,M,N,N,0,180000.0,Commercial associate,Secondary / secondary special,Married,Municipal apartment,-14781,-2443,1,0,1,0,Laborers,2.0,-14,0
7319,5009270,M,N,N,0,180000.0,Commercial associate,Secondary / secondary special,Married,Municipal apartment,-14781,-2443,1,0,1,0,Laborers,2.0,-15,0
7320,5009270,M,N,N,0,180000.0,Commercial associate,Secondary / secondary special,Married,Municipal apartment,-14781,-2443,1,0,1,0,Laborers,2.0,-16,0
7321,5009270,M,N,N,0,180000.0,Commercial associate,Secondary / secondary special,Married,Municipal apartment,-14781,-2443,1,0,1,0,Laborers,2.0,-17,0
7322,5009270,M,N,N,0,180000.0,Commercial associate,Secondary / secondary special,Married,Municipal apartment,-14781,-2443,1,0,1,0,Laborers,2.0,-18,0
7323,5009270,M,N,N,0,180000.0,Commercial associate,Secondary / secondary special,Married,Municipal apartment,-14781,-2443,1,0,1,0,Laborers,2.0,-19,0
7324,5009270,M,N,N,0,180000.0,Commercial associate,Secondary / secondary special,Married,Municipal apartment,-14781,-2443,1,0,1,0,Laborers,2.0,-20,0
7325,5009270,M,N,N,0,180000.0,Commercial associate,Secondary / secondary special,Married,Municipal apartment,-14781,-2443,1,0,1,0,Laborers,2.0,-21,0
7326,5009270,M,N,N,0,180000.0,Commercial associate,Secondary / secondary special,Married,Municipal apartment,-14781,-2443,1,0,1,0,Laborers,2.0,-22,0
7327,5009270,M,N,N,0,180000.0,Commercial associate,Secondary / secondary special,Married,Municipal apartment,-14781,-2443,1,0,1,0,Laborers,2.0,-23,0
7328,5009270,M,N,N,0,180000.0,Commercial associate,Secondary / secondary special,Married,Municipal apartment,-14781,-2443,1,0,1,0,Laborers,2.0,-24,0
7329,5009270,M,N,N,0,180000.0,Commercial associate,Secondary / secondary special,Married,Municipal apartment,-14781,-2443,1,0,1,0,Laborers,2.0,-25,0
7330,5009270,M,N,N,0,180000.0,Commercial associate,Secondary / secondary special,Married,Municipal apartment,-14781,-2443,1,0,1,0,Laborers,2.0,-26,0
7331,5009270,M,N,N,0,180000.0,Commercial associate,Secondary / secondary special,Married,Municipal apartment,-14781,-2443,1,0,1,0,Laborers,2.0,-27,X
7332,5009270,M,N,N,0,180000.0,Commercial associate,Secondary / secondary special,Married,Municipal apartment,-14781,-2443,1,0,1,0,Laborers,2.0,-28,X
7333,5009271,M,N,N,0,180000.0,Commercial associate,Secondary / secondary special,Married,Municipal apartment,-14781,-2443,1,0,1,0,Laborers,2.0,-10,X
7334,5009271,M,N,N,0,180000.0,Commercial associate,Secondary / secondary special,Married,Municipal apartment,-14781,-2443,1,0,1,0,Laborers,2.0,-11,X
7335,5009271,M,N,N,0,180000.0,Commercial associate,Secondary / secondary special,Married,Municipal apartment,-14781,-2443,1,0,1,0,Laborers,2.0,-12,0
7336,5009271,M,N,N,0,180000.0,Commercial associate,Secondary / secondary special,Married,Municipal apartment,-14781,-2443,1,0,1,0,Laborers,2.0,-13,0
7337,5009271,M,N,N,0,180000.0,Commercial associate,Secondary / secondary special,Married,Municipal apartment,-14781,-2443,1,0,1,0,Laborers,2.0,-14,0
7338,5009271,M,N,N,0,180000.0,Commercial associate,Secondary / secondary special,Married,Municipal apartment,-14781,-2443,1,0,1,0,Laborers,2.0,-15,0
7339,5009271,M,N,N,0,180000.0,Commercial associate,Secondary / secondary special,Married,Municipal apartment,-14781,-2443,1,0,1,0,Laborers,2.0,-16,0
7340,5009271,M,N,N,0,180000.0,Commercial associate,Secondary / secondary special,Married,Municipal apartment,-14781,-2443,1,0,1,0,Laborers,2.0,-17,X
7341,5009271,M,N,N,0,180000.0,Commercial associate,Secondary / secondary special,Married,Municipal apartment,-14781,-2443,1,0,1,0,Laborers,2.0,-18,0
7342,5009271,M,N,N,0,180000.0,Commercial associate,Secondary / secondary special,Married,Municipal apartment,-14781,-2443,1,0,1,0,Laborers,2.0,-19,0
7343,5009271,M,N,N,0,180000.0,Commercial associate,Secondary / secondary special,Married,Municipal apartment,-14781,-2443,1,0,1,0,Laborers,2.0,-20,X
7344,5009271,M,N,N,0,180000.0,Commercial associate,Secondary / secondary special,Married,Municipal apartment,-14781,-2443,1,0,1,0,Laborers,2.0,-21,0
7345,5009271,M,N,N,0,180000.0,Commercial associate,Secondary / secondary special,Married,Municipal apartment,-14781,-2443,1,0,1,0,Laborers,2.0,-22,X
7346,5009271,M,N,N,0,180000.0,Commercial associate,Secondary / secondary special,Married,Municipal apartment,-14781,-2443,1,0,1,0,Laborers,2.0,-23,0
7347,5009271,M,N,N,0,180000.0,Commercial associate,Secondary / secondary special,Married,Municipal apartment,-14781,-2443,1,0,1,0,Laborers,2.0,-24,X
7348,5009271,M,N,N,0,180000.0,Commercial associate,Secondary / secondary special,Married,Municipal apartment,-14781,-2443,1,0,1,0,Laborers,2.0,-25,0
7349,5009271,M,N,N,0,180000.0,Commercial associate,Secondary / secondary special,Married,Municipal apartment,-14781,-2443,1,0,1,0,Laborers,2.0,-26,X
7350,5009271,M,N,N,0,180000.0,Commercial associate,Secondary / secondary special,Married,Municipal apartment,-14781,-2443,1,0,1,0,Laborers,2.0,-27,0
7351,5009271,M,N,N,0,180000.0,Commercial associate,Secondary / secondary special,Married,Municipal apartment,-14781,-2443,1,0,1,0,Laborers,2.0,-28,0
7352,5009271,M,N,N,0,180000.0,Commercial associate,Secondary / secondary special,Married,Municipal apartment,-14781,-2443,1,0,1,0,Laborers,2.0,-29,0
7353,5009271,M,N,N,0,180000.0,Commercial associate,Secondary / secondary special,Married,Municipal apartment,-14781,-2443,1,0,1,0,Laborers,2.0,-30,X
7354,5009271,M,N,N,0,180000.0,Commercial associate,Secondary / secondary special,Married,Municipal apartment,-14781,-2443,1,0,1,0,Laborers,2.0,-31,0
7355,5009271,M,N,N,0,180000.0,Commercial associate,Secondary / secondary special,Married,Municipal apartment,-14781,-2443,1,0,1,0,Laborers,2.0,-32,0
7356,5009271,M,N,N,0,180000.0,Commercial associate,Secondary / secondary special,Married,Municipal apartment,-14781,-2443,1,0,1,0,Laborers,2.0,-33,0
7357,5009271,M,N,N,0,180000.0,Commercial associate,Secondary / secondary special,Married,Municipal apartment,-14781,-2443,1,0,1,0,Laborers,2.0,-34,X
7358,5009271,M,N,N,0,180000.0,Commercial associate,Secondary / secondary special,Married,Municipal apartment,-14781,-2443,1,0,1,0,Laborers,2.0,-35,0
7359,5009271,M,N,N,0,180000.0,Commercial associate,Secondary / secondary special,Married,Municipal apartment,-14781,-2443,1,0,1,0,Laborers,2.0,-36,X
7360,5009271,M,N,N,0,180000.0,Commercial associate,Secondary / secondary special,Married,Municipal apartment,-14781,-2443,1,0,1,0,Laborers,2.0,-37,X
7361,5009271,M,N,N,0,180000.0,Commercial associate,Secondary / secondary special,Married,Municipal apartment,-14781,-2443,1,0,1,0,Laborers,2.0,-38,X
7362,5009271,M,N,N,0,180000.0,Commercial associate,Secondary / secondary special,Married,Municipal apartment,-14781,-2443,1,0,1,0,Laborers,2.0,-39,X
7363,5009272,M,N,N,0,180000.0,Commercial associate,Secondary / secondary special,Married,Municipal apartment,-14781,-2443,1,0,1,0,Laborers,2.0,0,X
7364,5009272,M,N,N,0,180000.0,Commercial associate,Secondary / secondary special,Married,Municipal apartment,-14781,-2443,1,0,1,0,Laborers,2.0,-1,0
7365,5009272,M,N,N,0,180000.0,Commercial associate,Secondary / secondary special,Married,Municipal apartment,-14781,-2443,1,0,1,0,Laborers,2.0,-2,X
7366,5009272,M,N,N,0,180000.0,Commercial associate,Secondary / secondary special,Married,Municipal apartment,-14781,-2443,1,0,1,0,Laborers,2.0,-3,0
7367,5009272,M,N,N,0,180000.0,Commercial associate,Secondary / secondary special,Married,Municipal apartment,-14781,-2443,1,0,1,0,Laborers,2.0,-4,X
7368,5009272,M,N,N,0,180000.0,Commercial associate,Secondary / secondary special,Married,Municipal apartment,-14781,-2443,1,0,1,0,Laborers,2.0,-5,X
7369,5009272,M,N,N,0,180000.0,Commercial associate,Secondary / secondary special,Married,Municipal apartment,-14781,-2443,1,0,1,0,Laborers,2.0,-6,X
7370,5009272,M,N,N,0,180000.0,Commercial associate,Secondary / secondary special,Married,Municipal apartment,-14781,-2443,1,0,1,0,Laborers,2.0,-7,X
7371,5009272,M,N,N,0,180000.0,Commercial associate,Secondary / secondary special,Married,Municipal apartment,-14781,-2443,1,0,1,0,Laborers,2.0,-8,X
7372,5009272,M,N,N,0,180000.0,Commercial associate,Secondary / secondary special,Married,Municipal apartment,-14781,-2443,1,0,1,0,Laborers,2.0,-9,X
7373,5009272,M,N,N,0,180000.0,Commercial associate,Secondary / secondary special,Married,Municipal apartment,-14781,-2443,1,0,1,0,Laborers,2.0,-10,0
7374,5009272,M,N,N,0,180000.0,Commercial associate,Secondary / secondary special,Married,Municipal apartment,-14781,-2443,1,0,1,0,Laborers,2.0,-11,0
7375,5009272,M,N,N,0,180000.0,Commercial associate,Secondary / secondary special,Married,Municipal apartment,-14781,-2443,1,0,1,0,Laborers,2.0,-12,0
7376,5009272,M,N,N,0,180000.0,Commercial associate,Secondary / secondary special,Married,Municipal apartment,-14781,-2443,1,0,1,0,Laborers,2.0,-13,0
7377,5009272,M,N,N,0,180000.0,Commercial associate,Secondary / secondary special,Married,Municipal apartment,-14781,-2443,1,0,1,0,Laborers,2.0,-14,0
7378,5009272,M,N,N,0,180000.0,Commercial associate,Secondary / secondary special,Married,Municipal apartment,-14781,-2443,1,0,1,0,Laborers,2.0,-15,0
7379,5009272,M,N,N,0,180000.0,Commercial associate,Secondary / secondary special,Married,Municipal apartment,-14781,-2443,1,0,1,0,Laborers,2.0,-16,0
7380,5009272,M,N,N,0,180000.0,Commercial associate,Secondary / secondary special,Married,Municipal apartment,-14781,-2443,1,0,1,0,Laborers,2.0,-17,0
7381,5009272,M,N,N,0,180000.0,Commercial associate,Secondary / secondary special,Married,Municipal apartment,-14781,-2443,1,0,1,0,Laborers,2.0,-18,X
7382,5009272,M,N,N,0,180000.0,Commercial associate,Secondary / secondary special,Married,Municipal apartment,-14781,-2443,1,0,1,0,Laborers,2.0,-19,0
7383,5009272,M,N,N,0,180000.0,Commercial associate,Secondary / secondary special,Married,Municipal apartment,-14781,-2443,1,0,1,0,Laborers,2.0,-20,0
7384,5009272,M,N,N,0,180000.0,Commercial associate,Secondary / secondary special,Married,Municipal apartment,-14781,-2443,1,0,1,0,Laborers,2.0,-21,0
7385,5009272,M,N,N,0,180000.0,Commercial associate,Secondary / secondary special,Married,Municipal apartment,-14781,-2443,1,0,1,0,Laborers,2.0,-22,0
7386,5009272,M,N,N,0,180000.0,Commercial associate,Secondary / secondary special,Married,Municipal apartment,-14781,-2443,1,0,1,0,Laborers,2.0,-23,0
7387,5009272,M,N,N,0,180000.0,Commercial associate,Secondary / secondary special,Married,Municipal apartment,-14781,-2443,1,0,1,0,Laborers,2.0,-24,0
7388,5009272,M,N,N,0,180000.0,Commercial associate,Secondary / secondary special,Married,Municipal apartment,-14781,-2443,1,0,1,0,Laborers,2.0,-25,0
7389,5009274,M,N,N,0,180000.0,Commercial associate,Secondary / secondary special,Married,Municipal apartment,-14781,-2443,1,0,1,0,Laborers,2.0,-14,X
7390,5009274,M,N,N,0,180000.0,Commercial associate,Secondary / secondary special,Married,Municipal apartment,-14781,-2443,1,0,1,0,Laborers,2.0,-15,0
7391,5009274,M,N,N,0,180000.0,Commercial associate,Secondary / secondary special,Married,Municipal apartment,-14781,-2443,1,0,1,0,Laborers,2.0,-16,0
7392,5009274,M,N,N,0,180000.0,Commercial associate,Secondary / secondary special,Married,Municipal apartment,-14781,-2443,1,0,1,0,Laborers,2.0,-17,X
7393,5009274,M,N,N,0,180000.0,Commercial associate,Secondary / secondary special,Married,Municipal apartment,-14781,-2443,1,0,1,0,Laborers,2.0,-18,X
7394,5009274,M,N,N,0,180000.0,Commercial associate,Secondary / secondary special,Married,Municipal apartment,-14781,-2443,1,0,1,0,Laborers,2.0,-19,0
7395,5009274,M,N,N,0,180000.0,Commercial associate,Secondary / secondary special,Married,Municipal apartment,-14781,-2443,1,0,1,0,Laborers,2.0,-20,0
7396,5009274,M,N,N,0,180000.0,Commercial associate,Secondary / secondary special,Married,Municipal apartment,-14781,-2443,1,0,1,0,Laborers,2.0,-21,0
7397,5009274,M,N,N,0,180000.0,Commercial associate,Secondary / secondary special,Married,Municipal apartment,-14781,-2443,1,0,1,0,Laborers,2.0,-22,0
7398,5009274,M,N,N,0,180000.0,Commercial associate,Secondary / secondary special,Married,Municipal apartment,-14781,-2443,1,0,1,0,Laborers,2.0,-23,0
7399,5009274,M,N,N,0,180000.0,Commercial associate,Secondary / secondary special,Married,Municipal apartment,-14781,-2443,1,0,1,0,Laborers,2.0,-24,X
7400,5009274,M,N,N,0,180000.0,Commercial associate,Secondary / secondary special,Married,Municipal apartment,-14781,-2443,1,0,1,0,Laborers,2.0,-25,X
7401,5009274,M,N,N,0,180000.0,Commercial associate,Secondary / secondary special,Married,Municipal apartment,-14781,-2443,1,0,1,0,Laborers,2.0,-26,X
7402,5009274,M,N,N,0,180000.0,Commercial associate,Secondary / secondary special,Married,Municipal apartment,-14781,-2443,1,0,1,0,Laborers,2.0,-27,X
7403,5009274,M,N,N,0,180000.0,Commercial associate,Secondary / secondary special,Married,Municipal apartment,-14781,-2443,1,0,1,0,Laborers,2.0,-28,X
7404,5009274,M,N,N,0,180000.0,Commercial associate,Secondary / secondary special,Married,Municipal apartment,-14781,-2443,1,0,1,0,Laborers,2.0,-29,X
7405,5009274,M,N,N,0,180000.0,Commercial associate,Secondary / secondary special,Married,Municipal apartment,-14781,-2443,1,0,1,0,Laborers,2.0,-30,0
7406,5009274,M,N,N,0,180000.0,Commercial associate,Secondary / secondary special,Married,Municipal apartment,-14781,-2443,1,0,1,0,Laborers,2.0,-31,X
7407,5009274,M,N,N,0,180000.0,Commercial associate,Secondary / secondary special,Married,Municipal apartment,-14781,-2443,1,0,1,0,Laborers,2.0,-32,0
7408,5009274,M,N,N,0,180000.0,Commercial associate,Secondary / secondary special,Married,Municipal apartment,-14781,-2443,1,0,1,0,Laborers,2.0,-33,X
7409,5009274,M,N,N,0,180000.0,Commercial associate,Secondary / secondary special,Married,Municipal apartment,-14781,-2443,1,0,1,0,Laborers,2.0,-34,X
7410,5009274,M,N,N,0,180000.0,Commercial associate,Secondary / secondary special,Married,Municipal apartment,-14781,-2443,1,0,1,0,Laborers,2.0,-35,X
7411,5009274,M,N,N,0,180000.0,Commercial associate,Secondary / secondary special,Married,Municipal apartment,-14781,-2443,1,0,1,0,Laborers,2.0,-36,X
7412,5009274,M,N,N,0,180000.0,Commercial associate,Secondary / secondary special,Married,Municipal apartment,-14781,-2443,1,0,1,0,Laborers,2.0,-37,X
7413,5009274,M,N,N,0,180000.0,Commercial associate,Secondary / secondary special,Married,Municipal apartment,-14781,-2443,1,0,1,0,Laborers,2.0,-38,X
7414,5009274,M,N,N,0,180000.0,Commercial associate,Secondary / secondary special,Married,Municipal apartment,-14781,-2443,1,0,1,0,Laborers,2.0,-39,0
7415,5009274,M,N,N,0,180000.0,Commercial associate,Secondary / secondary special,Married,Municipal apartment,-14781,-2443,1,0,1,0,Laborers,2.0,-40,0
7416,5009274,M,N,N,0,180000.0,Commercial associate,Secondary / secondary special,Married,Municipal apartment,-14781,-2443,1,0,1,0,Laborers,2.0,-41,0
7417,5009274,M,N,N,0,180000.0,Commercial associate,Secondary / secondary special,Married,Municipal apartment,-14781,-2443,1,0,1,0,Laborers,2.0,-42,0
7418,5009274,M,N,N,0,180000.0,Commercial associate,Secondary / secondary special,Married,Municipal apartment,-14781,-2443,1,0,1,0,Laborers,2.0,-43,0
7419,5009274,M,N,N,0,180000.0,Commercial associate,Secondary / secondary special,Married,Municipal apartment,-14781,-2443,1,0,1,0,Laborers,2.0,-44,0
7420,5009274,M,N,N,0,180000.0,Commercial associate,Secondary / secondary special,Married,Municipal apartment,-14781,-2443,1,0,1,0,Laborers,2.0,-45,0
7421,5009274,M,N,N,0,180000.0,Commercial associate,Secondary / secondary special,Married,Municipal apartment,-14781,-2443,1,0,1,0,Laborers,2.0,-46,0
7422,5009274,M,N,N,0,180000.0,Commercial associate,Secondary / secondary special,Married,Municipal apartment,-14781,-2443,1,0,1,0,Laborers,2.0,-47,X
7423,5009274,M,N,N,0,180000.0,Commercial associate,Secondary / secondary special,Married,Municipal apartment,-14781,-2443,1,0,1,0,Laborers,2.0,-48,0
7424,5009274,M,N,N,0,180000.0,Commercial associate,Secondary / secondary special,Married,Municipal apartment,-14781,-2443,1,0,1,0,Laborers,2.0,-49,0
7425,5009274,M,N,N,0,180000.0,Commercial associate,Secondary / secondary special,Married,Municipal apartment,-14781,-2443,1,0,1,0,Laborers,2.0,-50,0
7426,5009274,M,N,N,0,180000.0,Commercial associate,Secondary / secondary special,Married,Municipal apartment,-14781,-2443,1,0,1,0,Laborers,2.0,-51,0
7427,5009274,M,N,N,0,180000.0,Commercial associate,Secondary / secondary special,Married,Municipal apartment,-14781,-2443,1,0,1,0,Laborers,2.0,-52,0
7428,5009274,M,N,N,0,180000.0,Commercial associate,Secondary / secondary special,Married,Municipal apartment,-14781,-2443,1,0,1,0,Laborers,2.0,-53,0
7429,5009274,M,N,N,0,180000.0,Commercial associate,Secondary / secondary special,Married,Municipal apartment,-14781,-2443,1,0,1,0,Laborers,2.0,-54,0
7430,5009275,M,N,N,0,180000.0,Commercial associate,Secondary / secondary special,Married,Municipal apartment,-14781,-2443,1,0,1,0,Laborers,2.0,0,X
7431,5009275,M,N,N,0,180000.0,Commercial associate,Secondary / secondary special,Married,Municipal apartment,-14781,-2443,1,0,1,0,Laborers,2.0,-1,X
7432,5009275,M,N,N,0,180000.0,Commercial associate,Secondary / secondary special,Married,Municipal apartment,-14781,-2443,1,0,1,0,Laborers,2.0,-2,X
7433,5009275,M,N,N,0,180000.0,Commercial associate,Secondary / secondary special,Married,Municipal apartment,-14781,-2443,1,0,1,0,Laborers,2.0,-3,X
7434,5009275,M,N,N,0,180000.0,Commercial associate,Secondary / secondary special,Married,Municipal apartment,-14781,-2443,1,0,1,0,Laborers,2.0,-4,X
7435,5009275,M,N,N,0,180000.0,Commercial associate,Secondary / secondary special,Married,Municipal apartment,-14781,-2443,1,0,1,0,Laborers,2.0,-5,X
7436,5009275,M,N,N,0,180000.0,Commercial associate,Secondary / secondary special,Married,Municipal apartment,-14781,-2443,1,0,1,0,Laborers,2.0,-6,X
7437,5009275,M,N,N,0,180000.0,Commercial associate,Secondary / secondary special,Married,Municipal apartment,-14781,-2443,1,0,1,0,Laborers,2.0,-7,X
7438,5009275,M,N,N,0,180000.0,Commercial associate,Secondary / secondary special,Married,Municipal apartment,-14781,-2443,1,0,1,0,Laborers,2.0,-8,X
7439,5009275,M,N,N,0,180000.0,Commercial associate,Secondary / secondary special,Married,Municipal apartment,-14781,-2443,1,0,1,0,Laborers,2.0,-9,X
7440,5009275,M,N,N,0,180000.0,Commercial associate,Secondary / secondary special,Married,Municipal apartment,-14781,-2443,1,0,1,0,Laborers,2.0,-10,X
7441,5009275,M,N,N,0,180000.0,Commercial associate,Secondary / secondary special,Married,Municipal apartment,-14781,-2443,1,0,1,0,Laborers,2.0,-11,X
7442,5009275,M,N,N,0,180000.0,Commercial associate,Secondary / secondary special,Married,Municipal apartment,-14781,-2443,1,0,1,0,Laborers,2.0,-12,X
7443,5009275,M,N,N,0,180000.0,Commercial associate,Secondary / secondary special,Married,Municipal apartment,-14781,-2443,1,0,1,0,Laborers,2.0,-13,X
7444,5009275,M,N,N,0,180000.0,Commercial associate,Secondary / secondary special,Married,Municipal apartment,-14781,-2443,1,0,1,0,Laborers,2.0,-14,X
7445,5009275,M,N,N,0,180000.0,Commercial associate,Secondary / secondary special,Married,Municipal apartment,-14781,-2443,1,0,1,0,Laborers,2.0,-15,X
7446,5009275,M,N,N,0,180000.0,Commercial associate,Secondary / secondary special,Married,Municipal apartment,-14781,-2443,1,0,1,0,Laborers,2.0,-16,X
7447,5009275,M,N,N,0,180000.0,Commercial associate,Secondary / secondary special,Married,Municipal apartment,-14781,-2443,1,0,1,0,Laborers,2.0,-17,X
7448,5009275,M,N,N,0,180000.0,Commercial associate,Secondary / secondary special,Married,Municipal apartment,-14781,-2443,1,0,1,0,Laborers,2.0,-18,X
7449,5009275,M,N,N,0,180000.0,Commercial associate,Secondary / secondary special,Married,Municipal apartment,-14781,-2443,1,0,1,0,Laborers,2.0,-19,X
7450,5009275,M,N,N,0,180000.0,Commercial associate,Secondary / secondary special,Married,Municipal apartment,-14781,-2443,1,0,1,0,Laborers,2.0,-20,X
7451,5009275,M,N,N,0,180000.0,Commercial associate,Secondary / secondary special,Married,Municipal apartment,-14781,-2443,1,0,1,0,Laborers,2.0,-21,X
7452,5009275,M,N,N,0,180000.0,Commercial associate,Secondary / secondary special,Married,Municipal apartment,-14781,-2443,1,0,1,0,Laborers,2.0,-22,X
7453,5009275,M,N,N,0,180000.0,Commercial associate,Secondary / secondary special,Married,Municipal apartment,-14781,-2443,1,0,1,0,Laborers,2.0,-23,X
7454,5009275,M,N,N,0,180000.0,Commercial associate,Secondary / secondary special,Married,Municipal apartment,-14781,-2443,1,0,1,0,Laborers,2.0,-24,X
7455,5009275,M,N,N,0,180000.0,Commercial associate,Secondary / secondary special,Married,Municipal apartment,-14781,-2443,1,0,1,0,Laborers,2.0,-25,X
7456,5009275,M,N,N,0,180000.0,Commercial associate,Secondary / secondary special,Married,Municipal apartment,-14781,-2443,1,0,1,0,Laborers,2.0,-26,X
7457,5009275,M,N,N,0,180000.0,Commercial associate,Secondary / secondary special,Married,Municipal apartment,-14781,-2443,1,0,1,0,Laborers,2.0,-27,X
7458,5009275,M,N,N,0,180000.0,Commercial associate,Secondary / secondary special,Married,Municipal apartment,-14781,-2443,1,0,1,0,Laborers,2.0,-28,X
7459,5009275,M,N,N,0,180000.0,Commercial associate,Secondary / secondary special,Married,Municipal apartment,-14781,-2443,1,0,1,0,Laborers,2.0,-29,0
7460,5009276,M,N,N,0,180000.0,Commercial associate,Secondary / secondary special,Married,Municipal apartment,-14781,-2443,1,0,1,0,Laborers,2.0,0,0
7461,5009276,M,N,N,0,180000.0,Commercial associate,Secondary / secondary special,Married,Municipal apartment,-14781,-2443,1,0,1,0,Laborers,2.0,-1,0
7462,5009276,M,N,N,0,180000.0,Commercial associate,Secondary / secondary special,Married,Municipal apartment,-14781,-2443,1,0,1,0,Laborers,2.0,-2,0
7463,5009276,M,N,N,0,180000.0,Commercial associate,Secondary / secondary special,Married,Municipal apartment,-14781,-2443,1,0,1,0,Laborers,2.0,-3,0
7464,5009276,M,N,N,0,180000.0,Commercial associate,Secondary / secondary special,Married,Municipal apartment,-14781,-2443,1,0,1,0,Laborers,2.0,-4,0
7465,5009276,M,N,N,0,180000.0,Commercial associate,Secondary / secondary special,Married,Municipal apartment,-14781,-2443,1,0,1,0,Laborers,2.0,-5,0
7466,5009276,M,N,N,0,180000.0,Commercial associate,Secondary / secondary special,Married,Municipal apartment,-14781,-2443,1,0,1,0,Laborers,2.0,-6,0
7467,5009276,M,N,N,0,180000.0,Commercial associate,Secondary / secondary special,Married,Municipal apartment,-14781,-2443,1,0,1,0,Laborers,2.0,-7,0
7468,5009276,M,N,N,0,180000.0,Commercial associate,Secondary / secondary special,Married,Municipal apartment,-14781,-2443,1,0,1,0,Laborers,2.0,-8,0
7469,5009276,M,N,N,0,180000.0,Commercial associate,Secondary / secondary special,Married,Municipal apartment,-14781,-2443,1,0,1,0,Laborers,2.0,-9,0
7470,5009276,M,N,N,0,180000.0,Commercial associate,Secondary / secondary special,Married,Municipal apartment,-14781,-2443,1,0,1,0,Laborers,2.0,-10,0
7471,5009276,M,N,N,0,180000.0,Commercial associate,Secondary / secondary special,Married,Municipal apartment,-14781,-2443,1,0,1,0,Laborers,2.0,-11,0
7472,5009276,M,N,N,0,180000.0,Commercial associate,Secondary / secondary special,Married,Municipal apartment,-14781,-2443,1,0,1,0,Laborers,2.0,-12,0
7473,5009276,M,N,N,0,180000.0,Commercial associate,Secondary / secondary special,Married,Municipal apartment,-14781,-2443,1,0,1,0,Laborers,2.0,-13,0
7474,5009276,M,N,N,0,180000.0,Commercial associate,Secondary / secondary special,Married,Municipal apartment,-14781,-2443,1,0,1,0,Laborers,2.0,-14,X
7475,5009276,M,N,N,0,180000.0,Commercial associate,Secondary / secondary special,Married,Municipal apartment,-14781,-2443,1,0,1,0,Laborers,2.0,-15,X
7476,5009277,M,N,N,0,180000.0,Commercial associate,Secondary / secondary special,Married,Municipal apartment,-14781,-2443,1,0,1,0,Laborers,2.0,-3,X
7477,5009277,M,N,N,0,180000.0,Commercial associate,Secondary / secondary special,Married,Municipal apartment,-14781,-2443,1,0,1,0,Laborers,2.0,-4,0
7478,5009277,M,N,N,0,180000.0,Commercial associate,Secondary / secondary special,Married,Municipal apartment,-14781,-2443,1,0,1,0,Laborers,2.0,-5,0
7479,5009277,M,N,N,0,180000.0,Commercial associate,Secondary / secondary special,Married,Municipal apartment,-14781,-2443,1,0,1,0,Laborers,2.0,-6,0
7480,5009277,M,N,N,0,180000.0,Commercial associate,Secondary / secondary special,Married,Municipal apartment,-14781,-2443,1,0,1,0,Laborers,2.0,-7,0
7481,5009277,M,N,N,0,180000.0,Commercial associate,Secondary / secondary special,Married,Municipal apartment,-14781,-2443,1,0,1,0,Laborers,2.0,-8,0
7482,5009277,M,N,N,0,180000.0,Commercial associate,Secondary / secondary special,Married,Municipal apartment,-14781,-2443,1,0,1,0,Laborers,2.0,-9,0
7483,5009277,M,N,N,0,180000.0,Commercial associate,Secondary / secondary special,Married,Municipal apartment,-14781,-2443,1,0,1,0,Laborers,2.0,-10,X
7484,5009277,M,N,N,0,180000.0,Commercial associate,Secondary / secondary special,Married,Municipal apartment,-14781,-2443,1,0,1,0,Laborers,2.0,-11,0
7485,5009277,M,N,N,0,180000.0,Commercial associate,Secondary / secondary special,Married,Municipal apartment,-14781,-2443,1,0,1,0,Laborers,2.0,-12,0
7486,5009277,M,N,N,0,180000.0,Commercial associate,Secondary / secondary special,Married,Municipal apartment,-14781,-2443,1,0,1,0,Laborers,2.0,-13,X
7487,5009277,M,N,N,0,180000.0,Commercial associate,Secondary / secondary special,Married,Municipal apartment,-14781,-2443,1,0,1,0,Laborers,2.0,-14,0
7488,5009277,M,N,N,0,180000.0,Commercial associate,Secondary / secondary special,Married,Municipal apartment,-14781,-2443,1,0,1,0,Laborers,2.0,-15,X
7489,5009277,M,N,N,0,180000.0,Commercial associate,Secondary / secondary special,Married,Municipal apartment,-14781,-2443,1,0,1,0,Laborers,2.0,-16,0
7490,5009277,M,N,N,0,180000.0,Commercial associate,Secondary / secondary special,Married,Municipal apartment,-14781,-2443,1,0,1,0,Laborers,2.0,-17,X
7491,5009277,M,N,N,0,180000.0,Commercial associate,Secondary / secondary special,Married,Municipal apartment,-14781,-2443,1,0,1,0,Laborers,2.0,-18,0
7492,5009277,M,N,N,0,180000.0,Commercial associate,Secondary / secondary special,Married,Municipal apartment,-14781,-2443,1,0,1,0,Laborers,2.0,-19,X
7493,5009277,M,N,N,0,180000.0,Commercial associate,Secondary / secondary special,Married,Municipal apartment,-14781,-2443,1,0,1,0,Laborers,2.0,-20,0
7494,5009277,M,N,N,0,180000.0,Commercial associate,Secondary / secondary special,Married,Municipal apartment,-14781,-2443,1,0,1,0,Laborers,2.0,-21,0
7495,5009277,M,N,N,0,180000.0,Commercial associate,Secondary / secondary special,Married,Municipal apartment,-14781,-2443,1,0,1,0,Laborers,2.0,-22,0
7496,5009277,M,N,N,0,180000.0,Commercial associate,Secondary / secondary special,Married,Municipal apartment,-14781,-2443,1,0,1,0,Laborers,2.0,-23,X
7497,5009277,M,N,N,0,180000.0,Commercial associate,Secondary / secondary special,Married,Municipal apartment,-14781,-2443,1,0,1,0,Laborers,2.0,-24,0
7498,5009277,M,N,N,0,180000.0,Commercial associate,Secondary / secondary special,Married,Municipal apartment,-14781,-2443,1,0,1,0,Laborers,2.0,-25,0
7499,5009277,M,N,N,0,180000.0,Commercial associate,Secondary / secondary special,Married,Municipal apartment,-14781,-2443,1,0,1,0,Laborers,2.0,-26,0
7500,5009277,M,N,N,0,180000.0,Commercial associate,Secondary / secondary special,Married,Municipal apartment,-14781,-2443,1,0,1,0,Laborers,2.0,-27,X
7501,5009277,M,N,N,0,180000.0,Commercial associate,Secondary / secondary special,Married,Municipal apartment,-14781,-2443,1,0,1,0,Laborers,2.0,-28,0
7502,5009277,M,N,N,0,180000.0,Commercial associate,Secondary / secondary special,Married,Municipal apartment,-14781,-2443,1,0,1,0,Laborers,2.0,-29,X
7503,5009278,F,N,N,0,130500.0,Working,Secondary / secondary special,Civil marriage,House / apartment,-15140,-4816,1,0,1,0,Cleaning staff,2.0,0,C
7504,5009278,F,N,N,0,130500.0,Working,Secondary / secondary special,Civil marriage,House / apartment,-15140,-4816,1,0,1,0,Cleaning staff,2.0,-1,C
7505,5009278,F,N,N,0,130500.0,Working,Secondary / secondary special,Civil marriage,House / apartment,-15140,-4816,1,0,1,0,Cleaning staff,2.0,-2,C
7506,5009278,F,N,N,0,130500.0,Working,Secondary / secondary special,Civil marriage,House / apartment,-15140,-4816,1,0,1,0,Cleaning staff,2.0,-3,C
7507,5009278,F,N,N,0,130500.0,Working,Secondary / secondary special,Civil marriage,House / apartment,-15140,-4816,1,0,1,0,Cleaning staff,2.0,-4,0
7508,5009278,F,N,N,0,130500.0,Working,Secondary / secondary special,Civil marriage,House / apartment,-15140,-4816,1,0,1,0,Cleaning staff,2.0,-5,X
7509,5009278,F,N,N,0,130500.0,Working,Secondary / secondary special,Civil marriage,House / apartment,-15140,-4816,1,0,1,0,Cleaning staff,2.0,-6,X
7510,5009278,F,N,N,0,130500.0,Working,Secondary / secondary special,Civil marriage,House / apartment,-15140,-4816,1,0,1,0,Cleaning staff,2.0,-7,X
7511,5009278,F,N,N,0,130500.0,Working,Secondary / secondary special,Civil marriage,House / apartment,-15140,-4816,1,0,1,0,Cleaning staff,2.0,-8,X
7512,5009278,F,N,N,0,130500.0,Working,Secondary / secondary special,Civil marriage,House / apartment,-15140,-4816,1,0,1,0,Cleaning staff,2.0,-9,X
7513,5009278,F,N,N,0,130500.0,Working,Secondary / secondary special,Civil marriage,House / apartment,-15140,-4816,1,0,1,0,Cleaning staff,2.0,-10,X
7514,5009278,F,N,N,0,130500.0,Working,Secondary / secondary special,Civil marriage,House / apartment,-15140,-4816,1,0,1,0,Cleaning staff,2.0,-11,X
7515,5009278,F,N,N,0,130500.0,Working,Secondary / secondary special,Civil marriage,House / apartment,-15140,-4816,1,0,1,0,Cleaning staff,2.0,-12,X
7516,5009278,F,N,N,0,130500.0,Working,Secondary / secondary special,Civil marriage,House / apartment,-15140,-4816,1,0,1,0,Cleaning staff,2.0,-13,X
7517,5009278,F,N,N,0,130500.0,Working,Secondary / secondary special,Civil marriage,House / apartment,-15140,-4816,1,0,1,0,Cleaning staff,2.0,-14,X
7518,5009278,F,N,N,0,130500.0,Working,Secondary / secondary special,Civil marriage,House / apartment,-15140,-4816,1,0,1,0,Cleaning staff,2.0,-15,X
7519,5009278,F,N,N,0,130500.0,Working,Secondary / secondary special,Civil marriage,House / apartment,-15140,-4816,1,0,1,0,Cleaning staff,2.0,-16,X
7520,5009278,F,N,N,0,130500.0,Working,Secondary / secondary special,Civil marriage,House / apartment,-15140,-4816,1,0,1,0,Cleaning staff,2.0,-17,X
7521,5009278,F,N,N,0,130500.0,Working,Secondary / secondary special,Civil marriage,House / apartment,-15140,-4816,1,0,1,0,Cleaning staff,2.0,-18,X
7522,5009278,F,N,N,0,130500.0,Working,Secondary / secondary special,Civil marriage,House / apartment,-15140,-4816,1,0,1,0,Cleaning staff,2.0,-19,X
7523,5009278,F,N,N,0,130500.0,Working,Secondary / secondary special,Civil marriage,House / apartment,-15140,-4816,1,0,1,0,Cleaning staff,2.0,-20,X
7524,5009279,F,N,N,0,130500.0,Working,Secondary / secondary special,Civil marriage,House / apartment,-15140,-4816,1,0,1,0,Cleaning staff,2.0,-4,X
7525,5009279,F,N,N,0,130500.0,Working,Secondary / secondary special,Civil marriage,House / apartment,-15140,-4816,1,0,1,0,Cleaning staff,2.0,-5,0
7526,5009279,F,N,N,0,130500.0,Working,Secondary / secondary special,Civil marriage,House / apartment,-15140,-4816,1,0,1,0,Cleaning staff,2.0,-6,0
7527,5009279,F,N,N,0,130500.0,Working,Secondary / secondary special,Civil marriage,House / apartment,-15140,-4816,1,0,1,0,Cleaning staff,2.0,-7,0
7528,5009279,F,N,N,0,130500.0,Working,Secondary / secondary special,Civil marriage,House / apartment,-15140,-4816,1,0,1,0,Cleaning staff,2.0,-8,0
7529,5009279,F,N,N,0,130500.0,Working,Secondary / secondary special,Civil marriage,House / apartment,-15140,-4816,1,0,1,0,Cleaning staff,2.0,-9,0
7530,5009279,F,N,N,0,130500.0,Working,Secondary / secondary special,Civil marriage,House / apartment,-15140,-4816,1,0,1,0,Cleaning staff,2.0,-10,X
7531,5009279,F,N,N,0,130500.0,Working,Secondary / secondary special,Civil marriage,House / apartment,-15140,-4816,1,0,1,0,Cleaning staff,2.0,-11,0
7532,5009279,F,N,N,0,130500.0,Working,Secondary / secondary special,Civil marriage,House / apartment,-15140,-4816,1,0,1,0,Cleaning staff,2.0,-12,0
7533,5009279,F,N,N,0,130500.0,Working,Secondary / secondary special,Civil marriage,House / apartment,-15140,-4816,1,0,1,0,Cleaning staff,2.0,-13,X
7534,5009279,F,N,N,0,130500.0,Working,Secondary / secondary special,Civil marriage,House / apartment,-15140,-4816,1,0,1,0,Cleaning staff,2.0,-14,0
7535,5009279,F,N,N,0,130500.0,Working,Secondary / secondary special,Civil marriage,House / apartment,-15140,-4816,1,0,1,0,Cleaning staff,2.0,-15,0
7536,5009279,F,N,N,0,130500.0,Working,Secondary / secondary special,Civil marriage,House / apartment,-15140,-4816,1,0,1,0,Cleaning staff,2.0,-16,0
7537,5009279,F,N,N,0,130500.0,Working,Secondary / secondary special,Civil marriage,House / apartment,-15140,-4816,1,0,1,0,Cleaning staff,2.0,-17,X
7538,5009279,F,N,N,0,130500.0,Working,Secondary / secondary special,Civil marriage,House / apartment,-15140,-4816,1,0,1,0,Cleaning staff,2.0,-18,0
7539,5009279,F,N,N,0,130500.0,Working,Secondary / secondary special,Civil marriage,House / apartment,-15140,-4816,1,0,1,0,Cleaning staff,2.0,-19,X
7540,5009279,F,N,N,0,130500.0,Working,Secondary / secondary special,Civil marriage,House / apartment,-15140,-4816,1,0,1,0,Cleaning staff,2.0,-20,0
7541,5009279,F,N,N,0,130500.0,Working,Secondary / secondary special,Civil marriage,House / apartment,-15140,-4816,1,0,1,0,Cleaning staff,2.0,-21,0
7542,5009279,F,N,N,0,130500.0,Working,Secondary / secondary special,Civil marriage,House / apartment,-15140,-4816,1,0,1,0,Cleaning staff,2.0,-22,X
7543,5009279,F,N,N,0,130500.0,Working,Secondary / secondary special,Civil marriage,House / apartment,-15140,-4816,1,0,1,0,Cleaning staff,2.0,-23,X
7544,5009279,F,N,N,0,130500.0,Working,Secondary / secondary special,Civil marriage,House / apartment,-15140,-4816,1,0,1,0,Cleaning staff,2.0,-24,0
7545,5009279,F,N,N,0,130500.0,Working,Secondary / secondary special,Civil marriage,House / apartment,-15140,-4816,1,0,1,0,Cleaning staff,2.0,-25,0
7546,5009279,F,N,N,0,130500.0,Working,Secondary / secondary special,Civil marriage,House / apartment,-15140,-4816,1,0,1,0,Cleaning staff,2.0,-26,X
7547,5009279,F,N,N,0,130500.0,Working,Secondary / secondary special,Civil marriage,House / apartment,-15140,-4816,1,0,1,0,Cleaning staff,2.0,-27,0
7548,5009279,F,N,N,0,130500.0,Working,Secondary / secondary special,Civil marriage,House / apartment,-15140,-4816,1,0,1,0,Cleaning staff,2.0,-28,X
7549,5009279,F,N,N,0,130500.0,Working,Secondary / secondary special,Civil marriage,House / apartment,-15140,-4816,1,0,1,0,Cleaning staff,2.0,-29,0
7550,5009279,F,N,N,0,130500.0,Working,Secondary / secondary special,Civil marriage,House / apartment,-15140,-4816,1,0,1,0,Cleaning staff,2.0,-30,X
7551,5009279,F,N,N,0,130500.0,Working,Secondary / secondary special,Civil marriage,House / apartment,-15140,-4816,1,0,1,0,Cleaning staff,2.0,-31,X
7552,5009279,F,N,N,0,130500.0,Working,Secondary / secondary special,Civil marriage,House / apartment,-15140,-4816,1,0,1,0,Cleaning staff,2.0,-32,X
7553,5009279,F,N,N,0,130500.0,Working,Secondary / secondary special,Civil marriage,House / apartment,-15140,-4816,1,0,1,0,Cleaning staff,2.0,-33,0
7554,5009279,F,N,N,0,130500.0,Working,Secondary / secondary special,Civil marriage,House / apartment,-15140,-4816,1,0,1,0,Cleaning staff,2.0,-34,0
7555,5009279,F,N,N,0,130500.0,Working,Secondary / secondary special,Civil marriage,House / apartment,-15140,-4816,1,0,1,0,Cleaning staff,2.0,-35,0
7556,5009279,F,N,N,0,130500.0,Working,Secondary / secondary special,Civil marriage,House / apartment,-15140,-4816,1,0,1,0,Cleaning staff,2.0,-36,X
7557,5009279,F,N,N,0,130500.0,Working,Secondary / secondary special,Civil marriage,House / apartment,-15140,-4816,1,0,1,0,Cleaning staff,2.0,-37,0
7558,5009279,F,N,N,0,130500.0,Working,Secondary / secondary special,Civil marriage,House / apartment,-15140,-4816,1,0,1,0,Cleaning staff,2.0,-38,0
7559,5009279,F,N,N,0,130500.0,Working,Secondary / secondary special,Civil marriage,House / apartment,-15140,-4816,1,0,1,0,Cleaning staff,2.0,-39,0
7560,5009279,F,N,N,0,130500.0,Working,Secondary / secondary special,Civil marriage,House / apartment,-15140,-4816,1,0,1,0,Cleaning staff,2.0,-40,X
7561,5009279,F,N,N,0,130500.0,Working,Secondary / secondary special,Civil marriage,House / apartment,-15140,-4816,1,0,1,0,Cleaning staff,2.0,-41,0
7562,5009279,F,N,N,0,130500.0,Working,Secondary / secondary special,Civil marriage,House / apartment,-15140,-4816,1,0,1,0,Cleaning staff,2.0,-42,X
7563,5009279,F,N,N,0,130500.0,Working,Secondary / secondary special,Civil marriage,House / apartment,-15140,-4816,1,0,1,0,Cleaning staff,2.0,-43,X
7564,5009279,F,N,N,0,130500.0,Working,Secondary / secondary special,Civil marriage,House / apartment,-15140,-4816,1,0,1,0,Cleaning staff,2.0,-44,X
7565,5009280,F,N,N,0,130500.0,Working,Secondary / secondary special,Civil marriage,House / apartment,-15140,-4816,1,0,1,0,Cleaning staff,2.0,0,C
7566,5009280,F,N,N,0,130500.0,Working,Secondary / secondary special,Civil marriage,House / apartment,-15140,-4816,1,0,1,0,Cleaning staff,2.0,-1,C
7567,5009280,F,N,N,0,130500.0,Working,Secondary / secondary special,Civil marriage,House / apartment,-15140,-4816,1,0,1,0,Cleaning staff,2.0,-2,C
7568,5009280,F,N,N,0,130500.0,Working,Secondary / secondary special,Civil marriage,House / apartment,-15140,-4816,1,0,1,0,Cleaning staff,2.0,-3,C
7569,5009280,F,N,N,0,130500.0,Working,Secondary / secondary special,Civil marriage,House / apartment,-15140,-4816,1,0,1,0,Cleaning staff,2.0,-4,C
7570,5009280,F,N,N,0,130500.0,Working,Secondary / secondary special,Civil marriage,House / apartment,-15140,-4816,1,0,1,0,Cleaning staff,2.0,-5,C
7571,5009280,F,N,N,0,130500.0,Working,Secondary / secondary special,Civil marriage,House / apartment,-15140,-4816,1,0,1,0,Cleaning staff,2.0,-6,C
7572,5009280,F,N,N,0,130500.0,Working,Secondary / secondary special,Civil marriage,House / apartment,-15140,-4816,1,0,1,0,Cleaning staff,2.0,-7,C
7573,5009280,F,N,N,0,130500.0,Working,Secondary / secondary special,Civil marriage,House / apartment,-15140,-4816,1,0,1,0,Cleaning staff,2.0,-8,C
7574,5009280,F,N,N,0,130500.0,Working,Secondary / secondary special,Civil marriage,House / apartment,-15140,-4816,1,0,1,0,Cleaning staff,2.0,-9,C
7575,5009280,F,N,N,0,130500.0,Working,Secondary / secondary special,Civil marriage,House / apartment,-15140,-4816,1,0,1,0,Cleaning staff,2.0,-10,C
7576,5009280,F,N,N,0,130500.0,Working,Secondary / secondary special,Civil marriage,House / apartment,-15140,-4816,1,0,1,0,Cleaning staff,2.0,-11,C
7577,5009280,F,N,N,0,130500.0,Working,Secondary / secondary special,Civil marriage,House / apartment,-15140,-4816,1,0,1,0,Cleaning staff,2.0,-12,C
7578,5009280,F,N,N,0,130500.0,Working,Secondary / secondary special,Civil marriage,House / apartment,-15140,-4816,1,0,1,0,Cleaning staff,2.0,-13,C
7579,5009280,F,N,N,0,130500.0,Working,Secondary / secondary special,Civil marriage,House / apartment,-15140,-4816,1,0,1,0,Cleaning staff,2.0,-14,C
7580,5009280,F,N,N,0,130500.0,Working,Secondary / secondary special,Civil marriage,House / apartment,-15140,-4816,1,0,1,0,Cleaning staff,2.0,-15,C
7581,5009280,F,N,N,0,130500.0,Working,Secondary / secondary special,Civil marriage,House / apartment,-15140,-4816,1,0,1,0,Cleaning staff,2.0,-16,C
7582,5009280,F,N,N,0,130500.0,Working,Secondary / secondary special,Civil marriage,House / apartment,-15140,-4816,1,0,1,0,Cleaning staff,2.0,-17,C
7583,5009280,F,N,N,0,130500.0,Working,Secondary / secondary special,Civil marriage,House / apartment,-15140,-4816,1,0,1,0,Cleaning staff,2.0,-18,X
7584,5009280,F,N,N,0,130500.0,Working,Secondary / secondary special,Civil marriage,House / apartment,-15140,-4816,1,0,1,0,Cleaning staff,2.0,-19,0
7585,5009280,F,N,N,0,130500.0,Working,Secondary / secondary special,Civil marriage,House / apartment,-15140,-4816,1,0,1,0,Cleaning staff,2.0,-20,0
7586,5009280,F,N,N,0,130500.0,Working,Secondary / secondary special,Civil marriage,House / apartment,-15140,-4816,1,0,1,0,Cleaning staff,2.0,-21,0
7587,5009280,F,N,N,0,130500.0,Working,Secondary / secondary special,Civil marriage,House / apartment,-15140,-4816,1,0,1,0,Cleaning staff,2.0,-22,0
7588,5009280,F,N,N,0,130500.0,Working,Secondary / secondary special,Civil marriage,House / apartment,-15140,-4816,1,0,1,0,Cleaning staff,2.0,-23,0
7589,5009280,F,N,N,0,130500.0,Working,Secondary / secondary special,Civil marriage,House / apartment,-15140,-4816,1,0,1,0,Cleaning staff,2.0,-24,0
7590,5009280,F,N,N,0,130500.0,Working,Secondary / secondary special,Civil marriage,House / apartment,-15140,-4816,1,0,1,0,Cleaning staff,2.0,-25,0
7591,5009280,F,N,N,0,130500.0,Working,Secondary / secondary special,Civil marriage,House / apartment,-15140,-4816,1,0,1,0,Cleaning staff,2.0,-26,0
7592,5009280,F,N,N,0,130500.0,Working,Secondary / secondary special,Civil marriage,House / apartment,-15140,-4816,1,0,1,0,Cleaning staff,2.0,-27,0
7593,5009280,F,N,N,0,130500.0,Working,Secondary / secondary special,Civil marriage,House / apartment,-15140,-4816,1,0,1,0,Cleaning staff,2.0,-28,0
7594,5009280,F,N,N,0,130500.0,Working,Secondary / secondary special,Civil marriage,House / apartment,-15140,-4816,1,0,1,0,Cleaning staff,2.0,-29,0
7595,5009280,F,N,N,0,130500.0,Working,Secondary / secondary special,Civil marriage,House / apartment,-15140,-4816,1,0,1,0,Cleaning staff,2.0,-30,0
7596,5009280,F,N,N,0,130500.0,Working,Secondary / secondary special,Civil marriage,House / apartment,-15140,-4816,1,0,1,0,Cleaning staff,2.0,-31,0
7597,5009280,F,N,N,0,130500.0,Working,Secondary / secondary special,Civil marriage,House / apartment,-15140,-4816,1,0,1,0,Cleaning staff,2.0,-32,0
7598,5009280,F,N,N,0,130500.0,Working,Secondary / secondary special,Civil marriage,House / apartment,-15140,-4816,1,0,1,0,Cleaning staff,2.0,-33,0
7599,5009280,F,N,N,0,130500.0,Working,Secondary / secondary special,Civil marriage,House / apartment,-15140,-4816,1,0,1,0,Cleaning staff,2.0,-34,0
7600,5009280,F,N,N,0,130500.0,Working,Secondary / secondary special,Civil marriage,House / apartment,-15140,-4816,1,0,1,0,Cleaning staff,2.0,-35,0
7601,5009280,F,N,N,0,130500.0,Working,Secondary / secondary special,Civil marriage,House / apartment,-15140,-4816,1,0,1,0,Cleaning staff,2.0,-36,0
7602,5009280,F,N,N,0,130500.0,Working,Secondary / secondary special,Civil marriage,House / apartment,-15140,-4816,1,0,1,0,Cleaning staff,2.0,-37,0
7603,5009280,F,N,N,0,130500.0,Working,Secondary / secondary special,Civil marriage,House / apartment,-15140,-4816,1,0,1,0,Cleaning staff,2.0,-38,0
7604,5009280,F,N,N,0,130500.0,Working,Secondary / secondary special,Civil marriage,House / apartment,-15140,-4816,1,0,1,0,Cleaning staff,2.0,-39,0
7605,5009280,F,N,N,0,130500.0,Working,Secondary / secondary special,Civil marriage,House / apartment,-15140,-4816,1,0,1,0,Cleaning staff,2.0,-40,X
7606,5009281,F,N,N,0,130500.0,Working,Secondary / secondary special,Civil marriage,House / apartment,-15140,-4816,1,0,1,0,Cleaning staff,2.0,0,X
7607,5009281,F,N,N,0,130500.0,Working,Secondary / secondary special,Civil marriage,House / apartment,-15140,-4816,1,0,1,0,Cleaning staff,2.0,-1,X
7608,5009281,F,N,N,0,130500.0,Working,Secondary / secondary special,Civil marriage,House / apartment,-15140,-4816,1,0,1,0,Cleaning staff,2.0,-2,0
7609,5009281,F,N,N,0,130500.0,Working,Secondary / secondary special,Civil marriage,House / apartment,-15140,-4816,1,0,1,0,Cleaning staff,2.0,-3,X
7610,5009281,F,N,N,0,130500.0,Working,Secondary / secondary special,Civil marriage,House / apartment,-15140,-4816,1,0,1,0,Cleaning staff,2.0,-4,0
7611,5009281,F,N,N,0,130500.0,Working,Secondary / secondary special,Civil marriage,House / apartment,-15140,-4816,1,0,1,0,Cleaning staff,2.0,-5,X
7612,5009281,F,N,N,0,130500.0,Working,Secondary / secondary special,Civil marriage,House / apartment,-15140,-4816,1,0,1,0,Cleaning staff,2.0,-6,X
7613,5009281,F,N,N,0,130500.0,Working,Secondary / secondary special,Civil marriage,House / apartment,-15140,-4816,1,0,1,0,Cleaning staff,2.0,-7,X
7614,5009281,F,N,N,0,130500.0,Working,Secondary / secondary special,Civil marriage,House / apartment,-15140,-4816,1,0,1,0,Cleaning staff,2.0,-8,X
7615,5009281,F,N,N,0,130500.0,Working,Secondary / secondary special,Civil marriage,House / apartment,-15140,-4816,1,0,1,0,Cleaning staff,2.0,-9,0
7616,5009281,F,N,N,0,130500.0,Working,Secondary / secondary special,Civil marriage,House / apartment,-15140,-4816,1,0,1,0,Cleaning staff,2.0,-10,X
7617,5009281,F,N,N,0,130500.0,Working,Secondary / secondary special,Civil marriage,House / apartment,-15140,-4816,1,0,1,0,Cleaning staff,2.0,-11,0
7618,5009281,F,N,N,0,130500.0,Working,Secondary / secondary special,Civil marriage,House / apartment,-15140,-4816,1,0,1,0,Cleaning staff,2.0,-12,X
7619,5009281,F,N,N,0,130500.0,Working,Secondary / secondary special,Civil marriage,House / apartment,-15140,-4816,1,0,1,0,Cleaning staff,2.0,-13,0
7620,5009281,F,N,N,0,130500.0,Working,Secondary / secondary special,Civil marriage,House / apartment,-15140,-4816,1,0,1,0,Cleaning staff,2.0,-14,X
7621,5009281,F,N,N,0,130500.0,Working,Secondary / secondary special,Civil marriage,House / apartment,-15140,-4816,1,0,1,0,Cleaning staff,2.0,-15,0
7622,5009281,F,N,N,0,130500.0,Working,Secondary / secondary special,Civil marriage,House / apartment,-15140,-4816,1,0,1,0,Cleaning staff,2.0,-16,0
7623,5009281,F,N,N,0,130500.0,Working,Secondary / secondary special,Civil marriage,House / apartment,-15140,-4816,1,0,1,0,Cleaning staff,2.0,-17,X
7624,5009281,F,N,N,0,130500.0,Working,Secondary / secondary special,Civil marriage,House / apartment,-15140,-4816,1,0,1,0,Cleaning staff,2.0,-18,X
7625,5009281,F,N,N,0,130500.0,Working,Secondary / secondary special,Civil marriage,House / apartment,-15140,-4816,1,0,1,0,Cleaning staff,2.0,-19,0
7626,5009281,F,N,N,0,130500.0,Working,Secondary / secondary special,Civil marriage,House / apartment,-15140,-4816,1,0,1,0,Cleaning staff,2.0,-20,0
7627,5009281,F,N,N,0,130500.0,Working,Secondary / secondary special,Civil marriage,House / apartment,-15140,-4816,1,0,1,0,Cleaning staff,2.0,-21,X
7628,5009281,F,N,N,0,130500.0,Working,Secondary / secondary special,Civil marriage,House / apartment,-15140,-4816,1,0,1,0,Cleaning staff,2.0,-22,0
7629,5009281,F,N,N,0,130500.0,Working,Secondary / secondary special,Civil marriage,House / apartment,-15140,-4816,1,0,1,0,Cleaning staff,2.0,-23,X
7630,5009281,F,N,N,0,130500.0,Working,Secondary / secondary special,Civil marriage,House / apartment,-15140,-4816,1,0,1,0,Cleaning staff,2.0,-24,0
7631,5009281,F,N,N,0,130500.0,Working,Secondary / secondary special,Civil marriage,House / apartment,-15140,-4816,1,0,1,0,Cleaning staff,2.0,-25,X
7632,5009281,F,N,N,0,130500.0,Working,Secondary / secondary special,Civil marriage,House / apartment,-15140,-4816,1,0,1,0,Cleaning staff,2.0,-26,X
7633,5009281,F,N,N,0,130500.0,Working,Secondary / secondary special,Civil marriage,House / apartment,-15140,-4816,1,0,1,0,Cleaning staff,2.0,-27,0
7634,5009281,F,N,N,0,130500.0,Working,Secondary / secondary special,Civil marriage,House / apartment,-15140,-4816,1,0,1,0,Cleaning staff,2.0,-28,0
7635,5009281,F,N,N,0,130500.0,Working,Secondary / secondary special,Civil marriage,House / apartment,-15140,-4816,1,0,1,0,Cleaning staff,2.0,-29,X
7636,5009281,F,N,N,0,130500.0,Working,Secondary / secondary special,Civil marriage,House / apartment,-15140,-4816,1,0,1,0,Cleaning staff,2.0,-30,X
7637,5009281,F,N,N,0,130500.0,Working,Secondary / secondary special,Civil marriage,House / apartment,-15140,-4816,1,0,1,0,Cleaning staff,2.0,-31,X
7638,5009281,F,N,N,0,130500.0,Working,Secondary / secondary special,Civil marriage,House / apartment,-15140,-4816,1,0,1,0,Cleaning staff,2.0,-32,0
7639,5009281,F,N,N,0,130500.0,Working,Secondary / secondary special,Civil marriage,House / apartment,-15140,-4816,1,0,1,0,Cleaning staff,2.0,-33,0
7640,5009281,F,N,N,0,130500.0,Working,Secondary / secondary special,Civil marriage,House / apartment,-15140,-4816,1,0,1,0,Cleaning staff,2.0,-34,0
7641,5009281,F,N,N,0,130500.0,Working,Secondary / secondary special,Civil marriage,House / apartment,-15140,-4816,1,0,1,0,Cleaning staff,2.0,-35,X
7642,5009281,F,N,N,0,130500.0,Working,Secondary / secondary special,Civil marriage,House / apartment,-15140,-4816,1,0,1,0,Cleaning staff,2.0,-36,0
7643,5009281,F,N,N,0,130500.0,Working,Secondary / secondary special,Civil marriage,House / apartment,-15140,-4816,1,0,1,0,Cleaning staff,2.0,-37,X
7644,5009281,F,N,N,0,130500.0,Working,Secondary / secondary special,Civil marriage,House / apartment,-15140,-4816,1,0,1,0,Cleaning staff,2.0,-38,X
7645,5009281,F,N,N,0,130500.0,Working,Secondary / secondary special,Civil marriage,House / apartment,-15140,-4816,1,0,1,0,Cleaning staff,2.0,-39,X
7646,5009284,F,N,N,0,130500.0,Working,Secondary / secondary special,Civil marriage,House / apartment,-15140,-4816,1,0,1,0,Cleaning staff,2.0,0,C
7647,5009284,F,N,N,0,130500.0,Working,Secondary / secondary special,Civil marriage,House / apartment,-15140,-4816,1,0,1,0,Cleaning staff,2.0,-1,C
7648,5009284,F,N,N,0,130500.0,Working,Secondary / secondary special,Civil marriage,House / apartment,-15140,-4816,1,0,1,0,Cleaning staff,2.0,-2,C
7649,5009284,F,N,N,0,130500.0,Working,Secondary / secondary special,Civil marriage,House / apartment,-15140,-4816,1,0,1,0,Cleaning staff,2.0,-3,C
7650,5009284,F,N,N,0,130500.0,Working,Secondary / secondary special,Civil marriage,House / apartment,-15140,-4816,1,0,1,0,Cleaning staff,2.0,-4,C
7651,5009284,F,N,N,0,130500.0,Working,Secondary / secondary special,Civil marriage,House / apartment,-15140,-4816,1,0,1,0,Cleaning staff,2.0,-5,C
7652,5009284,F,N,N,0,130500.0,Working,Secondary / secondary special,Civil marriage,House / apartment,-15140,-4816,1,0,1,0,Cleaning staff,2.0,-6,C
7653,5009284,F,N,N,0,130500.0,Working,Secondary / secondary special,Civil marriage,House / apartment,-15140,-4816,1,0,1,0,Cleaning staff,2.0,-7,C
7654,5009284,F,N,N,0,130500.0,Working,Secondary / secondary special,Civil marriage,House / apartment,-15140,-4816,1,0,1,0,Cleaning staff,2.0,-8,C
7655,5009284,F,N,N,0,130500.0,Working,Secondary / secondary special,Civil marriage,House / apartment,-15140,-4816,1,0,1,0,Cleaning staff,2.0,-9,C
7656,5009284,F,N,N,0,130500.0,Working,Secondary / secondary special,Civil marriage,House / apartment,-15140,-4816,1,0,1,0,Cleaning staff,2.0,-10,C
7657,5009284,F,N,N,0,130500.0,Working,Secondary / secondary special,Civil marriage,House / apartment,-15140,-4816,1,0,1,0,Cleaning staff,2.0,-11,C
7658,5009284,F,N,N,0,130500.0,Working,Secondary / secondary special,Civil marriage,House / apartment,-15140,-4816,1,0,1,0,Cleaning staff,2.0,-12,C
7659,5009284,F,N,N,0,130500.0,Working,Secondary / secondary special,Civil marriage,House / apartment,-15140,-4816,1,0,1,0,Cleaning staff,2.0,-13,C
7660,5009284,F,N,N,0,130500.0,Working,Secondary / secondary special,Civil marriage,House / apartment,-15140,-4816,1,0,1,0,Cleaning staff,2.0,-14,C
7661,5009284,F,N,N,0,130500.0,Working,Secondary / secondary special,Civil marriage,House / apartment,-15140,-4816,1,0,1,0,Cleaning staff,2.0,-15,C
7662,5009284,F,N,N,0,130500.0,Working,Secondary / secondary special,Civil marriage,House / apartment,-15140,-4816,1,0,1,0,Cleaning staff,2.0,-16,C
7663,5009284,F,N,N,0,130500.0,Working,Secondary / secondary special,Civil marriage,House / apartment,-15140,-4816,1,0,1,0,Cleaning staff,2.0,-17,C
7664,5009284,F,N,N,0,130500.0,Working,Secondary / secondary special,Civil marriage,House / apartment,-15140,-4816,1,0,1,0,Cleaning staff,2.0,-18,C
7665,5009284,F,N,N,0,130500.0,Working,Secondary / secondary special,Civil marriage,House / apartment,-15140,-4816,1,0,1,0,Cleaning staff,2.0,-19,C
7666,5009284,F,N,N,0,130500.0,Working,Secondary / secondary special,Civil marriage,House / apartment,-15140,-4816,1,0,1,0,Cleaning staff,2.0,-20,C
7667,5009284,F,N,N,0,130500.0,Working,Secondary / secondary special,Civil marriage,House / apartment,-15140,-4816,1,0,1,0,Cleaning staff,2.0,-21,C
7668,5009284,F,N,N,0,130500.0,Working,Secondary / secondary special,Civil marriage,House / apartment,-15140,-4816,1,0,1,0,Cleaning staff,2.0,-22,C
7669,5009284,F,N,N,0,130500.0,Working,Secondary / secondary special,Civil marriage,House / apartment,-15140,-4816,1,0,1,0,Cleaning staff,2.0,-23,C
7670,5009284,F,N,N,0,130500.0,Working,Secondary / secondary special,Civil marriage,House / apartment,-15140,-4816,1,0,1,0,Cleaning staff,2.0,-24,C
7671,5009284,F,N,N,0,130500.0,Working,Secondary / secondary special,Civil marriage,House / apartment,-15140,-4816,1,0,1,0,Cleaning staff,2.0,-25,C
7672,5009284,F,N,N,0,130500.0,Working,Secondary / secondary special,Civil marriage,House / apartment,-15140,-4816,1,0,1,0,Cleaning staff,2.0,-26,C
7673,5009284,F,N,N,0,130500.0,Working,Secondary / secondary special,Civil marriage,House / apartment,-15140,-4816,1,0,1,0,Cleaning staff,2.0,-27,C
7674,5009284,F,N,N,0,130500.0,Working,Secondary / secondary special,Civil marriage,House / apartment,-15140,-4816,1,0,1,0,Cleaning staff,2.0,-28,C
7675,5009284,F,N,N,0,130500.0,Working,Secondary / secondary special,Civil marriage,House / apartment,-15140,-4816,1,0,1,0,Cleaning staff,2.0,-29,C
7676,5009284,F,N,N,0,130500.0,Working,Secondary / secondary special,Civil marriage,House / apartment,-15140,-4816,1,0,1,0,Cleaning staff,2.0,-30,C
7677,5009284,F,N,N,0,130500.0,Working,Secondary / secondary special,Civil marriage,House / apartment,-15140,-4816,1,0,1,0,Cleaning staff,2.0,-31,C
7678,5009284,F,N,N,0,130500.0,Working,Secondary / secondary special,Civil marriage,House / apartment,-15140,-4816,1,0,1,0,Cleaning staff,2.0,-32,C
7679,5009284,F,N,N,0,130500.0,Working,Secondary / secondary special,Civil marriage,House / apartment,-15140,-4816,1,0,1,0,Cleaning staff,2.0,-33,C
7680,5009284,F,N,N,0,130500.0,Working,Secondary / secondary special,Civil marriage,House / apartment,-15140,-4816,1,0,1,0,Cleaning staff,2.0,-34,C
7681,5009284,F,N,N,0,130500.0,Working,Secondary / secondary special,Civil marriage,House / apartment,-15140,-4816,1,0,1,0,Cleaning staff,2.0,-35,C
7682,5009284,F,N,N,0,130500.0,Working,Secondary / secondary special,Civil marriage,House / apartment,-15140,-4816,1,0,1,0,Cleaning staff,2.0,-36,C
7683,5009284,F,N,N,0,130500.0,Working,Secondary / secondary special,Civil marriage,House / apartment,-15140,-4816,1,0,1,0,Cleaning staff,2.0,-37,C
7684,5009284,F,N,N,0,130500.0,Working,Secondary / secondary special,Civil marriage,House / apartment,-15140,-4816,1,0,1,0,Cleaning staff,2.0,-38,C
7685,5009284,F,N,N,0,130500.0,Working,Secondary / secondary special,Civil marriage,House / apartment,-15140,-4816,1,0,1,0,Cleaning staff,2.0,-39,C
7686,5009284,F,N,N,0,130500.0,Working,Secondary / secondary special,Civil marriage,House / apartment,-15140,-4816,1,0,1,0,Cleaning staff,2.0,-40,C
7687,5009284,F,N,N,0,130500.0,Working,Secondary / secondary special,Civil marriage,House / apartment,-15140,-4816,1,0,1,0,Cleaning staff,2.0,-41,C
7688,5009284,F,N,N,0,130500.0,Working,Secondary / secondary special,Civil marriage,House / apartment,-15140,-4816,1,0,1,0,Cleaning staff,2.0,-42,C
7689,5009284,F,N,N,0,130500.0,Working,Secondary / secondary special,Civil marriage,House / apartment,-15140,-4816,1,0,1,0,Cleaning staff,2.0,-43,C
7690,5009284,F,N,N,0,130500.0,Working,Secondary / secondary special,Civil marriage,House / apartment,-15140,-4816,1,0,1,0,Cleaning staff,2.0,-44,C
7691,5009284,F,N,N,0,130500.0,Working,Secondary / secondary special,Civil marriage,House / apartment,-15140,-4816,1,0,1,0,Cleaning staff,2.0,-45,C
7692,5009284,F,N,N,0,130500.0,Working,Secondary / secondary special,Civil marriage,House / apartment,-15140,-4816,1,0,1,0,Cleaning staff,2.0,-46,C
7693,5009284,F,N,N,0,130500.0,Working,Secondary / secondary special,Civil marriage,House / apartment,-15140,-4816,1,0,1,0,Cleaning staff,2.0,-47,C
7694,5009284,F,N,N,0,130500.0,Working,Secondary / secondary special,Civil marriage,House / apartment,-15140,-4816,1,0,1,0,Cleaning staff,2.0,-48,C
7695,5009284,F,N,N,0,130500.0,Working,Secondary / secondary special,Civil marriage,House / apartment,-15140,-4816,1,0,1,0,Cleaning staff,2.0,-49,C
7696,5009284,F,N,N,0,130500.0,Working,Secondary / secondary special,Civil marriage,House / apartment,-15140,-4816,1,0,1,0,Cleaning staff,2.0,-50,C
7697,5009284,F,N,N,0,130500.0,Working,Secondary / secondary special,Civil marriage,House / apartment,-15140,-4816,1,0,1,0,Cleaning staff,2.0,-51,C
7698,5009284,F,N,N,0,130500.0,Working,Secondary / secondary special,Civil marriage,House / apartment,-15140,-4816,1,0,1,0,Cleaning staff,2.0,-52,C
7699,5009284,F,N,N,0,130500.0,Working,Secondary / secondary special,Civil marriage,House / apartment,-15140,-4816,1,0,1,0,Cleaning staff,2.0,-53,0
7700,5009284,F,N,N,0,130500.0,Working,Secondary / secondary special,Civil marriage,House / apartment,-15140,-4816,1,0,1,0,Cleaning staff,2.0,-54,0
7701,5009284,F,N,N,0,130500.0,Working,Secondary / secondary special,Civil marriage,House / apartment,-15140,-4816,1,0,1,0,Cleaning staff,2.0,-55,0
7702,5009284,F,N,N,0,130500.0,Working,Secondary / secondary special,Civil marriage,House / apartment,-15140,-4816,1,0,1,0,Cleaning staff,2.0,-56,0
7703,5009284,F,N,N,0,130500.0,Working,Secondary / secondary special,Civil marriage,House / apartment,-15140,-4816,1,0,1,0,Cleaning staff,2.0,-57,0
7704,5009284,F,N,N,0,130500.0,Working,Secondary / secondary special,Civil marriage,House / apartment,-15140,-4816,1,0,1,0,Cleaning staff,2.0,-58,X
7705,5009285,F,N,N,0,130500.0,Working,Secondary / secondary special,Civil marriage,House / apartment,-15140,-4816,1,0,1,0,Cleaning staff,2.0,-39,X
7706,5009285,F,N,N,0,130500.0,Working,Secondary / secondary special,Civil marriage,House / apartment,-15140,-4816,1,0,1,0,Cleaning staff,2.0,-40,0
7707,5009285,F,N,N,0,130500.0,Working,Secondary / secondary special,Civil marriage,House / apartment,-15140,-4816,1,0,1,0,Cleaning staff,2.0,-41,0
7708,5009285,F,N,N,0,130500.0,Working,Secondary / secondary special,Civil marriage,House / apartment,-15140,-4816,1,0,1,0,Cleaning staff,2.0,-42,0
7709,5009285,F,N,N,0,130500.0,Working,Secondary / secondary special,Civil marriage,House / apartment,-15140,-4816,1,0,1,0,Cleaning staff,2.0,-43,0
7710,5009285,F,N,N,0,130500.0,Working,Secondary / secondary special,Civil marriage,House / apartment,-15140,-4816,1,0,1,0,Cleaning staff,2.0,-44,0
7711,5009285,F,N,N,0,130500.0,Working,Secondary / secondary special,Civil marriage,House / apartment,-15140,-4816,1,0,1,0,Cleaning staff,2.0,-45,0
7712,5009285,F,N,N,0,130500.0,Working,Secondary / secondary special,Civil marriage,House / apartment,-15140,-4816,1,0,1,0,Cleaning staff,2.0,-46,0
7713,5009285,F,N,N,0,130500.0,Working,Secondary / secondary special,Civil marriage,House / apartment,-15140,-4816,1,0,1,0,Cleaning staff,2.0,-47,0
7714,5009285,F,N,N,0,130500.0,Working,Secondary / secondary special,Civil marriage,House / apartment,-15140,-4816,1,0,1,0,Cleaning staff,2.0,-48,0
7715,5009285,F,N,N,0,130500.0,Working,Secondary / secondary special,Civil marriage,House / apartment,-15140,-4816,1,0,1,0,Cleaning staff,2.0,-49,0
7716,5009285,F,N,N,0,130500.0,Working,Secondary / secondary special,Civil marriage,House / apartment,-15140,-4816,1,0,1,0,Cleaning staff,2.0,-50,0
7717,5009285,F,N,N,0,130500.0,Working,Secondary / secondary special,Civil marriage,House / apartment,-15140,-4816,1,0,1,0,Cleaning staff,2.0,-51,0
7718,5009285,F,N,N,0,130500.0,Working,Secondary / secondary special,Civil marriage,House / apartment,-15140,-4816,1,0,1,0,Cleaning staff,2.0,-52,0
7719,5009285,F,N,N,0,130500.0,Working,Secondary / secondary special,Civil marriage,House / apartment,-15140,-4816,1,0,1,0,Cleaning staff,2.0,-53,0
7720,5009285,F,N,N,0,130500.0,Working,Secondary / secondary special,Civil marriage,House / apartment,-15140,-4816,1,0,1,0,Cleaning staff,2.0,-54,0
7721,5009285,F,N,N,0,130500.0,Working,Secondary / secondary special,Civil marriage,House / apartment,-15140,-4816,1,0,1,0,Cleaning staff,2.0,-55,0
7722,5009286,F,N,N,0,130500.0,Working,Secondary / secondary special,Civil marriage,House / apartment,-15140,-4816,1,0,1,0,Cleaning staff,2.0,-18,X
7723,5009286,F,N,N,0,130500.0,Working,Secondary / secondary special,Civil marriage,House / apartment,-15140,-4816,1,0,1,0,Cleaning staff,2.0,-19,0
7724,5009286,F,N,N,0,130500.0,Working,Secondary / secondary special,Civil marriage,House / apartment,-15140,-4816,1,0,1,0,Cleaning staff,2.0,-20,0
7725,5009286,F,N,N,0,130500.0,Working,Secondary / secondary special,Civil marriage,House / apartment,-15140,-4816,1,0,1,0,Cleaning staff,2.0,-21,0
7726,5009286,F,N,N,0,130500.0,Working,Secondary / secondary special,Civil marriage,House / apartment,-15140,-4816,1,0,1,0,Cleaning staff,2.0,-22,0
7727,5009286,F,N,N,0,130500.0,Working,Secondary / secondary special,Civil marriage,House / apartment,-15140,-4816,1,0,1,0,Cleaning staff,2.0,-23,0
7728,5009286,F,N,N,0,130500.0,Working,Secondary / secondary special,Civil marriage,House / apartment,-15140,-4816,1,0,1,0,Cleaning staff,2.0,-24,0
7729,5009286,F,N,N,0,130500.0,Working,Secondary / secondary special,Civil marriage,House / apartment,-15140,-4816,1,0,1,0,Cleaning staff,2.0,-25,0
7730,5009286,F,N,N,0,130500.0,Working,Secondary / secondary special,Civil marriage,House / apartment,-15140,-4816,1,0,1,0,Cleaning staff,2.0,-26,0
7731,5009286,F,N,N,0,130500.0,Working,Secondary / secondary special,Civil marriage,House / apartment,-15140,-4816,1,0,1,0,Cleaning staff,2.0,-27,0
7732,5009286,F,N,N,0,130500.0,Working,Secondary / secondary special,Civil marriage,House / apartment,-15140,-4816,1,0,1,0,Cleaning staff,2.0,-28,0
7733,5009286,F,N,N,0,130500.0,Working,Secondary / secondary special,Civil marriage,House / apartment,-15140,-4816,1,0,1,0,Cleaning staff,2.0,-29,0
7734,5009286,F,N,N,0,130500.0,Working,Secondary / secondary special,Civil marriage,House / apartment,-15140,-4816,1,0,1,0,Cleaning staff,2.0,-30,0
7735,5009286,F,N,N,0,130500.0,Working,Secondary / secondary special,Civil marriage,House / apartment,-15140,-4816,1,0,1,0,Cleaning staff,2.0,-31,0
7736,5009286,F,N,N,0,130500.0,Working,Secondary / secondary special,Civil marriage,House / apartment,-15140,-4816,1,0,1,0,Cleaning staff,2.0,-32,0
7737,5009286,F,N,N,0,130500.0,Working,Secondary / secondary special,Civil marriage,House / apartment,-15140,-4816,1,0,1,0,Cleaning staff,2.0,-33,0
7738,5009286,F,N,N,0,130500.0,Working,Secondary / secondary special,Civil marriage,House / apartment,-15140,-4816,1,0,1,0,Cleaning staff,2.0,-34,0
7739,5009286,F,N,N,0,130500.0,Working,Secondary / secondary special,Civil marriage,House / apartment,-15140,-4816,1,0,1,0,Cleaning staff,2.0,-35,0
7740,5009286,F,N,N,0,130500.0,Working,Secondary / secondary special,Civil marriage,House / apartment,-15140,-4816,1,0,1,0,Cleaning staff,2.0,-36,0
7741,5009286,F,N,N,0,130500.0,Working,Secondary / secondary special,Civil marriage,House / apartment,-15140,-4816,1,0,1,0,Cleaning staff,2.0,-37,0
7742,5009286,F,N,N,0,130500.0,Working,Secondary / secondary special,Civil marriage,House / apartment,-15140,-4816,1,0,1,0,Cleaning staff,2.0,-38,0
7743,5009286,F,N,N,0,130500.0,Working,Secondary / secondary special,Civil marriage,House / apartment,-15140,-4816,1,0,1,0,Cleaning staff,2.0,-39,0
7744,5009286,F,N,N,0,130500.0,Working,Secondary / secondary special,Civil marriage,House / apartment,-15140,-4816,1,0,1,0,Cleaning staff,2.0,-40,0
7745,5009286,F,N,N,0,130500.0,Working,Secondary / secondary special,Civil marriage,House / apartment,-15140,-4816,1,0,1,0,Cleaning staff,2.0,-41,0
7746,5009286,F,N,N,0,130500.0,Working,Secondary / secondary special,Civil marriage,House / apartment,-15140,-4816,1,0,1,0,Cleaning staff,2.0,-42,0
7747,5009286,F,N,N,0,130500.0,Working,Secondary / secondary special,Civil marriage,House / apartment,-15140,-4816,1,0,1,0,Cleaning staff,2.0,-43,0
7748,5009286,F,N,N,0,130500.0,Working,Secondary / secondary special,Civil marriage,House / apartment,-15140,-4816,1,0,1,0,Cleaning staff,2.0,-44,0
7749,5009286,F,N,N,0,130500.0,Working,Secondary / secondary special,Civil marriage,House / apartment,-15140,-4816,1,0,1,0,Cleaning staff,2.0,-45,0
7750,5009286,F,N,N,0,130500.0,Working,Secondary / secondary special,Civil marriage,House / apartment,-15140,-4816,1,0,1,0,Cleaning staff,2.0,-46,0
7751,5009286,F,N,N,0,130500.0,Working,Secondary / secondary special,Civil marriage,House / apartment,-15140,-4816,1,0,1,0,Cleaning staff,2.0,-47,0
7752,5009286,F,N,N,0,130500.0,Working,Secondary / secondary special,Civil marriage,House / apartment,-15140,-4816,1,0,1,0,Cleaning staff,2.0,-48,0
7753,5009287,F,N,N,0,130500.0,Working,Secondary / secondary special,Civil marriage,House / apartment,-15140,-4816,1,0,1,0,Cleaning staff,2.0,0,0
7754,5009287,F,N,N,0,130500.0,Working,Secondary / secondary special,Civil marriage,House / apartment,-15140,-4816,1,0,1,0,Cleaning staff,2.0,-1,0
7755,5009287,F,N,N,0,130500.0,Working,Secondary / secondary special,Civil marriage,House / apartment,-15140,-4816,1,0,1,0,Cleaning staff,2.0,-2,0
7756,5009287,F,N,N,0,130500.0,Working,Secondary / secondary special,Civil marriage,House / apartment,-15140,-4816,1,0,1,0,Cleaning staff,2.0,-3,0
7757,5009287,F,N,N,0,130500.0,Working,Secondary / secondary special,Civil marriage,House / apartment,-15140,-4816,1,0,1,0,Cleaning staff,2.0,-4,0
7758,5009287,F,N,N,0,130500.0,Working,Secondary / secondary special,Civil marriage,House / apartment,-15140,-4816,1,0,1,0,Cleaning staff,2.0,-5,0
7759,5009287,F,N,N,0,130500.0,Working,Secondary / secondary special,Civil marriage,House / apartment,-15140,-4816,1,0,1,0,Cleaning staff,2.0,-6,0
7760,5009287,F,N,N,0,130500.0,Working,Secondary / secondary special,Civil marriage,House / apartment,-15140,-4816,1,0,1,0,Cleaning staff,2.0,-7,0
7761,5009287,F,N,N,0,130500.0,Working,Secondary / secondary special,Civil marriage,House / apartment,-15140,-4816,1,0,1,0,Cleaning staff,2.0,-8,0
7762,5009287,F,N,N,0,130500.0,Working,Secondary / secondary special,Civil marriage,House / apartment,-15140,-4816,1,0,1,0,Cleaning staff,2.0,-9,0
7763,5009287,F,N,N,0,130500.0,Working,Secondary / secondary special,Civil marriage,House / apartment,-15140,-4816,1,0,1,0,Cleaning staff,2.0,-10,0
7764,5009287,F,N,N,0,130500.0,Working,Secondary / secondary special,Civil marriage,House / apartment,-15140,-4816,1,0,1,0,Cleaning staff,2.0,-11,0
7765,5009287,F,N,N,0,130500.0,Working,Secondary / secondary special,Civil marriage,House / apartment,-15140,-4816,1,0,1,0,Cleaning staff,2.0,-12,0
7766,5009287,F,N,N,0,130500.0,Working,Secondary / secondary special,Civil marriage,House / apartment,-15140,-4816,1,0,1,0,Cleaning staff,2.0,-13,0
7767,5009287,F,N,N,0,130500.0,Working,Secondary / secondary special,Civil marriage,House / apartment,-15140,-4816,1,0,1,0,Cleaning staff,2.0,-14,0
7768,5009287,F,N,N,0,130500.0,Working,Secondary / secondary special,Civil marriage,House / apartment,-15140,-4816,1,0,1,0,Cleaning staff,2.0,-15,0
7769,5009287,F,N,N,0,130500.0,Working,Secondary / secondary special,Civil marriage,House / apartment,-15140,-4816,1,0,1,0,Cleaning staff,2.0,-16,0
7770,5009287,F,N,N,0,130500.0,Working,Secondary / secondary special,Civil marriage,House / apartment,-15140,-4816,1,0,1,0,Cleaning staff,2.0,-17,0
7771,5009287,F,N,N,0,130500.0,Working,Secondary / secondary special,Civil marriage,House / apartment,-15140,-4816,1,0,1,0,Cleaning staff,2.0,-18,0
7772,5009287,F,N,N,0,130500.0,Working,Secondary / secondary special,Civil marriage,House / apartment,-15140,-4816,1,0,1,0,Cleaning staff,2.0,-19,0
7773,5009287,F,N,N,0,130500.0,Working,Secondary / secondary special,Civil marriage,House / apartment,-15140,-4816,1,0,1,0,Cleaning staff,2.0,-20,0
7774,5009287,F,N,N,0,130500.0,Working,Secondary / secondary special,Civil marriage,House / apartment,-15140,-4816,1,0,1,0,Cleaning staff,2.0,-21,0
7775,5009287,F,N,N,0,130500.0,Working,Secondary / secondary special,Civil marriage,House / apartment,-15140,-4816,1,0,1,0,Cleaning staff,2.0,-22,0
7776,5009287,F,N,N,0,130500.0,Working,Secondary / secondary special,Civil marriage,House / apartment,-15140,-4816,1,0,1,0,Cleaning staff,2.0,-23,0
7777,5009287,F,N,N,0,130500.0,Working,Secondary / secondary special,Civil marriage,House / apartment,-15140,-4816,1,0,1,0,Cleaning staff,2.0,-24,X
7778,5009289,F,N,N,0,130500.0,Working,Secondary / secondary special,Civil marriage,House / apartment,-15140,-4816,1,0,1,0,Cleaning staff,2.0,0,C
7779,5009289,F,N,N,0,130500.0,Working,Secondary / secondary special,Civil marriage,House / apartment,-15140,-4816,1,0,1,0,Cleaning staff,2.0,-1,C
7780,5009289,F,N,N,0,130500.0,Working,Secondary / secondary special,Civil marriage,House / apartment,-15140,-4816,1,0,1,0,Cleaning staff,2.0,-2,C
7781,5009289,F,N,N,0,130500.0,Working,Secondary / secondary special,Civil marriage,House / apartment,-15140,-4816,1,0,1,0,Cleaning staff,2.0,-3,C
7782,5009289,F,N,N,0,130500.0,Working,Secondary / secondary special,Civil marriage,House / apartment,-15140,-4816,1,0,1,0,Cleaning staff,2.0,-4,0
7783,5009289,F,N,N,0,130500.0,Working,Secondary / secondary special,Civil marriage,House / apartment,-15140,-4816,1,0,1,0,Cleaning staff,2.0,-5,0
7784,5009289,F,N,N,0,130500.0,Working,Secondary / secondary special,Civil marriage,House / apartment,-15140,-4816,1,0,1,0,Cleaning staff,2.0,-6,0
7785,5009289,F,N,N,0,130500.0,Working,Secondary / secondary special,Civil marriage,House / apartment,-15140,-4816,1,0,1,0,Cleaning staff,2.0,-7,0
7786,5009289,F,N,N,0,130500.0,Working,Secondary / secondary special,Civil marriage,House / apartment,-15140,-4816,1,0,1,0,Cleaning staff,2.0,-8,X
7787,5009290,F,N,N,0,130500.0,Working,Secondary / secondary special,Civil marriage,House / apartment,-15140,-4816,1,0,1,0,Cleaning staff,2.0,0,C
7788,5009290,F,N,N,0,130500.0,Working,Secondary / secondary special,Civil marriage,House / apartment,-15140,-4816,1,0,1,0,Cleaning staff,2.0,-1,C
7789,5009290,F,N,N,0,130500.0,Working,Secondary / secondary special,Civil marriage,House / apartment,-15140,-4816,1,0,1,0,Cleaning staff,2.0,-2,C
7790,5009290,F,N,N,0,130500.0,Working,Secondary / secondary special,Civil marriage,House / apartment,-15140,-4816,1,0,1,0,Cleaning staff,2.0,-3,C
7791,5009290,F,N,N,0,130500.0,Working,Secondary / secondary special,Civil marriage,House / apartment,-15140,-4816,1,0,1,0,Cleaning staff,2.0,-4,0
7792,5009290,F,N,N,0,130500.0,Working,Secondary / secondary special,Civil marriage,House / apartment,-15140,-4816,1,0,1,0,Cleaning staff,2.0,-5,X
7793,5009290,F,N,N,0,130500.0,Working,Secondary / secondary special,Civil marriage,House / apartment,-15140,-4816,1,0,1,0,Cleaning staff,2.0,-6,X
7794,5009290,F,N,N,0,130500.0,Working,Secondary / secondary special,Civil marriage,House / apartment,-15140,-4816,1,0,1,0,Cleaning staff,2.0,-7,X
7795,5009290,F,N,N,0,130500.0,Working,Secondary / secondary special,Civil marriage,House / apartment,-15140,-4816,1,0,1,0,Cleaning staff,2.0,-8,X
7796,5009290,F,N,N,0,130500.0,Working,Secondary / secondary special,Civil marriage,House / apartment,-15140,-4816,1,0,1,0,Cleaning staff,2.0,-9,X
7797,5009290,F,N,N,0,130500.0,Working,Secondary / secondary special,Civil marriage,House / apartment,-15140,-4816,1,0,1,0,Cleaning staff,2.0,-10,X
7798,5009290,F,N,N,0,130500.0,Working,Secondary / secondary special,Civil marriage,House / apartment,-15140,-4816,1,0,1,0,Cleaning staff,2.0,-11,X
7799,5009290,F,N,N,0,130500.0,Working,Secondary / secondary special,Civil marriage,House / apartment,-15140,-4816,1,0,1,0,Cleaning staff,2.0,-12,X
7800,5009290,F,N,N,0,130500.0,Working,Secondary / secondary special,Civil marriage,House / apartment,-15140,-4816,1,0,1,0,Cleaning staff,2.0,-13,X
7801,5009290,F,N,N,0,130500.0,Working,Secondary / secondary special,Civil marriage,House / apartment,-15140,-4816,1,0,1,0,Cleaning staff,2.0,-14,X
7802,5009290,F,N,N,0,130500.0,Working,Secondary / secondary special,Civil marriage,House / apartment,-15140,-4816,1,0,1,0,Cleaning staff,2.0,-15,X
7803,5009290,F,N,N,0,130500.0,Working,Secondary / secondary special,Civil marriage,House / apartment,-15140,-4816,1,0,1,0,Cleaning staff,2.0,-16,X
7804,5009290,F,N,N,0,130500.0,Working,Secondary / secondary special,Civil marriage,House / apartment,-15140,-4816,1,0,1,0,Cleaning staff,2.0,-17,X
7805,5009290,F,N,N,0,130500.0,Working,Secondary / secondary special,Civil marriage,House / apartment,-15140,-4816,1,0,1,0,Cleaning staff,2.0,-18,X
7806,5009290,F,N,N,0,130500.0,Working,Secondary / secondary special,Civil marriage,House / apartment,-15140,-4816,1,0,1,0,Cleaning staff,2.0,-19,X
7807,5009290,F,N,N,0,130500.0,Working,Secondary / secondary special,Civil marriage,House / apartment,-15140,-4816,1,0,1,0,Cleaning staff,2.0,-20,X
7808,5009291,F,N,N,0,130500.0,Working,Secondary / secondary special,Civil marriage,House / apartment,-15140,-4816,1,0,1,0,Cleaning staff,2.0,-7,X
7809,5009291,F,N,N,0,130500.0,Working,Secondary / secondary special,Civil marriage,House / apartment,-15140,-4816,1,0,1,0,Cleaning staff,2.0,-8,0
7810,5009291,F,N,N,0,130500.0,Working,Secondary / secondary special,Civil marriage,House / apartment,-15140,-4816,1,0,1,0,Cleaning staff,2.0,-9,0
7811,5009291,F,N,N,0,130500.0,Working,Secondary / secondary special,Civil marriage,House / apartment,-15140,-4816,1,0,1,0,Cleaning staff,2.0,-10,0
7812,5009291,F,N,N,0,130500.0,Working,Secondary / secondary special,Civil marriage,House / apartment,-15140,-4816,1,0,1,0,Cleaning staff,2.0,-11,0
7813,5009291,F,N,N,0,130500.0,Working,Secondary / secondary special,Civil marriage,House / apartment,-15140,-4816,1,0,1,0,Cleaning staff,2.0,-12,0
7814,5009291,F,N,N,0,130500.0,Working,Secondary / secondary special,Civil marriage,House / apartment,-15140,-4816,1,0,1,0,Cleaning staff,2.0,-13,0
7815,5009291,F,N,N,0,130500.0,Working,Secondary / secondary special,Civil marriage,House / apartment,-15140,-4816,1,0,1,0,Cleaning staff,2.0,-14,X
7816,5009291,F,N,N,0,130500.0,Working,Secondary / secondary special,Civil marriage,House / apartment,-15140,-4816,1,0,1,0,Cleaning staff,2.0,-15,0
7817,5009291,F,N,N,0,130500.0,Working,Secondary / secondary special,Civil marriage,House / apartment,-15140,-4816,1,0,1,0,Cleaning staff,2.0,-16,0
7818,5009292,F,N,N,0,130500.0,Working,Secondary / secondary special,Civil marriage,House / apartment,-15140,-4816,1,0,1,0,Cleaning staff,2.0,0,X
7819,5009292,F,N,N,0,130500.0,Working,Secondary / secondary special,Civil marriage,House / apartment,-15140,-4816,1,0,1,0,Cleaning staff,2.0,-1,0
7820,5009292,F,N,N,0,130500.0,Working,Secondary / secondary special,Civil marriage,House / apartment,-15140,-4816,1,0,1,0,Cleaning staff,2.0,-2,0
7821,5009292,F,N,N,0,130500.0,Working,Secondary / secondary special,Civil marriage,House / apartment,-15140,-4816,1,0,1,0,Cleaning staff,2.0,-3,X
7822,5009292,F,N,N,0,130500.0,Working,Secondary / secondary special,Civil marriage,House / apartment,-15140,-4816,1,0,1,0,Cleaning staff,2.0,-4,0
7823,5009292,F,N,N,0,130500.0,Working,Secondary / secondary special,Civil marriage,House / apartment,-15140,-4816,1,0,1,0,Cleaning staff,2.0,-5,0
7824,5009292,F,N,N,0,130500.0,Working,Secondary / secondary special,Civil marriage,House / apartment,-15140,-4816,1,0,1,0,Cleaning staff,2.0,-6,0
7825,5009292,F,N,N,0,130500.0,Working,Secondary / secondary special,Civil marriage,House / apartment,-15140,-4816,1,0,1,0,Cleaning staff,2.0,-7,X
7826,5009292,F,N,N,0,130500.0,Working,Secondary / secondary special,Civil marriage,House / apartment,-15140,-4816,1,0,1,0,Cleaning staff,2.0,-8,0
7827,5009292,F,N,N,0,130500.0,Working,Secondary / secondary special,Civil marriage,House / apartment,-15140,-4816,1,0,1,0,Cleaning staff,2.0,-9,X
7828,5009292,F,N,N,0,130500.0,Working,Secondary / secondary special,Civil marriage,House / apartment,-15140,-4816,1,0,1,0,Cleaning staff,2.0,-10,0
7829,5009292,F,N,N,0,130500.0,Working,Secondary / secondary special,Civil marriage,House / apartment,-15140,-4816,1,0,1,0,Cleaning staff,2.0,-11,0
7830,5009292,F,N,N,0,130500.0,Working,Secondary / secondary special,Civil marriage,House / apartment,-15140,-4816,1,0,1,0,Cleaning staff,2.0,-12,X
7831,5009292,F,N,N,0,130500.0,Working,Secondary / secondary special,Civil marriage,House / apartment,-15140,-4816,1,0,1,0,Cleaning staff,2.0,-13,X
7832,5009292,F,N,N,0,130500.0,Working,Secondary / secondary special,Civil marriage,House / apartment,-15140,-4816,1,0,1,0,Cleaning staff,2.0,-14,0
7833,5009292,F,N,N,0,130500.0,Working,Secondary / secondary special,Civil marriage,House / apartment,-15140,-4816,1,0,1,0,Cleaning staff,2.0,-15,0
7834,5009292,F,N,N,0,130500.0,Working,Secondary / secondary special,Civil marriage,House / apartment,-15140,-4816,1,0,1,0,Cleaning staff,2.0,-16,X
7835,5009292,F,N,N,0,130500.0,Working,Secondary / secondary special,Civil marriage,House / apartment,-15140,-4816,1,0,1,0,Cleaning staff,2.0,-17,0
7836,5009292,F,N,N,0,130500.0,Working,Secondary / secondary special,Civil marriage,House / apartment,-15140,-4816,1,0,1,0,Cleaning staff,2.0,-18,X
7837,5009292,F,N,N,0,130500.0,Working,Secondary / secondary special,Civil marriage,House / apartment,-15140,-4816,1,0,1,0,Cleaning staff,2.0,-19,0
7838,5009292,F,N,N,0,130500.0,Working,Secondary / secondary special,Civil marriage,House / apartment,-15140,-4816,1,0,1,0,Cleaning staff,2.0,-20,X
7839,5009292,F,N,N,0,130500.0,Working,Secondary / secondary special,Civil marriage,House / apartment,-15140,-4816,1,0,1,0,Cleaning staff,2.0,-21,X
7840,5009292,F,N,N,0,130500.0,Working,Secondary / secondary special,Civil marriage,House / apartment,-15140,-4816,1,0,1,0,Cleaning staff,2.0,-22,X
7841,5009292,F,N,N,0,130500.0,Working,Secondary / secondary special,Civil marriage,House / apartment,-15140,-4816,1,0,1,0,Cleaning staff,2.0,-23,0
7842,5009292,F,N,N,0,130500.0,Working,Secondary / secondary special,Civil marriage,House / apartment,-15140,-4816,1,0,1,0,Cleaning staff,2.0,-24,0
7843,5009292,F,N,N,0,130500.0,Working,Secondary / secondary special,Civil marriage,House / apartment,-15140,-4816,1,0,1,0,Cleaning staff,2.0,-25,0
7844,5009292,F,N,N,0,130500.0,Working,Secondary / secondary special,Civil marriage,House / apartment,-15140,-4816,1,0,1,0,Cleaning staff,2.0,-26,X
7845,5009292,F,N,N,0,130500.0,Working,Secondary / secondary special,Civil marriage,House / apartment,-15140,-4816,1,0,1,0,Cleaning staff,2.0,-27,0
7846,5009292,F,N,N,0,130500.0,Working,Secondary / secondary special,Civil marriage,House / apartment,-15140,-4816,1,0,1,0,Cleaning staff,2.0,-28,0
7847,5009292,F,N,N,0,130500.0,Working,Secondary / secondary special,Civil marriage,House / apartment,-15140,-4816,1,0,1,0,Cleaning staff,2.0,-29,0
7848,5009292,F,N,N,0,130500.0,Working,Secondary / secondary special,Civil marriage,House / apartment,-15140,-4816,1,0,1,0,Cleaning staff,2.0,-30,X
7849,5009292,F,N,N,0,130500.0,Working,Secondary / secondary special,Civil marriage,House / apartment,-15140,-4816,1,0,1,0,Cleaning staff,2.0,-31,0
7850,5009292,F,N,N,0,130500.0,Working,Secondary / secondary special,Civil marriage,House / apartment,-15140,-4816,1,0,1,0,Cleaning staff,2.0,-32,X
7851,5009292,F,N,N,0,130500.0,Working,Secondary / secondary special,Civil marriage,House / apartment,-15140,-4816,1,0,1,0,Cleaning staff,2.0,-33,X
7852,5009292,F,N,N,0,130500.0,Working,Secondary / secondary special,Civil marriage,House / apartment,-15140,-4816,1,0,1,0,Cleaning staff,2.0,-34,X
7853,5009293,F,N,N,0,130500.0,Working,Secondary / secondary special,Civil marriage,House / apartment,-15140,-4816,1,0,1,0,Cleaning staff,2.0,0,C
7854,5009293,F,N,N,0,130500.0,Working,Secondary / secondary special,Civil marriage,House / apartment,-15140,-4816,1,0,1,0,Cleaning staff,2.0,-1,C
7855,5009293,F,N,N,0,130500.0,Working,Secondary / secondary special,Civil marriage,House / apartment,-15140,-4816,1,0,1,0,Cleaning staff,2.0,-2,C
7856,5009293,F,N,N,0,130500.0,Working,Secondary / secondary special,Civil marriage,House / apartment,-15140,-4816,1,0,1,0,Cleaning staff,2.0,-3,C
7857,5009293,F,N,N,0,130500.0,Working,Secondary / secondary special,Civil marriage,House / apartment,-15140,-4816,1,0,1,0,Cleaning staff,2.0,-4,C
7858,5009293,F,N,N,0,130500.0,Working,Secondary / secondary special,Civil marriage,House / apartment,-15140,-4816,1,0,1,0,Cleaning staff,2.0,-5,C
7859,5009293,F,N,N,0,130500.0,Working,Secondary / secondary special,Civil marriage,House / apartment,-15140,-4816,1,0,1,0,Cleaning staff,2.0,-6,C
7860,5009293,F,N,N,0,130500.0,Working,Secondary / secondary special,Civil marriage,House / apartment,-15140,-4816,1,0,1,0,Cleaning staff,2.0,-7,C
7861,5009293,F,N,N,0,130500.0,Working,Secondary / secondary special,Civil marriage,House / apartment,-15140,-4816,1,0,1,0,Cleaning staff,2.0,-8,C
7862,5009293,F,N,N,0,130500.0,Working,Secondary / secondary special,Civil marriage,House / apartment,-15140,-4816,1,0,1,0,Cleaning staff,2.0,-9,C
7863,5009293,F,N,N,0,130500.0,Working,Secondary / secondary special,Civil marriage,House / apartment,-15140,-4816,1,0,1,0,Cleaning staff,2.0,-10,C
7864,5009293,F,N,N,0,130500.0,Working,Secondary / secondary special,Civil marriage,House / apartment,-15140,-4816,1,0,1,0,Cleaning staff,2.0,-11,C
7865,5009293,F,N,N,0,130500.0,Working,Secondary / secondary special,Civil marriage,House / apartment,-15140,-4816,1,0,1,0,Cleaning staff,2.0,-12,C
7866,5009293,F,N,N,0,130500.0,Working,Secondary / secondary special,Civil marriage,House / apartment,-15140,-4816,1,0,1,0,Cleaning staff,2.0,-13,C
7867,5009293,F,N,N,0,130500.0,Working,Secondary / secondary special,Civil marriage,House / apartment,-15140,-4816,1,0,1,0,Cleaning staff,2.0,-14,C
7868,5009293,F,N,N,0,130500.0,Working,Secondary / secondary special,Civil marriage,House / apartment,-15140,-4816,1,0,1,0,Cleaning staff,2.0,-15,C
7869,5009293,F,N,N,0,130500.0,Working,Secondary / secondary special,Civil marriage,House / apartment,-15140,-4816,1,0,1,0,Cleaning staff,2.0,-16,C
7870,5009293,F,N,N,0,130500.0,Working,Secondary / secondary special,Civil marriage,House / apartment,-15140,-4816,1,0,1,0,Cleaning staff,2.0,-17,C
7871,5009293,F,N,N,0,130500.0,Working,Secondary / secondary special,Civil marriage,House / apartment,-15140,-4816,1,0,1,0,Cleaning staff,2.0,-18,C
7872,5009293,F,N,N,0,130500.0,Working,Secondary / secondary special,Civil marriage,House / apartment,-15140,-4816,1,0,1,0,Cleaning staff,2.0,-19,C
7873,5009293,F,N,N,0,130500.0,Working,Secondary / secondary special,Civil marriage,House / apartment,-15140,-4816,1,0,1,0,Cleaning staff,2.0,-20,C
7874,5009293,F,N,N,0,130500.0,Working,Secondary / secondary special,Civil marriage,House / apartment,-15140,-4816,1,0,1,0,Cleaning staff,2.0,-21,C
7875,5009293,F,N,N,0,130500.0,Working,Secondary / secondary special,Civil marriage,House / apartment,-15140,-4816,1,0,1,0,Cleaning staff,2.0,-22,C
7876,5009293,F,N,N,0,130500.0,Working,Secondary / secondary special,Civil marriage,House / apartment,-15140,-4816,1,0,1,0,Cleaning staff,2.0,-23,C
7877,5009293,F,N,N,0,130500.0,Working,Secondary / secondary special,Civil marriage,House / apartment,-15140,-4816,1,0,1,0,Cleaning staff,2.0,-24,C
7878,5009293,F,N,N,0,130500.0,Working,Secondary / secondary special,Civil marriage,House / apartment,-15140,-4816,1,0,1,0,Cleaning staff,2.0,-25,C
7879,5009293,F,N,N,0,130500.0,Working,Secondary / secondary special,Civil marriage,House / apartment,-15140,-4816,1,0,1,0,Cleaning staff,2.0,-26,C
7880,5009293,F,N,N,0,130500.0,Working,Secondary / secondary special,Civil marriage,House / apartment,-15140,-4816,1,0,1,0,Cleaning staff,2.0,-27,C
7881,5009293,F,N,N,0,130500.0,Working,Secondary / secondary special,Civil marriage,House / apartment,-15140,-4816,1,0,1,0,Cleaning staff,2.0,-28,C
7882,5009293,F,N,N,0,130500.0,Working,Secondary / secondary special,Civil marriage,House / apartment,-15140,-4816,1,0,1,0,Cleaning staff,2.0,-29,C
7883,5009293,F,N,N,0,130500.0,Working,Secondary / secondary special,Civil marriage,House / apartment,-15140,-4816,1,0,1,0,Cleaning staff,2.0,-30,C
7884,5009293,F,N,N,0,130500.0,Working,Secondary / secondary special,Civil marriage,House / apartment,-15140,-4816,1,0,1,0,Cleaning staff,2.0,-31,C
7885,5009293,F,N,N,0,130500.0,Working,Secondary / secondary special,Civil marriage,House / apartment,-15140,-4816,1,0,1,0,Cleaning staff,2.0,-32,C
7886,5009293,F,N,N,0,130500.0,Working,Secondary / secondary special,Civil marriage,House / apartment,-15140,-4816,1,0,1,0,Cleaning staff,2.0,-33,C
7887,5009293,F,N,N,0,130500.0,Working,Secondary / secondary special,Civil marriage,House / apartment,-15140,-4816,1,0,1,0,Cleaning staff,2.0,-34,C
7888,5009293,F,N,N,0,130500.0,Working,Secondary / secondary special,Civil marriage,House / apartment,-15140,-4816,1,0,1,0,Cleaning staff,2.0,-35,0
7889,5009293,F,N,N,0,130500.0,Working,Secondary / secondary special,Civil marriage,House / apartment,-15140,-4816,1,0,1,0,Cleaning staff,2.0,-36,0
7890,5009293,F,N,N,0,130500.0,Working,Secondary / secondary special,Civil marriage,House / apartment,-15140,-4816,1,0,1,0,Cleaning staff,2.0,-37,0
7891,5009293,F,N,N,0,130500.0,Working,Secondary / secondary special,Civil marriage,House / apartment,-15140,-4816,1,0,1,0,Cleaning staff,2.0,-38,0
7892,5009293,F,N,N,0,130500.0,Working,Secondary / secondary special,Civil marriage,House / apartment,-15140,-4816,1,0,1,0,Cleaning staff,2.0,-39,0
7893,5009294,F,N,N,0,130500.0,Working,Secondary / secondary special,Civil marriage,House / apartment,-15140,-4816,1,0,1,0,Cleaning staff,2.0,0,C
7894,5009294,F,N,N,0,130500.0,Working,Secondary / secondary special,Civil marriage,House / apartment,-15140,-4816,1,0,1,0,Cleaning staff,2.0,-1,C
7895,5009294,F,N,N,0,130500.0,Working,Secondary / secondary special,Civil marriage,House / apartment,-15140,-4816,1,0,1,0,Cleaning staff,2.0,-2,C
7896,5009294,F,N,N,0,130500.0,Working,Secondary / secondary special,Civil marriage,House / apartment,-15140,-4816,1,0,1,0,Cleaning staff,2.0,-3,C
7897,5009294,F,N,N,0,130500.0,Working,Secondary / secondary special,Civil marriage,House / apartment,-15140,-4816,1,0,1,0,Cleaning staff,2.0,-4,C
7898,5009294,F,N,N,0,130500.0,Working,Secondary / secondary special,Civil marriage,House / apartment,-15140,-4816,1,0,1,0,Cleaning staff,2.0,-5,C
7899,5009294,F,N,N,0,130500.0,Working,Secondary / secondary special,Civil marriage,House / apartment,-15140,-4816,1,0,1,0,Cleaning staff,2.0,-6,C
7900,5009294,F,N,N,0,130500.0,Working,Secondary / secondary special,Civil marriage,House / apartment,-15140,-4816,1,0,1,0,Cleaning staff,2.0,-7,C
7901,5009294,F,N,N,0,130500.0,Working,Secondary / secondary special,Civil marriage,House / apartment,-15140,-4816,1,0,1,0,Cleaning staff,2.0,-8,C
7902,5009294,F,N,N,0,130500.0,Working,Secondary / secondary special,Civil marriage,House / apartment,-15140,-4816,1,0,1,0,Cleaning staff,2.0,-9,C
7903,5009294,F,N,N,0,130500.0,Working,Secondary / secondary special,Civil marriage,House / apartment,-15140,-4816,1,0,1,0,Cleaning staff,2.0,-10,C
7904,5009294,F,N,N,0,130500.0,Working,Secondary / secondary special,Civil marriage,House / apartment,-15140,-4816,1,0,1,0,Cleaning staff,2.0,-11,C
7905,5009294,F,N,N,0,130500.0,Working,Secondary / secondary special,Civil marriage,House / apartment,-15140,-4816,1,0,1,0,Cleaning staff,2.0,-12,C
7906,5009294,F,N,N,0,130500.0,Working,Secondary / secondary special,Civil marriage,House / apartment,-15140,-4816,1,0,1,0,Cleaning staff,2.0,-13,C
7907,5009294,F,N,N,0,130500.0,Working,Secondary / secondary special,Civil marriage,House / apartment,-15140,-4816,1,0,1,0,Cleaning staff,2.0,-14,C
7908,5009294,F,N,N,0,130500.0,Working,Secondary / secondary special,Civil marriage,House / apartment,-15140,-4816,1,0,1,0,Cleaning staff,2.0,-15,C
7909,5009294,F,N,N,0,130500.0,Working,Secondary / secondary special,Civil marriage,House / apartment,-15140,-4816,1,0,1,0,Cleaning staff,2.0,-16,C
7910,5009294,F,N,N,0,130500.0,Working,Secondary / secondary special,Civil marriage,House / apartment,-15140,-4816,1,0,1,0,Cleaning staff,2.0,-17,C
7911,5009294,F,N,N,0,130500.0,Working,Secondary / secondary special,Civil marriage,House / apartment,-15140,-4816,1,0,1,0,Cleaning staff,2.0,-18,C
7912,5009294,F,N,N,0,130500.0,Working,Secondary / secondary special,Civil marriage,House / apartment,-15140,-4816,1,0,1,0,Cleaning staff,2.0,-19,C
7913,5009294,F,N,N,0,130500.0,Working,Secondary / secondary special,Civil marriage,House / apartment,-15140,-4816,1,0,1,0,Cleaning staff,2.0,-20,C
7914,5009294,F,N,N,0,130500.0,Working,Secondary / secondary special,Civil marriage,House / apartment,-15140,-4816,1,0,1,0,Cleaning staff,2.0,-21,C
7915,5009294,F,N,N,0,130500.0,Working,Secondary / secondary special,Civil marriage,House / apartment,-15140,-4816,1,0,1,0,Cleaning staff,2.0,-22,C
7916,5009294,F,N,N,0,130500.0,Working,Secondary / secondary special,Civil marriage,House / apartment,-15140,-4816,1,0,1,0,Cleaning staff,2.0,-23,C
7917,5009294,F,N,N,0,130500.0,Working,Secondary / secondary special,Civil marriage,House / apartment,-15140,-4816,1,0,1,0,Cleaning staff,2.0,-24,C
7918,5009294,F,N,N,0,130500.0,Working,Secondary / secondary special,Civil marriage,House / apartment,-15140,-4816,1,0,1,0,Cleaning staff,2.0,-25,C
7919,5009294,F,N,N,0,130500.0,Working,Secondary / secondary special,Civil marriage,House / apartment,-15140,-4816,1,0,1,0,Cleaning staff,2.0,-26,X
7920,5009294,F,N,N,0,130500.0,Working,Secondary / secondary special,Civil marriage,House / apartment,-15140,-4816,1,0,1,0,Cleaning staff,2.0,-27,X
7921,5009294,F,N,N,0,130500.0,Working,Secondary / secondary special,Civil marriage,House / apartment,-15140,-4816,1,0,1,0,Cleaning staff,2.0,-28,X
7922,5009294,F,N,N,0,130500.0,Working,Secondary / secondary special,Civil marriage,House / apartment,-15140,-4816,1,0,1,0,Cleaning staff,2.0,-29,X
7923,5009294,F,N,N,0,130500.0,Working,Secondary / secondary special,Civil marriage,House / apartment,-15140,-4816,1,0,1,0,Cleaning staff,2.0,-30,X
7924,5009295,F,N,N,0,144000.0,Pensioner,Secondary / secondary special,Married,House / apartment,-21041,365243,1,0,1,0,,2.0,0,C
7925,5009295,F,N,N,0,144000.0,Pensioner,Secondary / secondary special,Married,House / apartment,-21041,365243,1,0,1,0,,2.0,-1,C
7926,5009295,F,N,N,0,144000.0,Pensioner,Secondary / secondary special,Married,House / apartment,-21041,365243,1,0,1,0,,2.0,-2,C
7927,5009295,F,N,N,0,144000.0,Pensioner,Secondary / secondary special,Married,House / apartment,-21041,365243,1,0,1,0,,2.0,-3,C
7928,5009295,F,N,N,0,144000.0,Pensioner,Secondary / secondary special,Married,House / apartment,-21041,365243,1,0,1,0,,2.0,-4,C
7929,5009295,F,N,N,0,144000.0,Pensioner,Secondary / secondary special,Married,House / apartment,-21041,365243,1,0,1,0,,2.0,-5,C
7930,5009295,F,N,N,0,144000.0,Pensioner,Secondary / secondary special,Married,House / apartment,-21041,365243,1,0,1,0,,2.0,-6,C
7931,5009295,F,N,N,0,144000.0,Pensioner,Secondary / secondary special,Married,House / apartment,-21041,365243,1,0,1,0,,2.0,-7,C
7932,5009295,F,N,N,0,144000.0,Pensioner,Secondary / secondary special,Married,House / apartment,-21041,365243,1,0,1,0,,2.0,-8,C
7933,5009295,F,N,N,0,144000.0,Pensioner,Secondary / secondary special,Married,House / apartment,-21041,365243,1,0,1,0,,2.0,-9,C
7934,5009295,F,N,N,0,144000.0,Pensioner,Secondary / secondary special,Married,House / apartment,-21041,365243,1,0,1,0,,2.0,-10,C
7935,5009295,F,N,N,0,144000.0,Pensioner,Secondary / secondary special,Married,House / apartment,-21041,365243,1,0,1,0,,2.0,-11,C
7936,5009295,F,N,N,0,144000.0,Pensioner,Secondary / secondary special,Married,House / apartment,-21041,365243,1,0,1,0,,2.0,-12,C
7937,5009295,F,N,N,0,144000.0,Pensioner,Secondary / secondary special,Married,House / apartment,-21041,365243,1,0,1,0,,2.0,-13,C
7938,5009295,F,N,N,0,144000.0,Pensioner,Secondary / secondary special,Married,House / apartment,-21041,365243,1,0,1,0,,2.0,-14,C
7939,5009295,F,N,N,0,144000.0,Pensioner,Secondary / secondary special,Married,House / apartment,-21041,365243,1,0,1,0,,2.0,-15,C
7940,5009295,F,N,N,0,144000.0,Pensioner,Secondary / secondary special,Married,House / apartment,-21041,365243,1,0,1,0,,2.0,-16,C
7941,5009295,F,N,N,0,144000.0,Pensioner,Secondary / secondary special,Married,House / apartment,-21041,365243,1,0,1,0,,2.0,-17,C
7942,5009295,F,N,N,0,144000.0,Pensioner,Secondary / secondary special,Married,House / apartment,-21041,365243,1,0,1,0,,2.0,-18,C
7943,5009295,F,N,N,0,144000.0,Pensioner,Secondary / secondary special,Married,House / apartment,-21041,365243,1,0,1,0,,2.0,-19,C
7944,5009295,F,N,N,0,144000.0,Pensioner,Secondary / secondary special,Married,House / apartment,-21041,365243,1,0,1,0,,2.0,-20,C
7945,5009295,F,N,N,0,144000.0,Pensioner,Secondary / secondary special,Married,House / apartment,-21041,365243,1,0,1,0,,2.0,-21,0
7946,5009295,F,N,N,0,144000.0,Pensioner,Secondary / secondary special,Married,House / apartment,-21041,365243,1,0,1,0,,2.0,-22,0
7947,5009295,F,N,N,0,144000.0,Pensioner,Secondary / secondary special,Married,House / apartment,-21041,365243,1,0,1,0,,2.0,-23,X
7948,5009295,F,N,N,0,144000.0,Pensioner,Secondary / secondary special,Married,House / apartment,-21041,365243,1,0,1,0,,2.0,-24,0
7949,5009295,F,N,N,0,144000.0,Pensioner,Secondary / secondary special,Married,House / apartment,-21041,365243,1,0,1,0,,2.0,-25,X
7950,5009295,F,N,N,0,144000.0,Pensioner,Secondary / secondary special,Married,House / apartment,-21041,365243,1,0,1,0,,2.0,-26,0
7951,5009295,F,N,N,0,144000.0,Pensioner,Secondary / secondary special,Married,House / apartment,-21041,365243,1,0,1,0,,2.0,-27,X
7952,5009295,F,N,N,0,144000.0,Pensioner,Secondary / secondary special,Married,House / apartment,-21041,365243,1,0,1,0,,2.0,-28,0
7953,5009295,F,N,N,0,144000.0,Pensioner,Secondary / secondary special,Married,House / apartment,-21041,365243,1,0,1,0,,2.0,-29,0
7954,5009295,F,N,N,0,144000.0,Pensioner,Secondary / secondary special,Married,House / apartment,-21041,365243,1,0,1,0,,2.0,-30,0
7955,5009295,F,N,N,0,144000.0,Pensioner,Secondary / secondary special,Married,House / apartment,-21041,365243,1,0,1,0,,2.0,-31,X
7956,5009295,F,N,N,0,144000.0,Pensioner,Secondary / secondary special,Married,House / apartment,-21041,365243,1,0,1,0,,2.0,-32,X
7957,5009295,F,N,N,0,144000.0,Pensioner,Secondary / secondary special,Married,House / apartment,-21041,365243,1,0,1,0,,2.0,-33,X
7958,5009296,F,N,N,0,144000.0,Pensioner,Secondary / secondary special,Married,House / apartment,-21041,365243,1,0,1,0,,2.0,0,0
7959,5009296,F,N,N,0,144000.0,Pensioner,Secondary / secondary special,Married,House / apartment,-21041,365243,1,0,1,0,,2.0,-1,0
7960,5009297,F,N,N,0,193500.0,Working,Secondary / secondary special,Single / not married,Municipal apartment,-16099,-1866,1,0,1,0,Laborers,1.0,0,1
7961,5009297,F,N,N,0,193500.0,Working,Secondary / secondary special,Single / not married,Municipal apartment,-16099,-1866,1,0,1,0,Laborers,1.0,-1,0
7962,5009297,F,N,N,0,193500.0,Working,Secondary / secondary special,Single / not married,Municipal apartment,-16099,-1866,1,0,1,0,Laborers,1.0,-2,0
7963,5009297,F,N,N,0,193500.0,Working,Secondary / secondary special,Single / not married,Municipal apartment,-16099,-1866,1,0,1,0,Laborers,1.0,-3,0
7964,5009297,F,N,N,0,193500.0,Working,Secondary / secondary special,Single / not married,Municipal apartment,-16099,-1866,1,0,1,0,Laborers,1.0,-4,0
7965,5009297,F,N,N,0,193500.0,Working,Secondary / secondary special,Single / not married,Municipal apartment,-16099,-1866,1,0,1,0,Laborers,1.0,-5,0
7966,5009297,F,N,N,0,193500.0,Working,Secondary / secondary special,Single / not married,Municipal apartment,-16099,-1866,1,0,1,0,Laborers,1.0,-6,X
7967,5009297,F,N,N,0,193500.0,Working,Secondary / secondary special,Single / not married,Municipal apartment,-16099,-1866,1,0,1,0,Laborers,1.0,-7,0
7968,5009297,F,N,N,0,193500.0,Working,Secondary / secondary special,Single / not married,Municipal apartment,-16099,-1866,1,0,1,0,Laborers,1.0,-8,X
7969,5009297,F,N,N,0,193500.0,Working,Secondary / secondary special,Single / not married,Municipal apartment,-16099,-1866,1,0,1,0,Laborers,1.0,-9,0
7970,5009297,F,N,N,0,193500.0,Working,Secondary / secondary special,Single / not married,Municipal apartment,-16099,-1866,1,0,1,0,Laborers,1.0,-10,X
7971,5009297,F,N,N,0,193500.0,Working,Secondary / secondary special,Single / not married,Municipal apartment,-16099,-1866,1,0,1,0,Laborers,1.0,-11,0
7972,5009297,F,N,N,0,193500.0,Working,Secondary / secondary special,Single / not married,Municipal apartment,-16099,-1866,1,0,1,0,Laborers,1.0,-12,0
7973,5009297,F,N,N,0,193500.0,Working,Secondary / secondary special,Single / not married,Municipal apartment,-16099,-1866,1,0,1,0,Laborers,1.0,-13,X
7974,5009297,F,N,N,0,193500.0,Working,Secondary / secondary special,Single / not married,Municipal apartment,-16099,-1866,1,0,1,0,Laborers,1.0,-14,X
7975,5009297,F,N,N,0,193500.0,Working,Secondary / secondary special,Single / not married,Municipal apartment,-16099,-1866,1,0,1,0,Laborers,1.0,-15,0
7976,5009297,F,N,N,0,193500.0,Working,Secondary / secondary special,Single / not married,Municipal apartment,-16099,-1866,1,0,1,0,Laborers,1.0,-16,0
7977,5009297,F,N,N,0,193500.0,Working,Secondary / secondary special,Single / not married,Municipal apartment,-16099,-1866,1,0,1,0,Laborers,1.0,-17,0
7978,5009297,F,N,N,0,193500.0,Working,Secondary / secondary special,Single / not married,Municipal apartment,-16099,-1866,1,0,1,0,Laborers,1.0,-18,X
7979,5009297,F,N,N,0,193500.0,Working,Secondary / secondary special,Single / not married,Municipal apartment,-16099,-1866,1,0,1,0,Laborers,1.0,-19,0
7980,5009297,F,N,N,0,193500.0,Working,Secondary / secondary special,Single / not married,Municipal apartment,-16099,-1866,1,0,1,0,Laborers,1.0,-20,0
7981,5009297,F,N,N,0,193500.0,Working,Secondary / secondary special,Single / not married,Municipal apartment,-16099,-1866,1,0,1,0,Laborers,1.0,-21,0
7982,5009297,F,N,N,0,193500.0,Working,Secondary / secondary special,Single / not married,Municipal apartment,-16099,-1866,1,0,1,0,Laborers,1.0,-22,X
7983,5009299,F,N,N,0,193500.0,Working,Secondary / secondary special,Single / not married,Municipal apartment,-16099,-1866,1,0,1,0,Laborers,1.0,0,X
7984,5009299,F,N,N,0,193500.0,Working,Secondary / secondary special,Single / not married,Municipal apartment,-16099,-1866,1,0,1,0,Laborers,1.0,-1,X
7985,5009299,F,N,N,0,193500.0,Working,Secondary / secondary special,Single / not married,Municipal apartment,-16099,-1866,1,0,1,0,Laborers,1.0,-2,0
7986,5009299,F,N,N,0,193500.0,Working,Secondary / secondary special,Single / not married,Municipal apartment,-16099,-1866,1,0,1,0,Laborers,1.0,-3,0
7987,5009299,F,N,N,0,193500.0,Working,Secondary / secondary special,Single / not married,Municipal apartment,-16099,-1866,1,0,1,0,Laborers,1.0,-4,0
7988,5009299,F,N,N,0,193500.0,Working,Secondary / secondary special,Single / not married,Municipal apartment,-16099,-1866,1,0,1,0,Laborers,1.0,-5,0
7989,5009299,F,N,N,0,193500.0,Working,Secondary / secondary special,Single / not married,Municipal apartment,-16099,-1866,1,0,1,0,Laborers,1.0,-6,0
7990,5009299,F,N,N,0,193500.0,Working,Secondary / secondary special,Single / not married,Municipal apartment,-16099,-1866,1,0,1,0,Laborers,1.0,-7,0
7991,5009299,F,N,N,0,193500.0,Working,Secondary / secondary special,Single / not married,Municipal apartment,-16099,-1866,1,0,1,0,Laborers,1.0,-8,0
7992,5009299,F,N,N,0,193500.0,Working,Secondary / secondary special,Single / not married,Municipal apartment,-16099,-1866,1,0,1,0,Laborers,1.0,-9,0
7993,5009299,F,N,N,0,193500.0,Working,Secondary / secondary special,Single / not married,Municipal apartment,-16099,-1866,1,0,1,0,Laborers,1.0,-10,0
7994,5009299,F,N,N,0,193500.0,Working,Secondary / secondary special,Single / not married,Municipal apartment,-16099,-1866,1,0,1,0,Laborers,1.0,-11,0
7995,5009299,F,N,N,0,193500.0,Working,Secondary / secondary special,Single / not married,Municipal apartment,-16099,-1866,1,0,1,0,Laborers,1.0,-12,0
7996,5009299,F,N,N,0,193500.0,Working,Secondary / secondary special,Single / not married,Municipal apartment,-16099,-1866,1,0,1,0,Laborers,1.0,-13,0
7997,5009299,F,N,N,0,193500.0,Working,Secondary / secondary special,Single / not married,Municipal apartment,-16099,-1866,1,0,1,0,Laborers,1.0,-14,0
7998,5009299,F,N,N,0,193500.0,Working,Secondary / secondary special,Single / not married,Municipal apartment,-16099,-1866,1,0,1,0,Laborers,1.0,-15,0
7999,5009299,F,N,N,0,193500.0,Working,Secondary / secondary special,Single / not married,Municipal apartment,-16099,-1866,1,0,1,0,Laborers,1.0,-16,0
8000,5009299,F,N,N,0,193500.0,Working,Secondary / secondary special,Single / not married,Municipal apartment,-16099,-1866,1,0,1,0,Laborers,1.0,-17,0
8001,5009299,F,N,N,0,193500.0,Working,Secondary / secondary special,Single / not married,Municipal apartment,-16099,-1866,1,0,1,0,Laborers,1.0,-18,0
8002,5009299,F,N,N,0,193500.0,Working,Secondary / secondary special,Single / not married,Municipal apartment,-16099,-1866,1,0,1,0,Laborers,1.0,-19,0
8003,5009299,F,N,N,0,193500.0,Working,Secondary / secondary special,Single / not married,Municipal apartment,-16099,-1866,1,0,1,0,Laborers,1.0,-20,0
8004,5009299,F,N,N,0,193500.0,Working,Secondary / secondary special,Single / not married,Municipal apartment,-16099,-1866,1,0,1,0,Laborers,1.0,-21,0
8005,5009299,F,N,N,0,193500.0,Working,Secondary / secondary special,Single / not married,Municipal apartment,-16099,-1866,1,0,1,0,Laborers,1.0,-22,0
8006,5009299,F,N,N,0,193500.0,Working,Secondary / secondary special,Single / not married,Municipal apartment,-16099,-1866,1,0,1,0,Laborers,1.0,-23,0
8007,5009299,F,N,N,0,193500.0,Working,Secondary / secondary special,Single / not married,Municipal apartment,-16099,-1866,1,0,1,0,Laborers,1.0,-24,0
8008,5009299,F,N,N,0,193500.0,Working,Secondary / secondary special,Single / not married,Municipal apartment,-16099,-1866,1,0,1,0,Laborers,1.0,-25,1
8009,5009299,F,N,N,0,193500.0,Working,Secondary / secondary special,Single / not married,Municipal apartment,-16099,-1866,1,0,1,0,Laborers,1.0,-26,0
8010,5009299,F,N,N,0,193500.0,Working,Secondary / secondary special,Single / not married,Municipal apartment,-16099,-1866,1,0,1,0,Laborers,1.0,-27,0
8011,5009299,F,N,N,0,193500.0,Working,Secondary / secondary special,Single / not married,Municipal apartment,-16099,-1866,1,0,1,0,Laborers,1.0,-28,0
8012,5009299,F,N,N,0,193500.0,Working,Secondary / secondary special,Single / not married,Municipal apartment,-16099,-1866,1,0,1,0,Laborers,1.0,-29,0
8013,5009299,F,N,N,0,193500.0,Working,Secondary / secondary special,Single / not married,Municipal apartment,-16099,-1866,1,0,1,0,Laborers,1.0,-30,0
8014,5009299,F,N,N,0,193500.0,Working,Secondary / secondary special,Single / not married,Municipal apartment,-16099,-1866,1,0,1,0,Laborers,1.0,-31,0
8015,5009299,F,N,N,0,193500.0,Working,Secondary / secondary special,Single / not married,Municipal apartment,-16099,-1866,1,0,1,0,Laborers,1.0,-32,0
8016,5009299,F,N,N,0,193500.0,Working,Secondary / secondary special,Single / not married,Municipal apartment,-16099,-1866,1,0,1,0,Laborers,1.0,-33,0
8017,5009300,F,N,N,0,193500.0,Working,Secondary / secondary special,Single / not married,Municipal apartment,-16099,-1866,1,0,1,0,Laborers,1.0,0,X
8018,5009300,F,N,N,0,193500.0,Working,Secondary / secondary special,Single / not married,Municipal apartment,-16099,-1866,1,0,1,0,Laborers,1.0,-1,0
8019,5009300,F,N,N,0,193500.0,Working,Secondary / secondary special,Single / not married,Municipal apartment,-16099,-1866,1,0,1,0,Laborers,1.0,-2,0
8020,5009300,F,N,N,0,193500.0,Working,Secondary / secondary special,Single / not married,Municipal apartment,-16099,-1866,1,0,1,0,Laborers,1.0,-3,X
8021,5009300,F,N,N,0,193500.0,Working,Secondary / secondary special,Single / not married,Municipal apartment,-16099,-1866,1,0,1,0,Laborers,1.0,-4,X
8022,5009300,F,N,N,0,193500.0,Working,Secondary / secondary special,Single / not married,Municipal apartment,-16099,-1866,1,0,1,0,Laborers,1.0,-5,0
8023,5009300,F,N,N,0,193500.0,Working,Secondary / secondary special,Single / not married,Municipal apartment,-16099,-1866,1,0,1,0,Laborers,1.0,-6,0
8024,5009300,F,N,N,0,193500.0,Working,Secondary / secondary special,Single / not married,Municipal apartment,-16099,-1866,1,0,1,0,Laborers,1.0,-7,0
8025,5009300,F,N,N,0,193500.0,Working,Secondary / secondary special,Single / not married,Municipal apartment,-16099,-1866,1,0,1,0,Laborers,1.0,-8,X
8026,5009300,F,N,N,0,193500.0,Working,Secondary / secondary special,Single / not married,Municipal apartment,-16099,-1866,1,0,1,0,Laborers,1.0,-9,0
8027,5009300,F,N,N,0,193500.0,Working,Secondary / secondary special,Single / not married,Municipal apartment,-16099,-1866,1,0,1,0,Laborers,1.0,-10,0
8028,5009300,F,N,N,0,193500.0,Working,Secondary / secondary special,Single / not married,Municipal apartment,-16099,-1866,1,0,1,0,Laborers,1.0,-11,0
8029,5009300,F,N,N,0,193500.0,Working,Secondary / secondary special,Single / not married,Municipal apartment,-16099,-1866,1,0,1,0,Laborers,1.0,-12,X
8030,5009301,F,N,N,0,193500.0,Working,Secondary / secondary special,Single / not married,Municipal apartment,-16099,-1866,1,0,1,0,Laborers,1.0,0,C
8031,5009301,F,N,N,0,193500.0,Working,Secondary / secondary special,Single / not married,Municipal apartment,-16099,-1866,1,0,1,0,Laborers,1.0,-1,C
8032,5009301,F,N,N,0,193500.0,Working,Secondary / secondary special,Single / not married,Municipal apartment,-16099,-1866,1,0,1,0,Laborers,1.0,-2,C
8033,5009301,F,N,N,0,193500.0,Working,Secondary / secondary special,Single / not married,Municipal apartment,-16099,-1866,1,0,1,0,Laborers,1.0,-3,0
8034,5009301,F,N,N,0,193500.0,Working,Secondary / secondary special,Single / not married,Municipal apartment,-16099,-1866,1,0,1,0,Laborers,1.0,-4,0
8035,5009301,F,N,N,0,193500.0,Working,Secondary / secondary special,Single / not married,Municipal apartment,-16099,-1866,1,0,1,0,Laborers,1.0,-5,0
8036,5009301,F,N,N,0,193500.0,Working,Secondary / secondary special,Single / not married,Municipal apartment,-16099,-1866,1,0,1,0,Laborers,1.0,-6,0
8037,5009301,F,N,N,0,193500.0,Working,Secondary / secondary special,Single / not married,Municipal apartment,-16099,-1866,1,0,1,0,Laborers,1.0,-7,0
8038,5009301,F,N,N,0,193500.0,Working,Secondary / secondary special,Single / not married,Municipal apartment,-16099,-1866,1,0,1,0,Laborers,1.0,-8,0
8039,5009302,F,N,N,0,112500.0,Pensioner,Secondary / secondary special,Widow,House / apartment,-22061,365243,1,0,0,0,,1.0,0,C
8040,5009302,F,N,N,0,112500.0,Pensioner,Secondary / secondary special,Widow,House / apartment,-22061,365243,1,0,0,0,,1.0,-1,C
8041,5009302,F,N,N,0,112500.0,Pensioner,Secondary / secondary special,Widow,House / apartment,-22061,365243,1,0,0,0,,1.0,-2,C
8042,5009302,F,N,N,0,112500.0,Pensioner,Secondary / secondary special,Widow,House / apartment,-22061,365243,1,0,0,0,,1.0,-3,C
8043,5009302,F,N,N,0,112500.0,Pensioner,Secondary / secondary special,Widow,House / apartment,-22061,365243,1,0,0,0,,1.0,-4,C
8044,5009302,F,N,N,0,112500.0,Pensioner,Secondary / secondary special,Widow,House / apartment,-22061,365243,1,0,0,0,,1.0,-5,C
8045,5009302,F,N,N,0,112500.0,Pensioner,Secondary / secondary special,Widow,House / apartment,-22061,365243,1,0,0,0,,1.0,-6,C
8046,5009302,F,N,N,0,112500.0,Pensioner,Secondary / secondary special,Widow,House / apartment,-22061,365243,1,0,0,0,,1.0,-7,C
8047,5009302,F,N,N,0,112500.0,Pensioner,Secondary / secondary special,Widow,House / apartment,-22061,365243,1,0,0,0,,1.0,-8,C
8048,5009302,F,N,N,0,112500.0,Pensioner,Secondary / secondary special,Widow,House / apartment,-22061,365243,1,0,0,0,,1.0,-9,C
8049,5009302,F,N,N,0,112500.0,Pensioner,Secondary / secondary special,Widow,House / apartment,-22061,365243,1,0,0,0,,1.0,-10,C
8050,5009302,F,N,N,0,112500.0,Pensioner,Secondary / secondary special,Widow,House / apartment,-22061,365243,1,0,0,0,,1.0,-11,C
8051,5009302,F,N,N,0,112500.0,Pensioner,Secondary / secondary special,Widow,House / apartment,-22061,365243,1,0,0,0,,1.0,-12,C
8052,5009302,F,N,N,0,112500.0,Pensioner,Secondary / secondary special,Widow,House / apartment,-22061,365243,1,0,0,0,,1.0,-13,C
8053,5009302,F,N,N,0,112500.0,Pensioner,Secondary / secondary special,Widow,House / apartment,-22061,365243,1,0,0,0,,1.0,-14,C
8054,5009302,F,N,N,0,112500.0,Pensioner,Secondary / secondary special,Widow,House / apartment,-22061,365243,1,0,0,0,,1.0,-15,C
8055,5009302,F,N,N,0,112500.0,Pensioner,Secondary / secondary special,Widow,House / apartment,-22061,365243,1,0,0,0,,1.0,-16,0
8056,5009302,F,N,N,0,112500.0,Pensioner,Secondary / secondary special,Widow,House / apartment,-22061,365243,1,0,0,0,,1.0,-17,0
8057,5009302,F,N,N,0,112500.0,Pensioner,Secondary / secondary special,Widow,House / apartment,-22061,365243,1,0,0,0,,1.0,-18,0
8058,5009302,F,N,N,0,112500.0,Pensioner,Secondary / secondary special,Widow,House / apartment,-22061,365243,1,0,0,0,,1.0,-19,0
8059,5009302,F,N,N,0,112500.0,Pensioner,Secondary / secondary special,Widow,House / apartment,-22061,365243,1,0,0,0,,1.0,-20,0
8060,5009302,F,N,N,0,112500.0,Pensioner,Secondary / secondary special,Widow,House / apartment,-22061,365243,1,0,0,0,,1.0,-21,0
8061,5009302,F,N,N,0,112500.0,Pensioner,Secondary / secondary special,Widow,House / apartment,-22061,365243,1,0,0,0,,1.0,-22,0
8062,5009302,F,N,N,0,112500.0,Pensioner,Secondary / secondary special,Widow,House / apartment,-22061,365243,1,0,0,0,,1.0,-23,0
8063,5009302,F,N,N,0,112500.0,Pensioner,Secondary / secondary special,Widow,House / apartment,-22061,365243,1,0,0,0,,1.0,-24,0
8064,5009302,F,N,N,0,112500.0,Pensioner,Secondary / secondary special,Widow,House / apartment,-22061,365243,1,0,0,0,,1.0,-25,0
8065,5009303,F,N,N,0,112500.0,Pensioner,Secondary / secondary special,Widow,House / apartment,-22061,365243,1,0,0,0,,1.0,-23,X
8066,5009303,F,N,N,0,112500.0,Pensioner,Secondary / secondary special,Widow,House / apartment,-22061,365243,1,0,0,0,,1.0,-24,0
8067,5009303,F,N,N,0,112500.0,Pensioner,Secondary / secondary special,Widow,House / apartment,-22061,365243,1,0,0,0,,1.0,-25,0
8068,5009303,F,N,N,0,112500.0,Pensioner,Secondary / secondary special,Widow,House / apartment,-22061,365243,1,0,0,0,,1.0,-26,0
8069,5009303,F,N,N,0,112500.0,Pensioner,Secondary / secondary special,Widow,House / apartment,-22061,365243,1,0,0,0,,1.0,-27,0
8070,5009303,F,N,N,0,112500.0,Pensioner,Secondary / secondary special,Widow,House / apartment,-22061,365243,1,0,0,0,,1.0,-28,0
8071,5009303,F,N,N,0,112500.0,Pensioner,Secondary / secondary special,Widow,House / apartment,-22061,365243,1,0,0,0,,1.0,-29,0
8072,5009303,F,N,N,0,112500.0,Pensioner,Secondary / secondary special,Widow,House / apartment,-22061,365243,1,0,0,0,,1.0,-30,0
8073,5009303,F,N,N,0,112500.0,Pensioner,Secondary / secondary special,Widow,House / apartment,-22061,365243,1,0,0,0,,1.0,-31,0
8074,5009303,F,N,N,0,112500.0,Pensioner,Secondary / secondary special,Widow,House / apartment,-22061,365243,1,0,0,0,,1.0,-32,0
8075,5009303,F,N,N,0,112500.0,Pensioner,Secondary / secondary special,Widow,House / apartment,-22061,365243,1,0,0,0,,1.0,-33,0
8076,5009303,F,N,N,0,112500.0,Pensioner,Secondary / secondary special,Widow,House / apartment,-22061,365243,1,0,0,0,,1.0,-34,0
8077,5009303,F,N,N,0,112500.0,Pensioner,Secondary / secondary special,Widow,House / apartment,-22061,365243,1,0,0,0,,1.0,-35,0
8078,5009303,F,N,N,0,112500.0,Pensioner,Secondary / secondary special,Widow,House / apartment,-22061,365243,1,0,0,0,,1.0,-36,0
8079,5009303,F,N,N,0,112500.0,Pensioner,Secondary / secondary special,Widow,House / apartment,-22061,365243,1,0,0,0,,1.0,-37,0
8080,5009303,F,N,N,0,112500.0,Pensioner,Secondary / secondary special,Widow,House / apartment,-22061,365243,1,0,0,0,,1.0,-38,0
8081,5009303,F,N,N,0,112500.0,Pensioner,Secondary / secondary special,Widow,House / apartment,-22061,365243,1,0,0,0,,1.0,-39,0
8082,5009303,F,N,N,0,112500.0,Pensioner,Secondary / secondary special,Widow,House / apartment,-22061,365243,1,0,0,0,,1.0,-40,0
8083,5009303,F,N,N,0,112500.0,Pensioner,Secondary / secondary special,Widow,House / apartment,-22061,365243,1,0,0,0,,1.0,-41,0
8084,5009303,F,N,N,0,112500.0,Pensioner,Secondary / secondary special,Widow,House / apartment,-22061,365243,1,0,0,0,,1.0,-42,0
8085,5009303,F,N,N,0,112500.0,Pensioner,Secondary / secondary special,Widow,House / apartment,-22061,365243,1,0,0,0,,1.0,-43,0
8086,5009303,F,N,N,0,112500.0,Pensioner,Secondary / secondary special,Widow,House / apartment,-22061,365243,1,0,0,0,,1.0,-44,0
8087,5009303,F,N,N,0,112500.0,Pensioner,Secondary / secondary special,Widow,House / apartment,-22061,365243,1,0,0,0,,1.0,-45,0
8088,5009303,F,N,N,0,112500.0,Pensioner,Secondary / secondary special,Widow,House / apartment,-22061,365243,1,0,0,0,,1.0,-46,0
8089,5009303,F,N,N,0,112500.0,Pensioner,Secondary / secondary special,Widow,House / apartment,-22061,365243,1,0,0,0,,1.0,-47,0
8090,5009303,F,N,N,0,112500.0,Pensioner,Secondary / secondary special,Widow,House / apartment,-22061,365243,1,0,0,0,,1.0,-48,0
8091,5009303,F,N,N,0,112500.0,Pensioner,Secondary / secondary special,Widow,House / apartment,-22061,365243,1,0,0,0,,1.0,-49,0
8092,5009303,F,N,N,0,112500.0,Pensioner,Secondary / secondary special,Widow,House / apartment,-22061,365243,1,0,0,0,,1.0,-50,0
8093,5009303,F,N,N,0,112500.0,Pensioner,Secondary / secondary special,Widow,House / apartment,-22061,365243,1,0,0,0,,1.0,-51,0
8094,5009303,F,N,N,0,112500.0,Pensioner,Secondary / secondary special,Widow,House / apartment,-22061,365243,1,0,0,0,,1.0,-52,0
8095,5009303,F,N,N,0,112500.0,Pensioner,Secondary / secondary special,Widow,House / apartment,-22061,365243,1,0,0,0,,1.0,-53,0
8096,5009303,F,N,N,0,112500.0,Pensioner,Secondary / secondary special,Widow,House / apartment,-22061,365243,1,0,0,0,,1.0,-54,0
8097,5009303,F,N,N,0,112500.0,Pensioner,Secondary / secondary special,Widow,House / apartment,-22061,365243,1,0,0,0,,1.0,-55,0
8098,5009303,F,N,N,0,112500.0,Pensioner,Secondary / secondary special,Widow,House / apartment,-22061,365243,1,0,0,0,,1.0,-56,0
8099,5009303,F,N,N,0,112500.0,Pensioner,Secondary / secondary special,Widow,House / apartment,-22061,365243,1,0,0,0,,1.0,-57,0
8100,5009303,F,N,N,0,112500.0,Pensioner,Secondary / secondary special,Widow,House / apartment,-22061,365243,1,0,0,0,,1.0,-58,X
8101,5009304,F,N,N,0,112500.0,Pensioner,Secondary / secondary special,Widow,House / apartment,-22061,365243,1,0,0,0,,1.0,0,C
8102,5009304,F,N,N,0,112500.0,Pensioner,Secondary / secondary special,Widow,House / apartment,-22061,365243,1,0,0,0,,1.0,-1,C
8103,5009304,F,N,N,0,112500.0,Pensioner,Secondary / secondary special,Widow,House / apartment,-22061,365243,1,0,0,0,,1.0,-2,C
8104,5009304,F,N,N,0,112500.0,Pensioner,Secondary / secondary special,Widow,House / apartment,-22061,365243,1,0,0,0,,1.0,-3,C
8105,5009304,F,N,N,0,112500.0,Pensioner,Secondary / secondary special,Widow,House / apartment,-22061,365243,1,0,0,0,,1.0,-4,C
8106,5009304,F,N,N,0,112500.0,Pensioner,Secondary / secondary special,Widow,House / apartment,-22061,365243,1,0,0,0,,1.0,-5,C
8107,5009304,F,N,N,0,112500.0,Pensioner,Secondary / secondary special,Widow,House / apartment,-22061,365243,1,0,0,0,,1.0,-6,X
8108,5009304,F,N,N,0,112500.0,Pensioner,Secondary / secondary special,Widow,House / apartment,-22061,365243,1,0,0,0,,1.0,-7,0
8109,5009304,F,N,N,0,112500.0,Pensioner,Secondary / secondary special,Widow,House / apartment,-22061,365243,1,0,0,0,,1.0,-8,X
8110,5009304,F,N,N,0,112500.0,Pensioner,Secondary / secondary special,Widow,House / apartment,-22061,365243,1,0,0,0,,1.0,-9,0
8111,5009304,F,N,N,0,112500.0,Pensioner,Secondary / secondary special,Widow,House / apartment,-22061,365243,1,0,0,0,,1.0,-10,0
8112,5009304,F,N,N,0,112500.0,Pensioner,Secondary / secondary special,Widow,House / apartment,-22061,365243,1,0,0,0,,1.0,-11,X
8113,5009304,F,N,N,0,112500.0,Pensioner,Secondary / secondary special,Widow,House / apartment,-22061,365243,1,0,0,0,,1.0,-12,X
8114,5009304,F,N,N,0,112500.0,Pensioner,Secondary / secondary special,Widow,House / apartment,-22061,365243,1,0,0,0,,1.0,-13,X
8115,5009304,F,N,N,0,112500.0,Pensioner,Secondary / secondary special,Widow,House / apartment,-22061,365243,1,0,0,0,,1.0,-14,0
8116,5009304,F,N,N,0,112500.0,Pensioner,Secondary / secondary special,Widow,House / apartment,-22061,365243,1,0,0,0,,1.0,-15,X
8117,5009304,F,N,N,0,112500.0,Pensioner,Secondary / secondary special,Widow,House / apartment,-22061,365243,1,0,0,0,,1.0,-16,X
8118,5009304,F,N,N,0,112500.0,Pensioner,Secondary / secondary special,Widow,House / apartment,-22061,365243,1,0,0,0,,1.0,-17,X
8119,5009304,F,N,N,0,112500.0,Pensioner,Secondary / secondary special,Widow,House / apartment,-22061,365243,1,0,0,0,,1.0,-18,X
8120,5009304,F,N,N,0,112500.0,Pensioner,Secondary / secondary special,Widow,House / apartment,-22061,365243,1,0,0,0,,1.0,-19,X
8121,5009304,F,N,N,0,112500.0,Pensioner,Secondary / secondary special,Widow,House / apartment,-22061,365243,1,0,0,0,,1.0,-20,X
8122,5009304,F,N,N,0,112500.0,Pensioner,Secondary / secondary special,Widow,House / apartment,-22061,365243,1,0,0,0,,1.0,-21,0
8123,5009304,F,N,N,0,112500.0,Pensioner,Secondary / secondary special,Widow,House / apartment,-22061,365243,1,0,0,0,,1.0,-22,X
8124,5009304,F,N,N,0,112500.0,Pensioner,Secondary / secondary special,Widow,House / apartment,-22061,365243,1,0,0,0,,1.0,-23,X
8125,5009304,F,N,N,0,112500.0,Pensioner,Secondary / secondary special,Widow,House / apartment,-22061,365243,1,0,0,0,,1.0,-24,X
8126,5009304,F,N,N,0,112500.0,Pensioner,Secondary / secondary special,Widow,House / apartment,-22061,365243,1,0,0,0,,1.0,-25,X
8127,5009304,F,N,N,0,112500.0,Pensioner,Secondary / secondary special,Widow,House / apartment,-22061,365243,1,0,0,0,,1.0,-26,X
8128,5009304,F,N,N,0,112500.0,Pensioner,Secondary / secondary special,Widow,House / apartment,-22061,365243,1,0,0,0,,1.0,-27,X
8129,5009304,F,N,N,0,112500.0,Pensioner,Secondary / secondary special,Widow,House / apartment,-22061,365243,1,0,0,0,,1.0,-28,X
8130,5009304,F,N,N,0,112500.0,Pensioner,Secondary / secondary special,Widow,House / apartment,-22061,365243,1,0,0,0,,1.0,-29,X
8131,5009304,F,N,N,0,112500.0,Pensioner,Secondary / secondary special,Widow,House / apartment,-22061,365243,1,0,0,0,,1.0,-30,X
8132,5009304,F,N,N,0,112500.0,Pensioner,Secondary / secondary special,Widow,House / apartment,-22061,365243,1,0,0,0,,1.0,-31,X
8133,5009304,F,N,N,0,112500.0,Pensioner,Secondary / secondary special,Widow,House / apartment,-22061,365243,1,0,0,0,,1.0,-32,X
8134,5009304,F,N,N,0,112500.0,Pensioner,Secondary / secondary special,Widow,House / apartment,-22061,365243,1,0,0,0,,1.0,-33,X
8135,5009304,F,N,N,0,112500.0,Pensioner,Secondary / secondary special,Widow,House / apartment,-22061,365243,1,0,0,0,,1.0,-34,X
8136,5009305,F,N,N,0,112500.0,Pensioner,Secondary / secondary special,Widow,House / apartment,-22061,365243,1,0,0,0,,1.0,0,0
8137,5009305,F,N,N,0,112500.0,Pensioner,Secondary / secondary special,Widow,House / apartment,-22061,365243,1,0,0,0,,1.0,-1,0
8138,5009305,F,N,N,0,112500.0,Pensioner,Secondary / secondary special,Widow,House / apartment,-22061,365243,1,0,0,0,,1.0,-2,0
8139,5009305,F,N,N,0,112500.0,Pensioner,Secondary / secondary special,Widow,House / apartment,-22061,365243,1,0,0,0,,1.0,-3,0
8140,5009305,F,N,N,0,112500.0,Pensioner,Secondary / secondary special,Widow,House / apartment,-22061,365243,1,0,0,0,,1.0,-4,0
8141,5009305,F,N,N,0,112500.0,Pensioner,Secondary / secondary special,Widow,House / apartment,-22061,365243,1,0,0,0,,1.0,-5,0
8142,5009305,F,N,N,0,112500.0,Pensioner,Secondary / secondary special,Widow,House / apartment,-22061,365243,1,0,0,0,,1.0,-6,0
8143,5009305,F,N,N,0,112500.0,Pensioner,Secondary / secondary special,Widow,House / apartment,-22061,365243,1,0,0,0,,1.0,-7,0
8144,5009305,F,N,N,0,112500.0,Pensioner,Secondary / secondary special,Widow,House / apartment,-22061,365243,1,0,0,0,,1.0,-8,0
8145,5009305,F,N,N,0,112500.0,Pensioner,Secondary / secondary special,Widow,House / apartment,-22061,365243,1,0,0,0,,1.0,-9,0
8146,5009305,F,N,N,0,112500.0,Pensioner,Secondary / secondary special,Widow,House / apartment,-22061,365243,1,0,0,0,,1.0,-10,0
8147,5009305,F,N,N,0,112500.0,Pensioner,Secondary / secondary special,Widow,House / apartment,-22061,365243,1,0,0,0,,1.0,-11,X
8148,5009305,F,N,N,0,112500.0,Pensioner,Secondary / secondary special,Widow,House / apartment,-22061,365243,1,0,0,0,,1.0,-12,X
8149,5009306,F,Y,N,0,135000.0,Pensioner,Secondary / secondary special,Married,House / apartment,-20140,365243,1,0,1,1,,2.0,-33,X
8150,5009306,F,Y,N,0,135000.0,Pensioner,Secondary / secondary special,Married,House / apartment,-20140,365243,1,0,1,1,,2.0,-34,0
8151,5009306,F,Y,N,0,135000.0,Pensioner,Secondary / secondary special,Married,House / apartment,-20140,365243,1,0,1,1,,2.0,-35,0
8152,5009306,F,Y,N,0,135000.0,Pensioner,Secondary / secondary special,Married,House / apartment,-20140,365243,1,0,1,1,,2.0,-36,0
8153,5009306,F,Y,N,0,135000.0,Pensioner,Secondary / secondary special,Married,House / apartment,-20140,365243,1,0,1,1,,2.0,-37,0
8154,5009306,F,Y,N,0,135000.0,Pensioner,Secondary / secondary special,Married,House / apartment,-20140,365243,1,0,1,1,,2.0,-38,0
8155,5009306,F,Y,N,0,135000.0,Pensioner,Secondary / secondary special,Married,House / apartment,-20140,365243,1,0,1,1,,2.0,-39,X
8156,5009306,F,Y,N,0,135000.0,Pensioner,Secondary / secondary special,Married,House / apartment,-20140,365243,1,0,1,1,,2.0,-40,0
8157,5009306,F,Y,N,0,135000.0,Pensioner,Secondary / secondary special,Married,House / apartment,-20140,365243,1,0,1,1,,2.0,-41,0
8158,5009306,F,Y,N,0,135000.0,Pensioner,Secondary / secondary special,Married,House / apartment,-20140,365243,1,0,1,1,,2.0,-42,X
8159,5009306,F,Y,N,0,135000.0,Pensioner,Secondary / secondary special,Married,House / apartment,-20140,365243,1,0,1,1,,2.0,-43,0
8160,5009306,F,Y,N,0,135000.0,Pensioner,Secondary / secondary special,Married,House / apartment,-20140,365243,1,0,1,1,,2.0,-44,X
8161,5009306,F,Y,N,0,135000.0,Pensioner,Secondary / secondary special,Married,House / apartment,-20140,365243,1,0,1,1,,2.0,-45,0
8162,5009306,F,Y,N,0,135000.0,Pensioner,Secondary / secondary special,Married,House / apartment,-20140,365243,1,0,1,1,,2.0,-46,X
8163,5009306,F,Y,N,0,135000.0,Pensioner,Secondary / secondary special,Married,House / apartment,-20140,365243,1,0,1,1,,2.0,-47,X
8164,5009306,F,Y,N,0,135000.0,Pensioner,Secondary / secondary special,Married,House / apartment,-20140,365243,1,0,1,1,,2.0,-48,0
8165,5009306,F,Y,N,0,135000.0,Pensioner,Secondary / secondary special,Married,House / apartment,-20140,365243,1,0,1,1,,2.0,-49,0
8166,5009306,F,Y,N,0,135000.0,Pensioner,Secondary / secondary special,Married,House / apartment,-20140,365243,1,0,1,1,,2.0,-50,0
8167,5009306,F,Y,N,0,135000.0,Pensioner,Secondary / secondary special,Married,House / apartment,-20140,365243,1,0,1,1,,2.0,-51,0
8168,5009306,F,Y,N,0,135000.0,Pensioner,Secondary / secondary special,Married,House / apartment,-20140,365243,1,0,1,1,,2.0,-52,0
8169,5009306,F,Y,N,0,135000.0,Pensioner,Secondary / secondary special,Married,House / apartment,-20140,365243,1,0,1,1,,2.0,-53,0
8170,5009306,F,Y,N,0,135000.0,Pensioner,Secondary / secondary special,Married,House / apartment,-20140,365243,1,0,1,1,,2.0,-54,0
8171,5009306,F,Y,N,0,135000.0,Pensioner,Secondary / secondary special,Married,House / apartment,-20140,365243,1,0,1,1,,2.0,-55,0
8172,5009306,F,Y,N,0,135000.0,Pensioner,Secondary / secondary special,Married,House / apartment,-20140,365243,1,0,1,1,,2.0,-56,0
8173,5009306,F,Y,N,0,135000.0,Pensioner,Secondary / secondary special,Married,House / apartment,-20140,365243,1,0,1,1,,2.0,-57,0
8174,5009306,F,Y,N,0,135000.0,Pensioner,Secondary / secondary special,Married,House / apartment,-20140,365243,1,0,1,1,,2.0,-58,0
8175,5009306,F,Y,N,0,135000.0,Pensioner,Secondary / secondary special,Married,House / apartment,-20140,365243,1,0,1,1,,2.0,-59,0
8176,5009306,F,Y,N,0,135000.0,Pensioner,Secondary / secondary special,Married,House / apartment,-20140,365243,1,0,1,1,,2.0,-60,X
8177,5009307,F,Y,N,0,135000.0,Pensioner,Secondary / secondary special,Married,House / apartment,-20140,365243,1,0,1,1,,2.0,0,C
8178,5009307,F,Y,N,0,135000.0,Pensioner,Secondary / secondary special,Married,House / apartment,-20140,365243,1,0,1,1,,2.0,-1,C
8179,5009307,F,Y,N,0,135000.0,Pensioner,Secondary / secondary special,Married,House / apartment,-20140,365243,1,0,1,1,,2.0,-2,C
8180,5009307,F,Y,N,0,135000.0,Pensioner,Secondary / secondary special,Married,House / apartment,-20140,365243,1,0,1,1,,2.0,-3,C
8181,5009307,F,Y,N,0,135000.0,Pensioner,Secondary / secondary special,Married,House / apartment,-20140,365243,1,0,1,1,,2.0,-4,C
8182,5009307,F,Y,N,0,135000.0,Pensioner,Secondary / secondary special,Married,House / apartment,-20140,365243,1,0,1,1,,2.0,-5,C
8183,5009307,F,Y,N,0,135000.0,Pensioner,Secondary / secondary special,Married,House / apartment,-20140,365243,1,0,1,1,,2.0,-6,C
8184,5009307,F,Y,N,0,135000.0,Pensioner,Secondary / secondary special,Married,House / apartment,-20140,365243,1,0,1,1,,2.0,-7,C
8185,5009307,F,Y,N,0,135000.0,Pensioner,Secondary / secondary special,Married,House / apartment,-20140,365243,1,0,1,1,,2.0,-8,C
8186,5009307,F,Y,N,0,135000.0,Pensioner,Secondary / secondary special,Married,House / apartment,-20140,365243,1,0,1,1,,2.0,-9,C
8187,5009307,F,Y,N,0,135000.0,Pensioner,Secondary / secondary special,Married,House / apartment,-20140,365243,1,0,1,1,,2.0,-10,C
8188,5009307,F,Y,N,0,135000.0,Pensioner,Secondary / secondary special,Married,House / apartment,-20140,365243,1,0,1,1,,2.0,-11,C
8189,5009307,F,Y,N,0,135000.0,Pensioner,Secondary / secondary special,Married,House / apartment,-20140,365243,1,0,1,1,,2.0,-12,0
8190,5009307,F,Y,N,0,135000.0,Pensioner,Secondary / secondary special,Married,House / apartment,-20140,365243,1,0,1,1,,2.0,-13,0
8191,5009307,F,Y,N,0,135000.0,Pensioner,Secondary / secondary special,Married,House / apartment,-20140,365243,1,0,1,1,,2.0,-14,0
8192,5009307,F,Y,N,0,135000.0,Pensioner,Secondary / secondary special,Married,House / apartment,-20140,365243,1,0,1,1,,2.0,-15,0
8193,5009307,F,Y,N,0,135000.0,Pensioner,Secondary / secondary special,Married,House / apartment,-20140,365243,1,0,1,1,,2.0,-16,0
8194,5009307,F,Y,N,0,135000.0,Pensioner,Secondary / secondary special,Married,House / apartment,-20140,365243,1,0,1,1,,2.0,-17,0
8195,5009307,F,Y,N,0,135000.0,Pensioner,Secondary / secondary special,Married,House / apartment,-20140,365243,1,0,1,1,,2.0,-18,0
8196,5009307,F,Y,N,0,135000.0,Pensioner,Secondary / secondary special,Married,House / apartment,-20140,365243,1,0,1,1,,2.0,-19,0
8197,5009307,F,Y,N,0,135000.0,Pensioner,Secondary / secondary special,Married,House / apartment,-20140,365243,1,0,1,1,,2.0,-20,0
8198,5009307,F,Y,N,0,135000.0,Pensioner,Secondary / secondary special,Married,House / apartment,-20140,365243,1,0,1,1,,2.0,-21,0
8199,5009307,F,Y,N,0,135000.0,Pensioner,Secondary / secondary special,Married,House / apartment,-20140,365243,1,0,1,1,,2.0,-22,0
8200,5009307,F,Y,N,0,135000.0,Pensioner,Secondary / secondary special,Married,House / apartment,-20140,365243,1,0,1,1,,2.0,-23,0
8201,5009307,F,Y,N,0,135000.0,Pensioner,Secondary / secondary special,Married,House / apartment,-20140,365243,1,0,1,1,,2.0,-24,0
8202,5009307,F,Y,N,0,135000.0,Pensioner,Secondary / secondary special,Married,House / apartment,-20140,365243,1,0,1,1,,2.0,-25,0
8203,5009307,F,Y,N,0,135000.0,Pensioner,Secondary / secondary special,Married,House / apartment,-20140,365243,1,0,1,1,,2.0,-26,0
8204,5009307,F,Y,N,0,135000.0,Pensioner,Secondary / secondary special,Married,House / apartment,-20140,365243,1,0,1,1,,2.0,-27,0
8205,5009308,F,Y,N,0,135000.0,Pensioner,Secondary / secondary special,Married,House / apartment,-20140,365243,1,0,1,1,,2.0,0,C
8206,5009308,F,Y,N,0,135000.0,Pensioner,Secondary / secondary special,Married,House / apartment,-20140,365243,1,0,1,1,,2.0,-1,C
8207,5009308,F,Y,N,0,135000.0,Pensioner,Secondary / secondary special,Married,House / apartment,-20140,365243,1,0,1,1,,2.0,-2,C
8208,5009308,F,Y,N,0,135000.0,Pensioner,Secondary / secondary special,Married,House / apartment,-20140,365243,1,0,1,1,,2.0,-3,C
8209,5009308,F,Y,N,0,135000.0,Pensioner,Secondary / secondary special,Married,House / apartment,-20140,365243,1,0,1,1,,2.0,-4,C
8210,5009308,F,Y,N,0,135000.0,Pensioner,Secondary / secondary special,Married,House / apartment,-20140,365243,1,0,1,1,,2.0,-5,C
8211,5009308,F,Y,N,0,135000.0,Pensioner,Secondary / secondary special,Married,House / apartment,-20140,365243,1,0,1,1,,2.0,-6,C
8212,5009308,F,Y,N,0,135000.0,Pensioner,Secondary / secondary special,Married,House / apartment,-20140,365243,1,0,1,1,,2.0,-7,C
8213,5009308,F,Y,N,0,135000.0,Pensioner,Secondary / secondary special,Married,House / apartment,-20140,365243,1,0,1,1,,2.0,-8,C
8214,5009308,F,Y,N,0,135000.0,Pensioner,Secondary / secondary special,Married,House / apartment,-20140,365243,1,0,1,1,,2.0,-9,C
8215,5009308,F,Y,N,0,135000.0,Pensioner,Secondary / secondary special,Married,House / apartment,-20140,365243,1,0,1,1,,2.0,-10,C
8216,5009308,F,Y,N,0,135000.0,Pensioner,Secondary / secondary special,Married,House / apartment,-20140,365243,1,0,1,1,,2.0,-11,C
8217,5009308,F,Y,N,0,135000.0,Pensioner,Secondary / secondary special,Married,House / apartment,-20140,365243,1,0,1,1,,2.0,-12,C
8218,5009308,F,Y,N,0,135000.0,Pensioner,Secondary / secondary special,Married,House / apartment,-20140,365243,1,0,1,1,,2.0,-13,C
8219,5009308,F,Y,N,0,135000.0,Pensioner,Secondary / secondary special,Married,House / apartment,-20140,365243,1,0,1,1,,2.0,-14,C
8220,5009308,F,Y,N,0,135000.0,Pensioner,Secondary / secondary special,Married,House / apartment,-20140,365243,1,0,1,1,,2.0,-15,C
8221,5009308,F,Y,N,0,135000.0,Pensioner,Secondary / secondary special,Married,House / apartment,-20140,365243,1,0,1,1,,2.0,-16,C
8222,5009308,F,Y,N,0,135000.0,Pensioner,Secondary / secondary special,Married,House / apartment,-20140,365243,1,0,1,1,,2.0,-17,C
8223,5009308,F,Y,N,0,135000.0,Pensioner,Secondary / secondary special,Married,House / apartment,-20140,365243,1,0,1,1,,2.0,-18,C
8224,5009308,F,Y,N,0,135000.0,Pensioner,Secondary / secondary special,Married,House / apartment,-20140,365243,1,0,1,1,,2.0,-19,C
8225,5009308,F,Y,N,0,135000.0,Pensioner,Secondary / secondary special,Married,House / apartment,-20140,365243,1,0,1,1,,2.0,-20,C
8226,5009308,F,Y,N,0,135000.0,Pensioner,Secondary / secondary special,Married,House / apartment,-20140,365243,1,0,1,1,,2.0,-21,C
8227,5009308,F,Y,N,0,135000.0,Pensioner,Secondary / secondary special,Married,House / apartment,-20140,365243,1,0,1,1,,2.0,-22,C
8228,5009308,F,Y,N,0,135000.0,Pensioner,Secondary / secondary special,Married,House / apartment,-20140,365243,1,0,1,1,,2.0,-23,C
8229,5009308,F,Y,N,0,135000.0,Pensioner,Secondary / secondary special,Married,House / apartment,-20140,365243,1,0,1,1,,2.0,-24,C
8230,5009308,F,Y,N,0,135000.0,Pensioner,Secondary / secondary special,Married,House / apartment,-20140,365243,1,0,1,1,,2.0,-25,C
8231,5009308,F,Y,N,0,135000.0,Pensioner,Secondary / secondary special,Married,House / apartment,-20140,365243,1,0,1,1,,2.0,-26,C
8232,5009308,F,Y,N,0,135000.0,Pensioner,Secondary / secondary special,Married,House / apartment,-20140,365243,1,0,1,1,,2.0,-27,C
8233,5009308,F,Y,N,0,135000.0,Pensioner,Secondary / secondary special,Married,House / apartment,-20140,365243,1,0,1,1,,2.0,-28,C
8234,5009308,F,Y,N,0,135000.0,Pensioner,Secondary / secondary special,Married,House / apartment,-20140,365243,1,0,1,1,,2.0,-29,C
8235,5009308,F,Y,N,0,135000.0,Pensioner,Secondary / secondary special,Married,House / apartment,-20140,365243,1,0,1,1,,2.0,-30,C
8236,5009308,F,Y,N,0,135000.0,Pensioner,Secondary / secondary special,Married,House / apartment,-20140,365243,1,0,1,1,,2.0,-31,0
8237,5009308,F,Y,N,0,135000.0,Pensioner,Secondary / secondary special,Married,House / apartment,-20140,365243,1,0,1,1,,2.0,-32,0
8238,5009308,F,Y,N,0,135000.0,Pensioner,Secondary / secondary special,Married,House / apartment,-20140,365243,1,0,1,1,,2.0,-33,0
8239,5009308,F,Y,N,0,135000.0,Pensioner,Secondary / secondary special,Married,House / apartment,-20140,365243,1,0,1,1,,2.0,-34,0
8240,5009308,F,Y,N,0,135000.0,Pensioner,Secondary / secondary special,Married,House / apartment,-20140,365243,1,0,1,1,,2.0,-35,0
8241,5009308,F,Y,N,0,135000.0,Pensioner,Secondary / secondary special,Married,House / apartment,-20140,365243,1,0,1,1,,2.0,-36,0
8242,5009308,F,Y,N,0,135000.0,Pensioner,Secondary / secondary special,Married,House / apartment,-20140,365243,1,0,1,1,,2.0,-37,0
8243,5009308,F,Y,N,0,135000.0,Pensioner,Secondary / secondary special,Married,House / apartment,-20140,365243,1,0,1,1,,2.0,-38,0
8244,5009308,F,Y,N,0,135000.0,Pensioner,Secondary / secondary special,Married,House / apartment,-20140,365243,1,0,1,1,,2.0,-39,0
8245,5009309,F,Y,N,0,135000.0,Pensioner,Secondary / secondary special,Married,House / apartment,-20140,365243,1,0,1,1,,2.0,0,C
8246,5009309,F,Y,N,0,135000.0,Pensioner,Secondary / secondary special,Married,House / apartment,-20140,365243,1,0,1,1,,2.0,-1,C
8247,5009309,F,Y,N,0,135000.0,Pensioner,Secondary / secondary special,Married,House / apartment,-20140,365243,1,0,1,1,,2.0,-2,C
8248,5009309,F,Y,N,0,135000.0,Pensioner,Secondary / secondary special,Married,House / apartment,-20140,365243,1,0,1,1,,2.0,-3,C
8249,5009309,F,Y,N,0,135000.0,Pensioner,Secondary / secondary special,Married,House / apartment,-20140,365243,1,0,1,1,,2.0,-4,C
8250,5009309,F,Y,N,0,135000.0,Pensioner,Secondary / secondary special,Married,House / apartment,-20140,365243,1,0,1,1,,2.0,-5,C
8251,5009309,F,Y,N,0,135000.0,Pensioner,Secondary / secondary special,Married,House / apartment,-20140,365243,1,0,1,1,,2.0,-6,C
8252,5009309,F,Y,N,0,135000.0,Pensioner,Secondary / secondary special,Married,House / apartment,-20140,365243,1,0,1,1,,2.0,-7,C
8253,5009309,F,Y,N,0,135000.0,Pensioner,Secondary / secondary special,Married,House / apartment,-20140,365243,1,0,1,1,,2.0,-8,C
8254,5009309,F,Y,N,0,135000.0,Pensioner,Secondary / secondary special,Married,House / apartment,-20140,365243,1,0,1,1,,2.0,-9,C
8255,5009309,F,Y,N,0,135000.0,Pensioner,Secondary / secondary special,Married,House / apartment,-20140,365243,1,0,1,1,,2.0,-10,C
8256,5009309,F,Y,N,0,135000.0,Pensioner,Secondary / secondary special,Married,House / apartment,-20140,365243,1,0,1,1,,2.0,-11,C
8257,5009309,F,Y,N,0,135000.0,Pensioner,Secondary / secondary special,Married,House / apartment,-20140,365243,1,0,1,1,,2.0,-12,C
8258,5009309,F,Y,N,0,135000.0,Pensioner,Secondary / secondary special,Married,House / apartment,-20140,365243,1,0,1,1,,2.0,-13,C
8259,5009309,F,Y,N,0,135000.0,Pensioner,Secondary / secondary special,Married,House / apartment,-20140,365243,1,0,1,1,,2.0,-14,C
8260,5009309,F,Y,N,0,135000.0,Pensioner,Secondary / secondary special,Married,House / apartment,-20140,365243,1,0,1,1,,2.0,-15,C
8261,5009309,F,Y,N,0,135000.0,Pensioner,Secondary / secondary special,Married,House / apartment,-20140,365243,1,0,1,1,,2.0,-16,C
8262,5009309,F,Y,N,0,135000.0,Pensioner,Secondary / secondary special,Married,House / apartment,-20140,365243,1,0,1,1,,2.0,-17,C
8263,5009309,F,Y,N,0,135000.0,Pensioner,Secondary / secondary special,Married,House / apartment,-20140,365243,1,0,1,1,,2.0,-18,C
8264,5009309,F,Y,N,0,135000.0,Pensioner,Secondary / secondary special,Married,House / apartment,-20140,365243,1,0,1,1,,2.0,-19,C
8265,5009309,F,Y,N,0,135000.0,Pensioner,Secondary / secondary special,Married,House / apartment,-20140,365243,1,0,1,1,,2.0,-20,C
8266,5009309,F,Y,N,0,135000.0,Pensioner,Secondary / secondary special,Married,House / apartment,-20140,365243,1,0,1,1,,2.0,-21,C
8267,5009309,F,Y,N,0,135000.0,Pensioner,Secondary / secondary special,Married,House / apartment,-20140,365243,1,0,1,1,,2.0,-22,0
8268,5009309,F,Y,N,0,135000.0,Pensioner,Secondary / secondary special,Married,House / apartment,-20140,365243,1,0,1,1,,2.0,-23,0
8269,5009309,F,Y,N,0,135000.0,Pensioner,Secondary / secondary special,Married,House / apartment,-20140,365243,1,0,1,1,,2.0,-24,0
8270,5009309,F,Y,N,0,135000.0,Pensioner,Secondary / secondary special,Married,House / apartment,-20140,365243,1,0,1,1,,2.0,-25,0
8271,5009309,F,Y,N,0,135000.0,Pensioner,Secondary / secondary special,Married,House / apartment,-20140,365243,1,0,1,1,,2.0,-26,0
8272,5009309,F,Y,N,0,135000.0,Pensioner,Secondary / secondary special,Married,House / apartment,-20140,365243,1,0,1,1,,2.0,-27,0
8273,5009309,F,Y,N,0,135000.0,Pensioner,Secondary / secondary special,Married,House / apartment,-20140,365243,1,0,1,1,,2.0,-28,0
8274,5009309,F,Y,N,0,135000.0,Pensioner,Secondary / secondary special,Married,House / apartment,-20140,365243,1,0,1,1,,2.0,-29,0
8275,5009309,F,Y,N,0,135000.0,Pensioner,Secondary / secondary special,Married,House / apartment,-20140,365243,1,0,1,1,,2.0,-30,0
8276,5009309,F,Y,N,0,135000.0,Pensioner,Secondary / secondary special,Married,House / apartment,-20140,365243,1,0,1,1,,2.0,-31,0
8277,5009310,F,Y,N,0,135000.0,Pensioner,Secondary / secondary special,Married,House / apartment,-20140,365243,1,0,1,1,,2.0,-11,C
8278,5009310,F,Y,N,0,135000.0,Pensioner,Secondary / secondary special,Married,House / apartment,-20140,365243,1,0,1,1,,2.0,-12,C
8279,5009310,F,Y,N,0,135000.0,Pensioner,Secondary / secondary special,Married,House / apartment,-20140,365243,1,0,1,1,,2.0,-13,C
8280,5009310,F,Y,N,0,135000.0,Pensioner,Secondary / secondary special,Married,House / apartment,-20140,365243,1,0,1,1,,2.0,-14,C
8281,5009310,F,Y,N,0,135000.0,Pensioner,Secondary / secondary special,Married,House / apartment,-20140,365243,1,0,1,1,,2.0,-15,C
8282,5009310,F,Y,N,0,135000.0,Pensioner,Secondary / secondary special,Married,House / apartment,-20140,365243,1,0,1,1,,2.0,-16,C
8283,5009310,F,Y,N,0,135000.0,Pensioner,Secondary / secondary special,Married,House / apartment,-20140,365243,1,0,1,1,,2.0,-17,C
8284,5009310,F,Y,N,0,135000.0,Pensioner,Secondary / secondary special,Married,House / apartment,-20140,365243,1,0,1,1,,2.0,-18,C
8285,5009310,F,Y,N,0,135000.0,Pensioner,Secondary / secondary special,Married,House / apartment,-20140,365243,1,0,1,1,,2.0,-19,C
8286,5009310,F,Y,N,0,135000.0,Pensioner,Secondary / secondary special,Married,House / apartment,-20140,365243,1,0,1,1,,2.0,-20,C
8287,5009310,F,Y,N,0,135000.0,Pensioner,Secondary / secondary special,Married,House / apartment,-20140,365243,1,0,1,1,,2.0,-21,C
8288,5009310,F,Y,N,0,135000.0,Pensioner,Secondary / secondary special,Married,House / apartment,-20140,365243,1,0,1,1,,2.0,-22,C
8289,5009310,F,Y,N,0,135000.0,Pensioner,Secondary / secondary special,Married,House / apartment,-20140,365243,1,0,1,1,,2.0,-23,C
8290,5009310,F,Y,N,0,135000.0,Pensioner,Secondary / secondary special,Married,House / apartment,-20140,365243,1,0,1,1,,2.0,-24,C
8291,5009310,F,Y,N,0,135000.0,Pensioner,Secondary / secondary special,Married,House / apartment,-20140,365243,1,0,1,1,,2.0,-25,C
8292,5009310,F,Y,N,0,135000.0,Pensioner,Secondary / secondary special,Married,House / apartment,-20140,365243,1,0,1,1,,2.0,-26,C
8293,5009310,F,Y,N,0,135000.0,Pensioner,Secondary / secondary special,Married,House / apartment,-20140,365243,1,0,1,1,,2.0,-27,C
8294,5009310,F,Y,N,0,135000.0,Pensioner,Secondary / secondary special,Married,House / apartment,-20140,365243,1,0,1,1,,2.0,-28,C
8295,5009310,F,Y,N,0,135000.0,Pensioner,Secondary / secondary special,Married,House / apartment,-20140,365243,1,0,1,1,,2.0,-29,C
8296,5009310,F,Y,N,0,135000.0,Pensioner,Secondary / secondary special,Married,House / apartment,-20140,365243,1,0,1,1,,2.0,-30,C
8297,5009310,F,Y,N,0,135000.0,Pensioner,Secondary / secondary special,Married,House / apartment,-20140,365243,1,0,1,1,,2.0,-31,C
8298,5009310,F,Y,N,0,135000.0,Pensioner,Secondary / secondary special,Married,House / apartment,-20140,365243,1,0,1,1,,2.0,-32,0
8299,5009310,F,Y,N,0,135000.0,Pensioner,Secondary / secondary special,Married,House / apartment,-20140,365243,1,0,1,1,,2.0,-33,0
8300,5009310,F,Y,N,0,135000.0,Pensioner,Secondary / secondary special,Married,House / apartment,-20140,365243,1,0,1,1,,2.0,-34,0
8301,5009310,F,Y,N,0,135000.0,Pensioner,Secondary / secondary special,Married,House / apartment,-20140,365243,1,0,1,1,,2.0,-35,0
8302,5009310,F,Y,N,0,135000.0,Pensioner,Secondary / secondary special,Married,House / apartment,-20140,365243,1,0,1,1,,2.0,-36,0
8303,5009310,F,Y,N,0,135000.0,Pensioner,Secondary / secondary special,Married,House / apartment,-20140,365243,1,0,1,1,,2.0,-37,0
8304,5009310,F,Y,N,0,135000.0,Pensioner,Secondary / secondary special,Married,House / apartment,-20140,365243,1,0,1,1,,2.0,-38,0
8305,5009310,F,Y,N,0,135000.0,Pensioner,Secondary / secondary special,Married,House / apartment,-20140,365243,1,0,1,1,,2.0,-39,0
8306,5009310,F,Y,N,0,135000.0,Pensioner,Secondary / secondary special,Married,House / apartment,-20140,365243,1,0,1,1,,2.0,-40,0
8307,5009310,F,Y,N,0,135000.0,Pensioner,Secondary / secondary special,Married,House / apartment,-20140,365243,1,0,1,1,,2.0,-41,0
8308,5009310,F,Y,N,0,135000.0,Pensioner,Secondary / secondary special,Married,House / apartment,-20140,365243,1,0,1,1,,2.0,-42,0
8309,5009310,F,Y,N,0,135000.0,Pensioner,Secondary / secondary special,Married,House / apartment,-20140,365243,1,0,1,1,,2.0,-43,0
8310,5009310,F,Y,N,0,135000.0,Pensioner,Secondary / secondary special,Married,House / apartment,-20140,365243,1,0,1,1,,2.0,-44,0
8311,5009310,F,Y,N,0,135000.0,Pensioner,Secondary / secondary special,Married,House / apartment,-20140,365243,1,0,1,1,,2.0,-45,0
8312,5009310,F,Y,N,0,135000.0,Pensioner,Secondary / secondary special,Married,House / apartment,-20140,365243,1,0,1,1,,2.0,-46,0
8313,5009310,F,Y,N,0,135000.0,Pensioner,Secondary / secondary special,Married,House / apartment,-20140,365243,1,0,1,1,,2.0,-47,0
8314,5009311,F,Y,N,0,135000.0,Pensioner,Secondary / secondary special,Married,House / apartment,-20140,365243,1,0,1,1,,2.0,-9,C
8315,5009311,F,Y,N,0,135000.0,Pensioner,Secondary / secondary special,Married,House / apartment,-20140,365243,1,0,1,1,,2.0,-10,C
8316,5009311,F,Y,N,0,135000.0,Pensioner,Secondary / secondary special,Married,House / apartment,-20140,365243,1,0,1,1,,2.0,-11,C
8317,5009311,F,Y,N,0,135000.0,Pensioner,Secondary / secondary special,Married,House / apartment,-20140,365243,1,0,1,1,,2.0,-12,C
8318,5009311,F,Y,N,0,135000.0,Pensioner,Secondary / secondary special,Married,House / apartment,-20140,365243,1,0,1,1,,2.0,-13,C
8319,5009311,F,Y,N,0,135000.0,Pensioner,Secondary / secondary special,Married,House / apartment,-20140,365243,1,0,1,1,,2.0,-14,C
8320,5009311,F,Y,N,0,135000.0,Pensioner,Secondary / secondary special,Married,House / apartment,-20140,365243,1,0,1,1,,2.0,-15,C
8321,5009311,F,Y,N,0,135000.0,Pensioner,Secondary / secondary special,Married,House / apartment,-20140,365243,1,0,1,1,,2.0,-16,C
8322,5009311,F,Y,N,0,135000.0,Pensioner,Secondary / secondary special,Married,House / apartment,-20140,365243,1,0,1,1,,2.0,-17,C
8323,5009311,F,Y,N,0,135000.0,Pensioner,Secondary / secondary special,Married,House / apartment,-20140,365243,1,0,1,1,,2.0,-18,C
8324,5009311,F,Y,N,0,135000.0,Pensioner,Secondary / secondary special,Married,House / apartment,-20140,365243,1,0,1,1,,2.0,-19,0
8325,5009311,F,Y,N,0,135000.0,Pensioner,Secondary / secondary special,Married,House / apartment,-20140,365243,1,0,1,1,,2.0,-20,0
8326,5009311,F,Y,N,0,135000.0,Pensioner,Secondary / secondary special,Married,House / apartment,-20140,365243,1,0,1,1,,2.0,-21,0
8327,5009311,F,Y,N,0,135000.0,Pensioner,Secondary / secondary special,Married,House / apartment,-20140,365243,1,0,1,1,,2.0,-22,0
8328,5009311,F,Y,N,0,135000.0,Pensioner,Secondary / secondary special,Married,House / apartment,-20140,365243,1,0,1,1,,2.0,-23,0
8329,5009311,F,Y,N,0,135000.0,Pensioner,Secondary / secondary special,Married,House / apartment,-20140,365243,1,0,1,1,,2.0,-24,0
8330,5009311,F,Y,N,0,135000.0,Pensioner,Secondary / secondary special,Married,House / apartment,-20140,365243,1,0,1,1,,2.0,-25,0
8331,5009311,F,Y,N,0,135000.0,Pensioner,Secondary / secondary special,Married,House / apartment,-20140,365243,1,0,1,1,,2.0,-26,0
8332,5009311,F,Y,N,0,135000.0,Pensioner,Secondary / secondary special,Married,House / apartment,-20140,365243,1,0,1,1,,2.0,-27,0
8333,5009311,F,Y,N,0,135000.0,Pensioner,Secondary / secondary special,Married,House / apartment,-20140,365243,1,0,1,1,,2.0,-28,0
8334,5009311,F,Y,N,0,135000.0,Pensioner,Secondary / secondary special,Married,House / apartment,-20140,365243,1,0,1,1,,2.0,-29,0
8335,5009311,F,Y,N,0,135000.0,Pensioner,Secondary / secondary special,Married,House / apartment,-20140,365243,1,0,1,1,,2.0,-30,X
8336,5009311,F,Y,N,0,135000.0,Pensioner,Secondary / secondary special,Married,House / apartment,-20140,365243,1,0,1,1,,2.0,-31,X
8337,5009311,F,Y,N,0,135000.0,Pensioner,Secondary / secondary special,Married,House / apartment,-20140,365243,1,0,1,1,,2.0,-32,X
8338,5009311,F,Y,N,0,135000.0,Pensioner,Secondary / secondary special,Married,House / apartment,-20140,365243,1,0,1,1,,2.0,-33,X
8339,5009311,F,Y,N,0,135000.0,Pensioner,Secondary / secondary special,Married,House / apartment,-20140,365243,1,0,1,1,,2.0,-34,X
8340,5009311,F,Y,N,0,135000.0,Pensioner,Secondary / secondary special,Married,House / apartment,-20140,365243,1,0,1,1,,2.0,-35,X
8341,5009311,F,Y,N,0,135000.0,Pensioner,Secondary / secondary special,Married,House / apartment,-20140,365243,1,0,1,1,,2.0,-36,X
8342,5009312,F,Y,N,0,135000.0,Pensioner,Secondary / secondary special,Married,House / apartment,-20140,365243,1,0,1,1,,2.0,-16,C
8343,5009312,F,Y,N,0,135000.0,Pensioner,Secondary / secondary special,Married,House / apartment,-20140,365243,1,0,1,1,,2.0,-17,C
8344,5009312,F,Y,N,0,135000.0,Pensioner,Secondary / secondary special,Married,House / apartment,-20140,365243,1,0,1,1,,2.0,-18,C
8345,5009312,F,Y,N,0,135000.0,Pensioner,Secondary / secondary special,Married,House / apartment,-20140,365243,1,0,1,1,,2.0,-19,C
8346,5009312,F,Y,N,0,135000.0,Pensioner,Secondary / secondary special,Married,House / apartment,-20140,365243,1,0,1,1,,2.0,-20,C
8347,5009312,F,Y,N,0,135000.0,Pensioner,Secondary / secondary special,Married,House / apartment,-20140,365243,1,0,1,1,,2.0,-21,C
8348,5009312,F,Y,N,0,135000.0,Pensioner,Secondary / secondary special,Married,House / apartment,-20140,365243,1,0,1,1,,2.0,-22,C
8349,5009312,F,Y,N,0,135000.0,Pensioner,Secondary / secondary special,Married,House / apartment,-20140,365243,1,0,1,1,,2.0,-23,C
8350,5009312,F,Y,N,0,135000.0,Pensioner,Secondary / secondary special,Married,House / apartment,-20140,365243,1,0,1,1,,2.0,-24,C
8351,5009312,F,Y,N,0,135000.0,Pensioner,Secondary / secondary special,Married,House / apartment,-20140,365243,1,0,1,1,,2.0,-25,C
8352,5009312,F,Y,N,0,135000.0,Pensioner,Secondary / secondary special,Married,House / apartment,-20140,365243,1,0,1,1,,2.0,-26,C
8353,5009312,F,Y,N,0,135000.0,Pensioner,Secondary / secondary special,Married,House / apartment,-20140,365243,1,0,1,1,,2.0,-27,C
8354,5009312,F,Y,N,0,135000.0,Pensioner,Secondary / secondary special,Married,House / apartment,-20140,365243,1,0,1,1,,2.0,-28,C
8355,5009312,F,Y,N,0,135000.0,Pensioner,Secondary / secondary special,Married,House / apartment,-20140,365243,1,0,1,1,,2.0,-29,C
8356,5009312,F,Y,N,0,135000.0,Pensioner,Secondary / secondary special,Married,House / apartment,-20140,365243,1,0,1,1,,2.0,-30,C
8357,5009312,F,Y,N,0,135000.0,Pensioner,Secondary / secondary special,Married,House / apartment,-20140,365243,1,0,1,1,,2.0,-31,C
8358,5009312,F,Y,N,0,135000.0,Pensioner,Secondary / secondary special,Married,House / apartment,-20140,365243,1,0,1,1,,2.0,-32,X
8359,5009312,F,Y,N,0,135000.0,Pensioner,Secondary / secondary special,Married,House / apartment,-20140,365243,1,0,1,1,,2.0,-33,0
8360,5009312,F,Y,N,0,135000.0,Pensioner,Secondary / secondary special,Married,House / apartment,-20140,365243,1,0,1,1,,2.0,-34,0
8361,5009312,F,Y,N,0,135000.0,Pensioner,Secondary / secondary special,Married,House / apartment,-20140,365243,1,0,1,1,,2.0,-35,0
8362,5009312,F,Y,N,0,135000.0,Pensioner,Secondary / secondary special,Married,House / apartment,-20140,365243,1,0,1,1,,2.0,-36,0
8363,5009312,F,Y,N,0,135000.0,Pensioner,Secondary / secondary special,Married,House / apartment,-20140,365243,1,0,1,1,,2.0,-37,0
8364,5009312,F,Y,N,0,135000.0,Pensioner,Secondary / secondary special,Married,House / apartment,-20140,365243,1,0,1,1,,2.0,-38,0
8365,5009312,F,Y,N,0,135000.0,Pensioner,Secondary / secondary special,Married,House / apartment,-20140,365243,1,0,1,1,,2.0,-39,0
8366,5009312,F,Y,N,0,135000.0,Pensioner,Secondary / secondary special,Married,House / apartment,-20140,365243,1,0,1,1,,2.0,-40,X
8367,5009313,F,Y,N,0,135000.0,Pensioner,Secondary / secondary special,Married,House / apartment,-20140,365243,1,0,1,1,,2.0,0,0
8368,5009313,F,Y,N,0,135000.0,Pensioner,Secondary / secondary special,Married,House / apartment,-20140,365243,1,0,1,1,,2.0,-1,0
8369,5009313,F,Y,N,0,135000.0,Pensioner,Secondary / secondary special,Married,House / apartment,-20140,365243,1,0,1,1,,2.0,-2,0
8370,5009313,F,Y,N,0,135000.0,Pensioner,Secondary / secondary special,Married,House / apartment,-20140,365243,1,0,1,1,,2.0,-3,0
8371,5009313,F,Y,N,0,135000.0,Pensioner,Secondary / secondary special,Married,House / apartment,-20140,365243,1,0,1,1,,2.0,-4,0
8372,5009313,F,Y,N,0,135000.0,Pensioner,Secondary / secondary special,Married,House / apartment,-20140,365243,1,0,1,1,,2.0,-5,X
8373,5009313,F,Y,N,0,135000.0,Pensioner,Secondary / secondary special,Married,House / apartment,-20140,365243,1,0,1,1,,2.0,-6,X
8374,5009313,F,Y,N,0,135000.0,Pensioner,Secondary / secondary special,Married,House / apartment,-20140,365243,1,0,1,1,,2.0,-7,X
8375,5009313,F,Y,N,0,135000.0,Pensioner,Secondary / secondary special,Married,House / apartment,-20140,365243,1,0,1,1,,2.0,-8,X
8376,5009313,F,Y,N,0,135000.0,Pensioner,Secondary / secondary special,Married,House / apartment,-20140,365243,1,0,1,1,,2.0,-9,X
8377,5009313,F,Y,N,0,135000.0,Pensioner,Secondary / secondary special,Married,House / apartment,-20140,365243,1,0,1,1,,2.0,-10,X
8378,5009313,F,Y,N,0,135000.0,Pensioner,Secondary / secondary special,Married,House / apartment,-20140,365243,1,0,1,1,,2.0,-11,X
8379,5009313,F,Y,N,0,135000.0,Pensioner,Secondary / secondary special,Married,House / apartment,-20140,365243,1,0,1,1,,2.0,-12,X
8380,5009313,F,Y,N,0,135000.0,Pensioner,Secondary / secondary special,Married,House / apartment,-20140,365243,1,0,1,1,,2.0,-13,X
8381,5009313,F,Y,N,0,135000.0,Pensioner,Secondary / secondary special,Married,House / apartment,-20140,365243,1,0,1,1,,2.0,-14,X
8382,5009313,F,Y,N,0,135000.0,Pensioner,Secondary / secondary special,Married,House / apartment,-20140,365243,1,0,1,1,,2.0,-15,X
8383,5009313,F,Y,N,0,135000.0,Pensioner,Secondary / secondary special,Married,House / apartment,-20140,365243,1,0,1,1,,2.0,-16,X
8384,5009313,F,Y,N,0,135000.0,Pensioner,Secondary / secondary special,Married,House / apartment,-20140,365243,1,0,1,1,,2.0,-17,X
8385,5009313,F,Y,N,0,135000.0,Pensioner,Secondary / secondary special,Married,House / apartment,-20140,365243,1,0,1,1,,2.0,-18,X
8386,5009314,F,Y,N,0,135000.0,Pensioner,Secondary / secondary special,Married,House / apartment,-20140,365243,1,0,1,1,,2.0,0,0
8387,5009314,F,Y,N,0,135000.0,Pensioner,Secondary / secondary special,Married,House / apartment,-20140,365243,1,0,1,1,,2.0,-1,0
8388,5009314,F,Y,N,0,135000.0,Pensioner,Secondary / secondary special,Married,House / apartment,-20140,365243,1,0,1,1,,2.0,-2,0
8389,5009314,F,Y,N,0,135000.0,Pensioner,Secondary / secondary special,Married,House / apartment,-20140,365243,1,0,1,1,,2.0,-3,0
8390,5009314,F,Y,N,0,135000.0,Pensioner,Secondary / secondary special,Married,House / apartment,-20140,365243,1,0,1,1,,2.0,-4,0
8391,5009314,F,Y,N,0,135000.0,Pensioner,Secondary / secondary special,Married,House / apartment,-20140,365243,1,0,1,1,,2.0,-5,0
8392,5009314,F,Y,N,0,135000.0,Pensioner,Secondary / secondary special,Married,House / apartment,-20140,365243,1,0,1,1,,2.0,-6,0
8393,5009314,F,Y,N,0,135000.0,Pensioner,Secondary / secondary special,Married,House / apartment,-20140,365243,1,0,1,1,,2.0,-7,0
8394,5009314,F,Y,N,0,135000.0,Pensioner,Secondary / secondary special,Married,House / apartment,-20140,365243,1,0,1,1,,2.0,-8,0
8395,5009314,F,Y,N,0,135000.0,Pensioner,Secondary / secondary special,Married,House / apartment,-20140,365243,1,0,1,1,,2.0,-9,X
8396,5009314,F,Y,N,0,135000.0,Pensioner,Secondary / secondary special,Married,House / apartment,-20140,365243,1,0,1,1,,2.0,-10,X
8397,5009315,F,Y,N,0,135000.0,Pensioner,Secondary / secondary special,Married,House / apartment,-20140,365243,1,0,1,1,,2.0,0,0
8398,5009315,F,Y,N,0,135000.0,Pensioner,Secondary / secondary special,Married,House / apartment,-20140,365243,1,0,1,1,,2.0,-1,0
8399,5009315,F,Y,N,0,135000.0,Pensioner,Secondary / secondary special,Married,House / apartment,-20140,365243,1,0,1,1,,2.0,-2,0
8400,5009315,F,Y,N,0,135000.0,Pensioner,Secondary / secondary special,Married,House / apartment,-20140,365243,1,0,1,1,,2.0,-3,0
8401,5009315,F,Y,N,0,135000.0,Pensioner,Secondary / secondary special,Married,House / apartment,-20140,365243,1,0,1,1,,2.0,-4,0
8402,5009315,F,Y,N,0,135000.0,Pensioner,Secondary / secondary special,Married,House / apartment,-20140,365243,1,0,1,1,,2.0,-5,0
8403,5009315,F,Y,N,0,135000.0,Pensioner,Secondary / secondary special,Married,House / apartment,-20140,365243,1,0,1,1,,2.0,-6,0
8404,5009315,F,Y,N,0,135000.0,Pensioner,Secondary / secondary special,Married,House / apartment,-20140,365243,1,0,1,1,,2.0,-7,0
8405,5009315,F,Y,N,0,135000.0,Pensioner,Secondary / secondary special,Married,House / apartment,-20140,365243,1,0,1,1,,2.0,-8,0
8406,5009315,F,Y,N,0,135000.0,Pensioner,Secondary / secondary special,Married,House / apartment,-20140,365243,1,0,1,1,,2.0,-9,0
8407,5009315,F,Y,N,0,135000.0,Pensioner,Secondary / secondary special,Married,House / apartment,-20140,365243,1,0,1,1,,2.0,-10,0
8408,5009315,F,Y,N,0,135000.0,Pensioner,Secondary / secondary special,Married,House / apartment,-20140,365243,1,0,1,1,,2.0,-11,0
8409,5009315,F,Y,N,0,135000.0,Pensioner,Secondary / secondary special,Married,House / apartment,-20140,365243,1,0,1,1,,2.0,-12,0
8410,5009315,F,Y,N,0,135000.0,Pensioner,Secondary / secondary special,Married,House / apartment,-20140,365243,1,0,1,1,,2.0,-13,0
8411,5009315,F,Y,N,0,135000.0,Pensioner,Secondary / secondary special,Married,House / apartment,-20140,365243,1,0,1,1,,2.0,-14,0
8412,5009315,F,Y,N,0,135000.0,Pensioner,Secondary / secondary special,Married,House / apartment,-20140,365243,1,0,1,1,,2.0,-15,0
8413,5009316,F,Y,N,0,135000.0,Pensioner,Secondary / secondary special,Married,House / apartment,-20140,365243,1,0,1,1,,2.0,0,C
8414,5009316,F,Y,N,0,135000.0,Pensioner,Secondary / secondary special,Married,House / apartment,-20140,365243,1,0,1,1,,2.0,-1,C
8415,5009316,F,Y,N,0,135000.0,Pensioner,Secondary / secondary special,Married,House / apartment,-20140,365243,1,0,1,1,,2.0,-2,C
8416,5009316,F,Y,N,0,135000.0,Pensioner,Secondary / secondary special,Married,House / apartment,-20140,365243,1,0,1,1,,2.0,-3,C
8417,5009316,F,Y,N,0,135000.0,Pensioner,Secondary / secondary special,Married,House / apartment,-20140,365243,1,0,1,1,,2.0,-4,C
8418,5009316,F,Y,N,0,135000.0,Pensioner,Secondary / secondary special,Married,House / apartment,-20140,365243,1,0,1,1,,2.0,-5,0
8419,5009316,F,Y,N,0,135000.0,Pensioner,Secondary / secondary special,Married,House / apartment,-20140,365243,1,0,1,1,,2.0,-6,0
8420,5009316,F,Y,N,0,135000.0,Pensioner,Secondary / secondary special,Married,House / apartment,-20140,365243,1,0,1,1,,2.0,-7,0
8421,5009316,F,Y,N,0,135000.0,Pensioner,Secondary / secondary special,Married,House / apartment,-20140,365243,1,0,1,1,,2.0,-8,0
8422,5009316,F,Y,N,0,135000.0,Pensioner,Secondary / secondary special,Married,House / apartment,-20140,365243,1,0,1,1,,2.0,-9,0
8423,5009316,F,Y,N,0,135000.0,Pensioner,Secondary / secondary special,Married,House / apartment,-20140,365243,1,0,1,1,,2.0,-10,0
8424,5009316,F,Y,N,0,135000.0,Pensioner,Secondary / secondary special,Married,House / apartment,-20140,365243,1,0,1,1,,2.0,-11,0
8425,5009316,F,Y,N,0,135000.0,Pensioner,Secondary / secondary special,Married,House / apartment,-20140,365243,1,0,1,1,,2.0,-12,0
8426,5009316,F,Y,N,0,135000.0,Pensioner,Secondary / secondary special,Married,House / apartment,-20140,365243,1,0,1,1,,2.0,-13,0
8427,5009316,F,Y,N,0,135000.0,Pensioner,Secondary / secondary special,Married,House / apartment,-20140,365243,1,0,1,1,,2.0,-14,0
8428,5009316,F,Y,N,0,135000.0,Pensioner,Secondary / secondary special,Married,House / apartment,-20140,365243,1,0,1,1,,2.0,-15,0
8429,5009316,F,Y,N,0,135000.0,Pensioner,Secondary / secondary special,Married,House / apartment,-20140,365243,1,0,1,1,,2.0,-16,0
8430,5009316,F,Y,N,0,135000.0,Pensioner,Secondary / secondary special,Married,House / apartment,-20140,365243,1,0,1,1,,2.0,-17,0
8431,5009316,F,Y,N,0,135000.0,Pensioner,Secondary / secondary special,Married,House / apartment,-20140,365243,1,0,1,1,,2.0,-18,0
8432,5009316,F,Y,N,0,135000.0,Pensioner,Secondary / secondary special,Married,House / apartment,-20140,365243,1,0,1,1,,2.0,-19,0
8433,5009316,F,Y,N,0,135000.0,Pensioner,Secondary / secondary special,Married,House / apartment,-20140,365243,1,0,1,1,,2.0,-20,0
8434,5009317,F,Y,N,0,135000.0,Pensioner,Secondary / secondary special,Married,House / apartment,-20140,365243,1,0,1,1,,2.0,-12,0
8435,5009317,F,Y,N,0,135000.0,Pensioner,Secondary / secondary special,Married,House / apartment,-20140,365243,1,0,1,1,,2.0,-13,0
8436,5009317,F,Y,N,0,135000.0,Pensioner,Secondary / secondary special,Married,House / apartment,-20140,365243,1,0,1,1,,2.0,-14,0
8437,5009317,F,Y,N,0,135000.0,Pensioner,Secondary / secondary special,Married,House / apartment,-20140,365243,1,0,1,1,,2.0,-15,0
8438,5009317,F,Y,N,0,135000.0,Pensioner,Secondary / secondary special,Married,House / apartment,-20140,365243,1,0,1,1,,2.0,-16,0
8439,5009317,F,Y,N,0,135000.0,Pensioner,Secondary / secondary special,Married,House / apartment,-20140,365243,1,0,1,1,,2.0,-17,0
8440,5009317,F,Y,N,0,135000.0,Pensioner,Secondary / secondary special,Married,House / apartment,-20140,365243,1,0,1,1,,2.0,-18,0
8441,5009317,F,Y,N,0,135000.0,Pensioner,Secondary / secondary special,Married,House / apartment,-20140,365243,1,0,1,1,,2.0,-19,0
8442,5009317,F,Y,N,0,135000.0,Pensioner,Secondary / secondary special,Married,House / apartment,-20140,365243,1,0,1,1,,2.0,-20,0
8443,5009317,F,Y,N,0,135000.0,Pensioner,Secondary / secondary special,Married,House / apartment,-20140,365243,1,0,1,1,,2.0,-21,0
8444,5009317,F,Y,N,0,135000.0,Pensioner,Secondary / secondary special,Married,House / apartment,-20140,365243,1,0,1,1,,2.0,-22,0
8445,5009317,F,Y,N,0,135000.0,Pensioner,Secondary / secondary special,Married,House / apartment,-20140,365243,1,0,1,1,,2.0,-23,0
8446,5009317,F,Y,N,0,135000.0,Pensioner,Secondary / secondary special,Married,House / apartment,-20140,365243,1,0,1,1,,2.0,-24,0
8447,5009317,F,Y,N,0,135000.0,Pensioner,Secondary / secondary special,Married,House / apartment,-20140,365243,1,0,1,1,,2.0,-25,0
8448,5009317,F,Y,N,0,135000.0,Pensioner,Secondary / secondary special,Married,House / apartment,-20140,365243,1,0,1,1,,2.0,-26,0
8449,5009317,F,Y,N,0,135000.0,Pensioner,Secondary / secondary special,Married,House / apartment,-20140,365243,1,0,1,1,,2.0,-27,0
8450,5009318,F,Y,N,0,135000.0,Pensioner,Secondary / secondary special,Married,House / apartment,-20140,365243,1,0,1,1,,2.0,-14,0
8451,5009318,F,Y,N,0,135000.0,Pensioner,Secondary / secondary special,Married,House / apartment,-20140,365243,1,0,1,1,,2.0,-15,0
8452,5009318,F,Y,N,0,135000.0,Pensioner,Secondary / secondary special,Married,House / apartment,-20140,365243,1,0,1,1,,2.0,-16,0
8453,5009318,F,Y,N,0,135000.0,Pensioner,Secondary / secondary special,Married,House / apartment,-20140,365243,1,0,1,1,,2.0,-17,0
8454,5009318,F,Y,N,0,135000.0,Pensioner,Secondary / secondary special,Married,House / apartment,-20140,365243,1,0,1,1,,2.0,-18,0
8455,5009318,F,Y,N,0,135000.0,Pensioner,Secondary / secondary special,Married,House / apartment,-20140,365243,1,0,1,1,,2.0,-19,0
8456,5009318,F,Y,N,0,135000.0,Pensioner,Secondary / secondary special,Married,House / apartment,-20140,365243,1,0,1,1,,2.0,-20,0
8457,5009318,F,Y,N,0,135000.0,Pensioner,Secondary / secondary special,Married,House / apartment,-20140,365243,1,0,1,1,,2.0,-21,X
8458,5009318,F,Y,N,0,135000.0,Pensioner,Secondary / secondary special,Married,House / apartment,-20140,365243,1,0,1,1,,2.0,-22,X
8459,5009318,F,Y,N,0,135000.0,Pensioner,Secondary / secondary special,Married,House / apartment,-20140,365243,1,0,1,1,,2.0,-23,X
8460,5009318,F,Y,N,0,135000.0,Pensioner,Secondary / secondary special,Married,House / apartment,-20140,365243,1,0,1,1,,2.0,-24,X
8461,5009319,F,Y,N,0,135000.0,Pensioner,Secondary / secondary special,Married,House / apartment,-20140,365243,1,0,1,1,,2.0,0,C
8462,5009319,F,Y,N,0,135000.0,Pensioner,Secondary / secondary special,Married,House / apartment,-20140,365243,1,0,1,1,,2.0,-1,C
8463,5009319,F,Y,N,0,135000.0,Pensioner,Secondary / secondary special,Married,House / apartment,-20140,365243,1,0,1,1,,2.0,-2,C
8464,5009319,F,Y,N,0,135000.0,Pensioner,Secondary / secondary special,Married,House / apartment,-20140,365243,1,0,1,1,,2.0,-3,C
8465,5009319,F,Y,N,0,135000.0,Pensioner,Secondary / secondary special,Married,House / apartment,-20140,365243,1,0,1,1,,2.0,-4,C
8466,5009319,F,Y,N,0,135000.0,Pensioner,Secondary / secondary special,Married,House / apartment,-20140,365243,1,0,1,1,,2.0,-5,C
8467,5009319,F,Y,N,0,135000.0,Pensioner,Secondary / secondary special,Married,House / apartment,-20140,365243,1,0,1,1,,2.0,-6,C
8468,5009319,F,Y,N,0,135000.0,Pensioner,Secondary / secondary special,Married,House / apartment,-20140,365243,1,0,1,1,,2.0,-7,C
8469,5009319,F,Y,N,0,135000.0,Pensioner,Secondary / secondary special,Married,House / apartment,-20140,365243,1,0,1,1,,2.0,-8,C
8470,5009319,F,Y,N,0,135000.0,Pensioner,Secondary / secondary special,Married,House / apartment,-20140,365243,1,0,1,1,,2.0,-9,C
8471,5009319,F,Y,N,0,135000.0,Pensioner,Secondary / secondary special,Married,House / apartment,-20140,365243,1,0,1,1,,2.0,-10,C
8472,5009319,F,Y,N,0,135000.0,Pensioner,Secondary / secondary special,Married,House / apartment,-20140,365243,1,0,1,1,,2.0,-11,C
8473,5009319,F,Y,N,0,135000.0,Pensioner,Secondary / secondary special,Married,House / apartment,-20140,365243,1,0,1,1,,2.0,-12,C
8474,5009319,F,Y,N,0,135000.0,Pensioner,Secondary / secondary special,Married,House / apartment,-20140,365243,1,0,1,1,,2.0,-13,C
8475,5009319,F,Y,N,0,135000.0,Pensioner,Secondary / secondary special,Married,House / apartment,-20140,365243,1,0,1,1,,2.0,-14,C
8476,5009319,F,Y,N,0,135000.0,Pensioner,Secondary / secondary special,Married,House / apartment,-20140,365243,1,0,1,1,,2.0,-15,C
8477,5009319,F,Y,N,0,135000.0,Pensioner,Secondary / secondary special,Married,House / apartment,-20140,365243,1,0,1,1,,2.0,-16,C
8478,5009319,F,Y,N,0,135000.0,Pensioner,Secondary / secondary special,Married,House / apartment,-20140,365243,1,0,1,1,,2.0,-17,C
8479,5009319,F,Y,N,0,135000.0,Pensioner,Secondary / secondary special,Married,House / apartment,-20140,365243,1,0,1,1,,2.0,-18,C
8480,5009319,F,Y,N,0,135000.0,Pensioner,Secondary / secondary special,Married,House / apartment,-20140,365243,1,0,1,1,,2.0,-19,C
8481,5009319,F,Y,N,0,135000.0,Pensioner,Secondary / secondary special,Married,House / apartment,-20140,365243,1,0,1,1,,2.0,-20,C
8482,5009319,F,Y,N,0,135000.0,Pensioner,Secondary / secondary special,Married,House / apartment,-20140,365243,1,0,1,1,,2.0,-21,C
8483,5009319,F,Y,N,0,135000.0,Pensioner,Secondary / secondary special,Married,House / apartment,-20140,365243,1,0,1,1,,2.0,-22,C
8484,5009319,F,Y,N,0,135000.0,Pensioner,Secondary / secondary special,Married,House / apartment,-20140,365243,1,0,1,1,,2.0,-23,C
8485,5009319,F,Y,N,0,135000.0,Pensioner,Secondary / secondary special,Married,House / apartment,-20140,365243,1,0,1,1,,2.0,-24,C
8486,5009319,F,Y,N,0,135000.0,Pensioner,Secondary / secondary special,Married,House / apartment,-20140,365243,1,0,1,1,,2.0,-25,C
8487,5009319,F,Y,N,0,135000.0,Pensioner,Secondary / secondary special,Married,House / apartment,-20140,365243,1,0,1,1,,2.0,-26,C
8488,5009319,F,Y,N,0,135000.0,Pensioner,Secondary / secondary special,Married,House / apartment,-20140,365243,1,0,1,1,,2.0,-27,C
8489,5009319,F,Y,N,0,135000.0,Pensioner,Secondary / secondary special,Married,House / apartment,-20140,365243,1,0,1,1,,2.0,-28,0
8490,5009319,F,Y,N,0,135000.0,Pensioner,Secondary / secondary special,Married,House / apartment,-20140,365243,1,0,1,1,,2.0,-29,0
8491,5009319,F,Y,N,0,135000.0,Pensioner,Secondary / secondary special,Married,House / apartment,-20140,365243,1,0,1,1,,2.0,-30,0
8492,5009319,F,Y,N,0,135000.0,Pensioner,Secondary / secondary special,Married,House / apartment,-20140,365243,1,0,1,1,,2.0,-31,0
8493,5009319,F,Y,N,0,135000.0,Pensioner,Secondary / secondary special,Married,House / apartment,-20140,365243,1,0,1,1,,2.0,-32,0
8494,5009319,F,Y,N,0,135000.0,Pensioner,Secondary / secondary special,Married,House / apartment,-20140,365243,1,0,1,1,,2.0,-33,0
8495,5009319,F,Y,N,0,135000.0,Pensioner,Secondary / secondary special,Married,House / apartment,-20140,365243,1,0,1,1,,2.0,-34,0
8496,5009319,F,Y,N,0,135000.0,Pensioner,Secondary / secondary special,Married,House / apartment,-20140,365243,1,0,1,1,,2.0,-35,0
8497,5009319,F,Y,N,0,135000.0,Pensioner,Secondary / secondary special,Married,House / apartment,-20140,365243,1,0,1,1,,2.0,-36,0
8498,5009319,F,Y,N,0,135000.0,Pensioner,Secondary / secondary special,Married,House / apartment,-20140,365243,1,0,1,1,,2.0,-37,0
8499,5009325,M,Y,N,0,267750.0,Working,Higher education,Married,House / apartment,-20991,-4727,1,0,1,0,Laborers,2.0,0,X
8500,5009325,M,Y,N,0,267750.0,Working,Higher education,Married,House / apartment,-20991,-4727,1,0,1,0,Laborers,2.0,-1,X
8501,5009325,M,Y,N,0,267750.0,Working,Higher education,Married,House / apartment,-20991,-4727,1,0,1,0,Laborers,2.0,-2,X
8502,5009325,M,Y,N,0,267750.0,Working,Higher education,Married,House / apartment,-20991,-4727,1,0,1,0,Laborers,2.0,-3,X
8503,5009325,M,Y,N,0,267750.0,Working,Higher education,Married,House / apartment,-20991,-4727,1,0,1,0,Laborers,2.0,-4,X
8504,5009325,M,Y,N,0,267750.0,Working,Higher education,Married,House / apartment,-20991,-4727,1,0,1,0,Laborers,2.0,-5,X
8505,5009325,M,Y,N,0,267750.0,Working,Higher education,Married,House / apartment,-20991,-4727,1,0,1,0,Laborers,2.0,-6,X
8506,5009325,M,Y,N,0,267750.0,Working,Higher education,Married,House / apartment,-20991,-4727,1,0,1,0,Laborers,2.0,-7,X
8507,5009325,M,Y,N,0,267750.0,Working,Higher education,Married,House / apartment,-20991,-4727,1,0,1,0,Laborers,2.0,-8,X
8508,5009325,M,Y,N,0,267750.0,Working,Higher education,Married,House / apartment,-20991,-4727,1,0,1,0,Laborers,2.0,-9,X
8509,5009325,M,Y,N,0,267750.0,Working,Higher education,Married,House / apartment,-20991,-4727,1,0,1,0,Laborers,2.0,-10,0
8510,5009325,M,Y,N,0,267750.0,Working,Higher education,Married,House / apartment,-20991,-4727,1,0,1,0,Laborers,2.0,-11,0
8511,5009325,M,Y,N,0,267750.0,Working,Higher education,Married,House / apartment,-20991,-4727,1,0,1,0,Laborers,2.0,-12,0
8512,5009325,M,Y,N,0,267750.0,Working,Higher education,Married,House / apartment,-20991,-4727,1,0,1,0,Laborers,2.0,-13,0
8513,5009325,M,Y,N,0,267750.0,Working,Higher education,Married,House / apartment,-20991,-4727,1,0,1,0,Laborers,2.0,-14,0
8514,5009325,M,Y,N,0,267750.0,Working,Higher education,Married,House / apartment,-20991,-4727,1,0,1,0,Laborers,2.0,-15,0
8515,5009325,M,Y,N,0,267750.0,Working,Higher education,Married,House / apartment,-20991,-4727,1,0,1,0,Laborers,2.0,-16,0
8516,5009327,M,Y,N,0,267750.0,Working,Higher education,Married,House / apartment,-20991,-4727,1,0,1,0,Laborers,2.0,-19,X
8517,5009327,M,Y,N,0,267750.0,Working,Higher education,Married,House / apartment,-20991,-4727,1,0,1,0,Laborers,2.0,-20,X
8518,5009327,M,Y,N,0,267750.0,Working,Higher education,Married,House / apartment,-20991,-4727,1,0,1,0,Laborers,2.0,-21,X
8519,5009327,M,Y,N,0,267750.0,Working,Higher education,Married,House / apartment,-20991,-4727,1,0,1,0,Laborers,2.0,-22,X
8520,5009327,M,Y,N,0,267750.0,Working,Higher education,Married,House / apartment,-20991,-4727,1,0,1,0,Laborers,2.0,-23,X
8521,5009327,M,Y,N,0,267750.0,Working,Higher education,Married,House / apartment,-20991,-4727,1,0,1,0,Laborers,2.0,-24,X
8522,5009327,M,Y,N,0,267750.0,Working,Higher education,Married,House / apartment,-20991,-4727,1,0,1,0,Laborers,2.0,-25,X
8523,5009327,M,Y,N,0,267750.0,Working,Higher education,Married,House / apartment,-20991,-4727,1,0,1,0,Laborers,2.0,-26,X
8524,5009327,M,Y,N,0,267750.0,Working,Higher education,Married,House / apartment,-20991,-4727,1,0,1,0,Laborers,2.0,-27,X
8525,5009327,M,Y,N,0,267750.0,Working,Higher education,Married,House / apartment,-20991,-4727,1,0,1,0,Laborers,2.0,-28,X
8526,5009327,M,Y,N,0,267750.0,Working,Higher education,Married,House / apartment,-20991,-4727,1,0,1,0,Laborers,2.0,-29,X
8527,5009327,M,Y,N,0,267750.0,Working,Higher education,Married,House / apartment,-20991,-4727,1,0,1,0,Laborers,2.0,-30,0
8528,5009327,M,Y,N,0,267750.0,Working,Higher education,Married,House / apartment,-20991,-4727,1,0,1,0,Laborers,2.0,-31,0
8529,5009327,M,Y,N,0,267750.0,Working,Higher education,Married,House / apartment,-20991,-4727,1,0,1,0,Laborers,2.0,-32,0
8530,5009327,M,Y,N,0,267750.0,Working,Higher education,Married,House / apartment,-20991,-4727,1,0,1,0,Laborers,2.0,-33,0
8531,5009327,M,Y,N,0,267750.0,Working,Higher education,Married,House / apartment,-20991,-4727,1,0,1,0,Laborers,2.0,-34,0
8532,5009327,M,Y,N,0,267750.0,Working,Higher education,Married,House / apartment,-20991,-4727,1,0,1,0,Laborers,2.0,-35,0
8533,5009327,M,Y,N,0,267750.0,Working,Higher education,Married,House / apartment,-20991,-4727,1,0,1,0,Laborers,2.0,-36,0
8534,5009328,M,Y,N,0,267750.0,Working,Higher education,Married,House / apartment,-20991,-4727,1,0,1,0,Laborers,2.0,-8,X
8535,5009328,M,Y,N,0,267750.0,Working,Higher education,Married,House / apartment,-20991,-4727,1,0,1,0,Laborers,2.0,-9,0
8536,5009328,M,Y,N,0,267750.0,Working,Higher education,Married,House / apartment,-20991,-4727,1,0,1,0,Laborers,2.0,-10,0
8537,5009328,M,Y,N,0,267750.0,Working,Higher education,Married,House / apartment,-20991,-4727,1,0,1,0,Laborers,2.0,-11,0
8538,5009328,M,Y,N,0,267750.0,Working,Higher education,Married,House / apartment,-20991,-4727,1,0,1,0,Laborers,2.0,-12,0
8539,5009328,M,Y,N,0,267750.0,Working,Higher education,Married,House / apartment,-20991,-4727,1,0,1,0,Laborers,2.0,-13,0
8540,5009328,M,Y,N,0,267750.0,Working,Higher education,Married,House / apartment,-20991,-4727,1,0,1,0,Laborers,2.0,-14,0
8541,5009328,M,Y,N,0,267750.0,Working,Higher education,Married,House / apartment,-20991,-4727,1,0,1,0,Laborers,2.0,-15,0
8542,5009328,M,Y,N,0,267750.0,Working,Higher education,Married,House / apartment,-20991,-4727,1,0,1,0,Laborers,2.0,-16,0
8543,5009328,M,Y,N,0,267750.0,Working,Higher education,Married,House / apartment,-20991,-4727,1,0,1,0,Laborers,2.0,-17,0
8544,5009328,M,Y,N,0,267750.0,Working,Higher education,Married,House / apartment,-20991,-4727,1,0,1,0,Laborers,2.0,-18,0
8545,5009329,M,Y,N,0,267750.0,Working,Higher education,Married,House / apartment,-20991,-4727,1,0,1,0,Laborers,2.0,-13,X
8546,5009329,M,Y,N,0,267750.0,Working,Higher education,Married,House / apartment,-20991,-4727,1,0,1,0,Laborers,2.0,-14,X
8547,5009329,M,Y,N,0,267750.0,Working,Higher education,Married,House / apartment,-20991,-4727,1,0,1,0,Laborers,2.0,-15,X
8548,5009329,M,Y,N,0,267750.0,Working,Higher education,Married,House / apartment,-20991,-4727,1,0,1,0,Laborers,2.0,-16,X
8549,5009329,M,Y,N,0,267750.0,Working,Higher education,Married,House / apartment,-20991,-4727,1,0,1,0,Laborers,2.0,-17,X
8550,5009329,M,Y,N,0,267750.0,Working,Higher education,Married,House / apartment,-20991,-4727,1,0,1,0,Laborers,2.0,-18,X
8551,5009329,M,Y,N,0,267750.0,Working,Higher education,Married,House / apartment,-20991,-4727,1,0,1,0,Laborers,2.0,-19,X
8552,5009329,M,Y,N,0,267750.0,Working,Higher education,Married,House / apartment,-20991,-4727,1,0,1,0,Laborers,2.0,-20,X
8553,5009329,M,Y,N,0,267750.0,Working,Higher education,Married,House / apartment,-20991,-4727,1,0,1,0,Laborers,2.0,-21,X
8554,5009329,M,Y,N,0,267750.0,Working,Higher education,Married,House / apartment,-20991,-4727,1,0,1,0,Laborers,2.0,-22,X
8555,5009329,M,Y,N,0,267750.0,Working,Higher education,Married,House / apartment,-20991,-4727,1,0,1,0,Laborers,2.0,-23,X
8556,5009329,M,Y,N,0,267750.0,Working,Higher education,Married,House / apartment,-20991,-4727,1,0,1,0,Laborers,2.0,-24,0
8557,5009329,M,Y,N,0,267750.0,Working,Higher education,Married,House / apartment,-20991,-4727,1,0,1,0,Laborers,2.0,-25,0
8558,5009329,M,Y,N,0,267750.0,Working,Higher education,Married,House / apartment,-20991,-4727,1,0,1,0,Laborers,2.0,-26,0
8559,5009329,M,Y,N,0,267750.0,Working,Higher education,Married,House / apartment,-20991,-4727,1,0,1,0,Laborers,2.0,-27,0
8560,5009329,M,Y,N,0,267750.0,Working,Higher education,Married,House / apartment,-20991,-4727,1,0,1,0,Laborers,2.0,-28,0
8561,5009329,M,Y,N,0,267750.0,Working,Higher education,Married,House / apartment,-20991,-4727,1,0,1,0,Laborers,2.0,-29,0
8562,5009329,M,Y,N,0,267750.0,Working,Higher education,Married,House / apartment,-20991,-4727,1,0,1,0,Laborers,2.0,-30,0
8563,5009330,M,Y,N,0,267750.0,Working,Higher education,Married,House / apartment,-20991,-4727,1,0,1,0,Laborers,2.0,0,C
8564,5009330,M,Y,N,0,267750.0,Working,Higher education,Married,House / apartment,-20991,-4727,1,0,1,0,Laborers,2.0,-1,C
8565,5009330,M,Y,N,0,267750.0,Working,Higher education,Married,House / apartment,-20991,-4727,1,0,1,0,Laborers,2.0,-2,C
8566,5009330,M,Y,N,0,267750.0,Working,Higher education,Married,House / apartment,-20991,-4727,1,0,1,0,Laborers,2.0,-3,C
8567,5009330,M,Y,N,0,267750.0,Working,Higher education,Married,House / apartment,-20991,-4727,1,0,1,0,Laborers,2.0,-4,C
8568,5009330,M,Y,N,0,267750.0,Working,Higher education,Married,House / apartment,-20991,-4727,1,0,1,0,Laborers,2.0,-5,C
8569,5009330,M,Y,N,0,267750.0,Working,Higher education,Married,House / apartment,-20991,-4727,1,0,1,0,Laborers,2.0,-6,C
8570,5009330,M,Y,N,0,267750.0,Working,Higher education,Married,House / apartment,-20991,-4727,1,0,1,0,Laborers,2.0,-7,C
8571,5009330,M,Y,N,0,267750.0,Working,Higher education,Married,House / apartment,-20991,-4727,1,0,1,0,Laborers,2.0,-8,C
8572,5009330,M,Y,N,0,267750.0,Working,Higher education,Married,House / apartment,-20991,-4727,1,0,1,0,Laborers,2.0,-9,C
8573,5009330,M,Y,N,0,267750.0,Working,Higher education,Married,House / apartment,-20991,-4727,1,0,1,0,Laborers,2.0,-10,C
8574,5009330,M,Y,N,0,267750.0,Working,Higher education,Married,House / apartment,-20991,-4727,1,0,1,0,Laborers,2.0,-11,0
8575,5009330,M,Y,N,0,267750.0,Working,Higher education,Married,House / apartment,-20991,-4727,1,0,1,0,Laborers,2.0,-12,0
8576,5009330,M,Y,N,0,267750.0,Working,Higher education,Married,House / apartment,-20991,-4727,1,0,1,0,Laborers,2.0,-13,X
8577,5009330,M,Y,N,0,267750.0,Working,Higher education,Married,House / apartment,-20991,-4727,1,0,1,0,Laborers,2.0,-14,0
8578,5009331,M,Y,N,0,267750.0,Working,Higher education,Married,House / apartment,-20991,-4727,1,0,1,0,Laborers,2.0,-18,X
8579,5009331,M,Y,N,0,267750.0,Working,Higher education,Married,House / apartment,-20991,-4727,1,0,1,0,Laborers,2.0,-19,X
8580,5009331,M,Y,N,0,267750.0,Working,Higher education,Married,House / apartment,-20991,-4727,1,0,1,0,Laborers,2.0,-20,X
8581,5009331,M,Y,N,0,267750.0,Working,Higher education,Married,House / apartment,-20991,-4727,1,0,1,0,Laborers,2.0,-21,X
8582,5009331,M,Y,N,0,267750.0,Working,Higher education,Married,House / apartment,-20991,-4727,1,0,1,0,Laborers,2.0,-22,X
8583,5009331,M,Y,N,0,267750.0,Working,Higher education,Married,House / apartment,-20991,-4727,1,0,1,0,Laborers,2.0,-23,X
8584,5009331,M,Y,N,0,267750.0,Working,Higher education,Married,House / apartment,-20991,-4727,1,0,1,0,Laborers,2.0,-24,X
8585,5009331,M,Y,N,0,267750.0,Working,Higher education,Married,House / apartment,-20991,-4727,1,0,1,0,Laborers,2.0,-25,X
8586,5009331,M,Y,N,0,267750.0,Working,Higher education,Married,House / apartment,-20991,-4727,1,0,1,0,Laborers,2.0,-26,X
8587,5009331,M,Y,N,0,267750.0,Working,Higher education,Married,House / apartment,-20991,-4727,1,0,1,0,Laborers,2.0,-27,X
8588,5009331,M,Y,N,0,267750.0,Working,Higher education,Married,House / apartment,-20991,-4727,1,0,1,0,Laborers,2.0,-28,X
8589,5009331,M,Y,N,0,267750.0,Working,Higher education,Married,House / apartment,-20991,-4727,1,0,1,0,Laborers,2.0,-29,0
8590,5009331,M,Y,N,0,267750.0,Working,Higher education,Married,House / apartment,-20991,-4727,1,0,1,0,Laborers,2.0,-30,0
8591,5009331,M,Y,N,0,267750.0,Working,Higher education,Married,House / apartment,-20991,-4727,1,0,1,0,Laborers,2.0,-31,0
8592,5009331,M,Y,N,0,267750.0,Working,Higher education,Married,House / apartment,-20991,-4727,1,0,1,0,Laborers,2.0,-32,0
8593,5009331,M,Y,N,0,267750.0,Working,Higher education,Married,House / apartment,-20991,-4727,1,0,1,0,Laborers,2.0,-33,0
8594,5009331,M,Y,N,0,267750.0,Working,Higher education,Married,House / apartment,-20991,-4727,1,0,1,0,Laborers,2.0,-34,0
8595,5009331,M,Y,N,0,267750.0,Working,Higher education,Married,House / apartment,-20991,-4727,1,0,1,0,Laborers,2.0,-35,0
8596,5009332,M,Y,N,0,267750.0,Working,Higher education,Married,House / apartment,-20991,-4727,1,0,1,0,Laborers,2.0,-38,X
8597,5009332,M,Y,N,0,267750.0,Working,Higher education,Married,House / apartment,-20991,-4727,1,0,1,0,Laborers,2.0,-39,0
8598,5009332,M,Y,N,0,267750.0,Working,Higher education,Married,House / apartment,-20991,-4727,1,0,1,0,Laborers,2.0,-40,0
8599,5009332,M,Y,N,0,267750.0,Working,Higher education,Married,House / apartment,-20991,-4727,1,0,1,0,Laborers,2.0,-41,0
8600,5009332,M,Y,N,0,267750.0,Working,Higher education,Married,House / apartment,-20991,-4727,1,0,1,0,Laborers,2.0,-42,0
8601,5009332,M,Y,N,0,267750.0,Working,Higher education,Married,House / apartment,-20991,-4727,1,0,1,0,Laborers,2.0,-43,0
8602,5009332,M,Y,N,0,267750.0,Working,Higher education,Married,House / apartment,-20991,-4727,1,0,1,0,Laborers,2.0,-44,0
8603,5009332,M,Y,N,0,267750.0,Working,Higher education,Married,House / apartment,-20991,-4727,1,0,1,0,Laborers,2.0,-45,0
8604,5009332,M,Y,N,0,267750.0,Working,Higher education,Married,House / apartment,-20991,-4727,1,0,1,0,Laborers,2.0,-46,0
8605,5009332,M,Y,N,0,267750.0,Working,Higher education,Married,House / apartment,-20991,-4727,1,0,1,0,Laborers,2.0,-47,0
8606,5009332,M,Y,N,0,267750.0,Working,Higher education,Married,House / apartment,-20991,-4727,1,0,1,0,Laborers,2.0,-48,0
8607,5009332,M,Y,N,0,267750.0,Working,Higher education,Married,House / apartment,-20991,-4727,1,0,1,0,Laborers,2.0,-49,0
8608,5009332,M,Y,N,0,267750.0,Working,Higher education,Married,House / apartment,-20991,-4727,1,0,1,0,Laborers,2.0,-50,0
8609,5009332,M,Y,N,0,267750.0,Working,Higher education,Married,House / apartment,-20991,-4727,1,0,1,0,Laborers,2.0,-51,0
8610,5009332,M,Y,N,0,267750.0,Working,Higher education,Married,House / apartment,-20991,-4727,1,0,1,0,Laborers,2.0,-52,0
8611,5009333,M,Y,N,0,267750.0,Working,Higher education,Married,House / apartment,-20991,-4727,1,0,1,0,Laborers,2.0,-39,X
8612,5009333,M,Y,N,0,267750.0,Working,Higher education,Married,House / apartment,-20991,-4727,1,0,1,0,Laborers,2.0,-40,X
8613,5009333,M,Y,N,0,267750.0,Working,Higher education,Married,House / apartment,-20991,-4727,1,0,1,0,Laborers,2.0,-41,X
8614,5009333,M,Y,N,0,267750.0,Working,Higher education,Married,House / apartment,-20991,-4727,1,0,1,0,Laborers,2.0,-42,X
8615,5009333,M,Y,N,0,267750.0,Working,Higher education,Married,House / apartment,-20991,-4727,1,0,1,0,Laborers,2.0,-43,X
8616,5009333,M,Y,N,0,267750.0,Working,Higher education,Married,House / apartment,-20991,-4727,1,0,1,0,Laborers,2.0,-44,X
8617,5009333,M,Y,N,0,267750.0,Working,Higher education,Married,House / apartment,-20991,-4727,1,0,1,0,Laborers,2.0,-45,X
8618,5009333,M,Y,N,0,267750.0,Working,Higher education,Married,House / apartment,-20991,-4727,1,0,1,0,Laborers,2.0,-46,X
8619,5009333,M,Y,N,0,267750.0,Working,Higher education,Married,House / apartment,-20991,-4727,1,0,1,0,Laborers,2.0,-47,X
8620,5009333,M,Y,N,0,267750.0,Working,Higher education,Married,House / apartment,-20991,-4727,1,0,1,0,Laborers,2.0,-48,X
8621,5009333,M,Y,N,0,267750.0,Working,Higher education,Married,House / apartment,-20991,-4727,1,0,1,0,Laborers,2.0,-49,X
8622,5009333,M,Y,N,0,267750.0,Working,Higher education,Married,House / apartment,-20991,-4727,1,0,1,0,Laborers,2.0,-50,X
8623,5009333,M,Y,N,0,267750.0,Working,Higher education,Married,House / apartment,-20991,-4727,1,0,1,0,Laborers,2.0,-51,X
8624,5009333,M,Y,N,0,267750.0,Working,Higher education,Married,House / apartment,-20991,-4727,1,0,1,0,Laborers,2.0,-52,X
8625,5009333,M,Y,N,0,267750.0,Working,Higher education,Married,House / apartment,-20991,-4727,1,0,1,0,Laborers,2.0,-53,X
8626,5009333,M,Y,N,0,267750.0,Working,Higher education,Married,House / apartment,-20991,-4727,1,0,1,0,Laborers,2.0,-54,X
8627,5009333,M,Y,N,0,267750.0,Working,Higher education,Married,House / apartment,-20991,-4727,1,0,1,0,Laborers,2.0,-55,X
8628,5009335,F,N,N,0,139500.0,Working,Higher education,Separated,House / apartment,-16203,-7100,1,0,0,0,Managers,1.0,0,0
8629,5009335,F,N,N,0,139500.0,Working,Higher education,Separated,House / apartment,-16203,-7100,1,0,0,0,Managers,1.0,-1,0
8630,5009335,F,N,N,0,139500.0,Working,Higher education,Separated,House / apartment,-16203,-7100,1,0,0,0,Managers,1.0,-2,X
8631,5009335,F,N,N,0,139500.0,Working,Higher education,Separated,House / apartment,-16203,-7100,1,0,0,0,Managers,1.0,-3,X
8632,5009335,F,N,N,0,139500.0,Working,Higher education,Separated,House / apartment,-16203,-7100,1,0,0,0,Managers,1.0,-4,X
8633,5009335,F,N,N,0,139500.0,Working,Higher education,Separated,House / apartment,-16203,-7100,1,0,0,0,Managers,1.0,-5,0
8634,5009335,F,N,N,0,139500.0,Working,Higher education,Separated,House / apartment,-16203,-7100,1,0,0,0,Managers,1.0,-6,0
8635,5009335,F,N,N,0,139500.0,Working,Higher education,Separated,House / apartment,-16203,-7100,1,0,0,0,Managers,1.0,-7,X
8636,5009335,F,N,N,0,139500.0,Working,Higher education,Separated,House / apartment,-16203,-7100,1,0,0,0,Managers,1.0,-8,0
8637,5009335,F,N,N,0,139500.0,Working,Higher education,Separated,House / apartment,-16203,-7100,1,0,0,0,Managers,1.0,-9,X
8638,5009336,F,N,N,0,139500.0,Working,Higher education,Separated,House / apartment,-16203,-7100,1,0,0,0,Managers,1.0,-1,X
8639,5009336,F,N,N,0,139500.0,Working,Higher education,Separated,House / apartment,-16203,-7100,1,0,0,0,Managers,1.0,-2,0
8640,5009336,F,N,N,0,139500.0,Working,Higher education,Separated,House / apartment,-16203,-7100,1,0,0,0,Managers,1.0,-3,0
8641,5009336,F,N,N,0,139500.0,Working,Higher education,Separated,House / apartment,-16203,-7100,1,0,0,0,Managers,1.0,-4,0
8642,5009336,F,N,N,0,139500.0,Working,Higher education,Separated,House / apartment,-16203,-7100,1,0,0,0,Managers,1.0,-5,0
8643,5009336,F,N,N,0,139500.0,Working,Higher education,Separated,House / apartment,-16203,-7100,1,0,0,0,Managers,1.0,-6,0
8644,5009336,F,N,N,0,139500.0,Working,Higher education,Separated,House / apartment,-16203,-7100,1,0,0,0,Managers,1.0,-7,X
8645,5009336,F,N,N,0,139500.0,Working,Higher education,Separated,House / apartment,-16203,-7100,1,0,0,0,Managers,1.0,-8,0
8646,5009336,F,N,N,0,139500.0,Working,Higher education,Separated,House / apartment,-16203,-7100,1,0,0,0,Managers,1.0,-9,0
8647,5009336,F,N,N,0,139500.0,Working,Higher education,Separated,House / apartment,-16203,-7100,1,0,0,0,Managers,1.0,-10,X
8648,5009336,F,N,N,0,139500.0,Working,Higher education,Separated,House / apartment,-16203,-7100,1,0,0,0,Managers,1.0,-11,X
8649,5009336,F,N,N,0,139500.0,Working,Higher education,Separated,House / apartment,-16203,-7100,1,0,0,0,Managers,1.0,-12,X
8650,5009336,F,N,N,0,139500.0,Working,Higher education,Separated,House / apartment,-16203,-7100,1,0,0,0,Managers,1.0,-13,0
8651,5009336,F,N,N,0,139500.0,Working,Higher education,Separated,House / apartment,-16203,-7100,1,0,0,0,Managers,1.0,-14,0
8652,5009336,F,N,N,0,139500.0,Working,Higher education,Separated,House / apartment,-16203,-7100,1,0,0,0,Managers,1.0,-15,X
8653,5009336,F,N,N,0,139500.0,Working,Higher education,Separated,House / apartment,-16203,-7100,1,0,0,0,Managers,1.0,-16,0
8654,5009336,F,N,N,0,139500.0,Working,Higher education,Separated,House / apartment,-16203,-7100,1,0,0,0,Managers,1.0,-17,X
8655,5009337,F,N,N,0,139500.0,Working,Higher education,Separated,House / apartment,-16203,-7100,1,0,0,0,Managers,1.0,-29,X
8656,5009337,F,N,N,0,139500.0,Working,Higher education,Separated,House / apartment,-16203,-7100,1,0,0,0,Managers,1.0,-30,0
8657,5009337,F,N,N,0,139500.0,Working,Higher education,Separated,House / apartment,-16203,-7100,1,0,0,0,Managers,1.0,-31,0
8658,5009337,F,N,N,0,139500.0,Working,Higher education,Separated,House / apartment,-16203,-7100,1,0,0,0,Managers,1.0,-32,0
8659,5009337,F,N,N,0,139500.0,Working,Higher education,Separated,House / apartment,-16203,-7100,1,0,0,0,Managers,1.0,-33,0
8660,5009337,F,N,N,0,139500.0,Working,Higher education,Separated,House / apartment,-16203,-7100,1,0,0,0,Managers,1.0,-34,0
8661,5009337,F,N,N,0,139500.0,Working,Higher education,Separated,House / apartment,-16203,-7100,1,0,0,0,Managers,1.0,-35,X
8662,5009337,F,N,N,0,139500.0,Working,Higher education,Separated,House / apartment,-16203,-7100,1,0,0,0,Managers,1.0,-36,0
8663,5009337,F,N,N,0,139500.0,Working,Higher education,Separated,House / apartment,-16203,-7100,1,0,0,0,Managers,1.0,-37,0
8664,5009337,F,N,N,0,139500.0,Working,Higher education,Separated,House / apartment,-16203,-7100,1,0,0,0,Managers,1.0,-38,X
8665,5009337,F,N,N,0,139500.0,Working,Higher education,Separated,House / apartment,-16203,-7100,1,0,0,0,Managers,1.0,-39,X
8666,5009337,F,N,N,0,139500.0,Working,Higher education,Separated,House / apartment,-16203,-7100,1,0,0,0,Managers,1.0,-40,X
8667,5009337,F,N,N,0,139500.0,Working,Higher education,Separated,House / apartment,-16203,-7100,1,0,0,0,Managers,1.0,-41,0
8668,5009337,F,N,N,0,139500.0,Working,Higher education,Separated,House / apartment,-16203,-7100,1,0,0,0,Managers,1.0,-42,0
8669,5009337,F,N,N,0,139500.0,Working,Higher education,Separated,House / apartment,-16203,-7100,1,0,0,0,Managers,1.0,-43,X
8670,5009337,F,N,N,0,139500.0,Working,Higher education,Separated,House / apartment,-16203,-7100,1,0,0,0,Managers,1.0,-44,0
8671,5009337,F,N,N,0,139500.0,Working,Higher education,Separated,House / apartment,-16203,-7100,1,0,0,0,Managers,1.0,-45,X
8672,5009338,M,N,N,0,67500.0,Working,Secondary / secondary special,Married,House / apartment,-18674,-5304,1,1,1,0,Security staff,2.0,0,0
8673,5009338,M,N,N,0,67500.0,Working,Secondary / secondary special,Married,House / apartment,-18674,-5304,1,1,1,0,Security staff,2.0,-1,0
8674,5009338,M,N,N,0,67500.0,Working,Secondary / secondary special,Married,House / apartment,-18674,-5304,1,1,1,0,Security staff,2.0,-2,0
8675,5009338,M,N,N,0,67500.0,Working,Secondary / secondary special,Married,House / apartment,-18674,-5304,1,1,1,0,Security staff,2.0,-3,0
8676,5009338,M,N,N,0,67500.0,Working,Secondary / secondary special,Married,House / apartment,-18674,-5304,1,1,1,0,Security staff,2.0,-4,0
8677,5009338,M,N,N,0,67500.0,Working,Secondary / secondary special,Married,House / apartment,-18674,-5304,1,1,1,0,Security staff,2.0,-5,0
8678,5009338,M,N,N,0,67500.0,Working,Secondary / secondary special,Married,House / apartment,-18674,-5304,1,1,1,0,Security staff,2.0,-6,0
8679,5009338,M,N,N,0,67500.0,Working,Secondary / secondary special,Married,House / apartment,-18674,-5304,1,1,1,0,Security staff,2.0,-7,0
8680,5009338,M,N,N,0,67500.0,Working,Secondary / secondary special,Married,House / apartment,-18674,-5304,1,1,1,0,Security staff,2.0,-8,0
8681,5009338,M,N,N,0,67500.0,Working,Secondary / secondary special,Married,House / apartment,-18674,-5304,1,1,1,0,Security staff,2.0,-9,0
8682,5009338,M,N,N,0,67500.0,Working,Secondary / secondary special,Married,House / apartment,-18674,-5304,1,1,1,0,Security staff,2.0,-10,0
8683,5009338,M,N,N,0,67500.0,Working,Secondary / secondary special,Married,House / apartment,-18674,-5304,1,1,1,0,Security staff,2.0,-11,0
8684,5009338,M,N,N,0,67500.0,Working,Secondary / secondary special,Married,House / apartment,-18674,-5304,1,1,1,0,Security staff,2.0,-12,0
8685,5009339,M,N,N,0,67500.0,Working,Secondary / secondary special,Married,House / apartment,-18674,-5304,1,1,1,0,Security staff,2.0,-22,X
8686,5009339,M,N,N,0,67500.0,Working,Secondary / secondary special,Married,House / apartment,-18674,-5304,1,1,1,0,Security staff,2.0,-23,0
8687,5009339,M,N,N,0,67500.0,Working,Secondary / secondary special,Married,House / apartment,-18674,-5304,1,1,1,0,Security staff,2.0,-24,0
8688,5009339,M,N,N,0,67500.0,Working,Secondary / secondary special,Married,House / apartment,-18674,-5304,1,1,1,0,Security staff,2.0,-25,0
8689,5009339,M,N,N,0,67500.0,Working,Secondary / secondary special,Married,House / apartment,-18674,-5304,1,1,1,0,Security staff,2.0,-26,0
8690,5009339,M,N,N,0,67500.0,Working,Secondary / secondary special,Married,House / apartment,-18674,-5304,1,1,1,0,Security staff,2.0,-27,0
8691,5009339,M,N,N,0,67500.0,Working,Secondary / secondary special,Married,House / apartment,-18674,-5304,1,1,1,0,Security staff,2.0,-28,1
8692,5009339,M,N,N,0,67500.0,Working,Secondary / secondary special,Married,House / apartment,-18674,-5304,1,1,1,0,Security staff,2.0,-29,1
8693,5009339,M,N,N,0,67500.0,Working,Secondary / secondary special,Married,House / apartment,-18674,-5304,1,1,1,0,Security staff,2.0,-30,1
8694,5009339,M,N,N,0,67500.0,Working,Secondary / secondary special,Married,House / apartment,-18674,-5304,1,1,1,0,Security staff,2.0,-31,0
8695,5009339,M,N,N,0,67500.0,Working,Secondary / secondary special,Married,House / apartment,-18674,-5304,1,1,1,0,Security staff,2.0,-32,0
8696,5009339,M,N,N,0,67500.0,Working,Secondary / secondary special,Married,House / apartment,-18674,-5304,1,1,1,0,Security staff,2.0,-33,0
8697,5009339,M,N,N,0,67500.0,Working,Secondary / secondary special,Married,House / apartment,-18674,-5304,1,1,1,0,Security staff,2.0,-34,0
8698,5009340,M,Y,N,0,252000.0,Working,Secondary / secondary special,Married,House / apartment,-10750,-2443,1,0,0,0,High skill tech staff,2.0,-23,C
8699,5009340,M,Y,N,0,252000.0,Working,Secondary / secondary special,Married,House / apartment,-10750,-2443,1,0,0,0,High skill tech staff,2.0,-24,C
8700,5009340,M,Y,N,0,252000.0,Working,Secondary / secondary special,Married,House / apartment,-10750,-2443,1,0,0,0,High skill tech staff,2.0,-25,C
8701,5009340,M,Y,N,0,252000.0,Working,Secondary / secondary special,Married,House / apartment,-10750,-2443,1,0,0,0,High skill tech staff,2.0,-26,C
8702,5009340,M,Y,N,0,252000.0,Working,Secondary / secondary special,Married,House / apartment,-10750,-2443,1,0,0,0,High skill tech staff,2.0,-27,C
8703,5009340,M,Y,N,0,252000.0,Working,Secondary / secondary special,Married,House / apartment,-10750,-2443,1,0,0,0,High skill tech staff,2.0,-28,C
8704,5009340,M,Y,N,0,252000.0,Working,Secondary / secondary special,Married,House / apartment,-10750,-2443,1,0,0,0,High skill tech staff,2.0,-29,C
8705,5009340,M,Y,N,0,252000.0,Working,Secondary / secondary special,Married,House / apartment,-10750,-2443,1,0,0,0,High skill tech staff,2.0,-30,C
8706,5009340,M,Y,N,0,252000.0,Working,Secondary / secondary special,Married,House / apartment,-10750,-2443,1,0,0,0,High skill tech staff,2.0,-31,C
8707,5009340,M,Y,N,0,252000.0,Working,Secondary / secondary special,Married,House / apartment,-10750,-2443,1,0,0,0,High skill tech staff,2.0,-32,C
8708,5009340,M,Y,N,0,252000.0,Working,Secondary / secondary special,Married,House / apartment,-10750,-2443,1,0,0,0,High skill tech staff,2.0,-33,C
8709,5009340,M,Y,N,0,252000.0,Working,Secondary / secondary special,Married,House / apartment,-10750,-2443,1,0,0,0,High skill tech staff,2.0,-34,C
8710,5009340,M,Y,N,0,252000.0,Working,Secondary / secondary special,Married,House / apartment,-10750,-2443,1,0,0,0,High skill tech staff,2.0,-35,C
8711,5009340,M,Y,N,0,252000.0,Working,Secondary / secondary special,Married,House / apartment,-10750,-2443,1,0,0,0,High skill tech staff,2.0,-36,C
8712,5009340,M,Y,N,0,252000.0,Working,Secondary / secondary special,Married,House / apartment,-10750,-2443,1,0,0,0,High skill tech staff,2.0,-37,C
8713,5009340,M,Y,N,0,252000.0,Working,Secondary / secondary special,Married,House / apartment,-10750,-2443,1,0,0,0,High skill tech staff,2.0,-38,C
8714,5009340,M,Y,N,0,252000.0,Working,Secondary / secondary special,Married,House / apartment,-10750,-2443,1,0,0,0,High skill tech staff,2.0,-39,C
8715,5009340,M,Y,N,0,252000.0,Working,Secondary / secondary special,Married,House / apartment,-10750,-2443,1,0,0,0,High skill tech staff,2.0,-40,0
8716,5009340,M,Y,N,0,252000.0,Working,Secondary / secondary special,Married,House / apartment,-10750,-2443,1,0,0,0,High skill tech staff,2.0,-41,0
8717,5009340,M,Y,N,0,252000.0,Working,Secondary / secondary special,Married,House / apartment,-10750,-2443,1,0,0,0,High skill tech staff,2.0,-42,0
8718,5009340,M,Y,N,0,252000.0,Working,Secondary / secondary special,Married,House / apartment,-10750,-2443,1,0,0,0,High skill tech staff,2.0,-43,0
8719,5009340,M,Y,N,0,252000.0,Working,Secondary / secondary special,Married,House / apartment,-10750,-2443,1,0,0,0,High skill tech staff,2.0,-44,0
8720,5009340,M,Y,N,0,252000.0,Working,Secondary / secondary special,Married,House / apartment,-10750,-2443,1,0,0,0,High skill tech staff,2.0,-45,0
8721,5009340,M,Y,N,0,252000.0,Working,Secondary / secondary special,Married,House / apartment,-10750,-2443,1,0,0,0,High skill tech staff,2.0,-46,0
8722,5009340,M,Y,N,0,252000.0,Working,Secondary / secondary special,Married,House / apartment,-10750,-2443,1,0,0,0,High skill tech staff,2.0,-47,0
8723,5009340,M,Y,N,0,252000.0,Working,Secondary / secondary special,Married,House / apartment,-10750,-2443,1,0,0,0,High skill tech staff,2.0,-48,0
8724,5009340,M,Y,N,0,252000.0,Working,Secondary / secondary special,Married,House / apartment,-10750,-2443,1,0,0,0,High skill tech staff,2.0,-49,0
8725,5009340,M,Y,N,0,252000.0,Working,Secondary / secondary special,Married,House / apartment,-10750,-2443,1,0,0,0,High skill tech staff,2.0,-50,0
8726,5009340,M,Y,N,0,252000.0,Working,Secondary / secondary special,Married,House / apartment,-10750,-2443,1,0,0,0,High skill tech staff,2.0,-51,0
8727,5009340,M,Y,N,0,252000.0,Working,Secondary / secondary special,Married,House / apartment,-10750,-2443,1,0,0,0,High skill tech staff,2.0,-52,0
8728,5009340,M,Y,N,0,252000.0,Working,Secondary / secondary special,Married,House / apartment,-10750,-2443,1,0,0,0,High skill tech staff,2.0,-53,0
8729,5009340,M,Y,N,0,252000.0,Working,Secondary / secondary special,Married,House / apartment,-10750,-2443,1,0,0,0,High skill tech staff,2.0,-54,0
8730,5009340,M,Y,N,0,252000.0,Working,Secondary / secondary special,Married,House / apartment,-10750,-2443,1,0,0,0,High skill tech staff,2.0,-55,0
8731,5009340,M,Y,N,0,252000.0,Working,Secondary / secondary special,Married,House / apartment,-10750,-2443,1,0,0,0,High skill tech staff,2.0,-56,0
8732,5009340,M,Y,N,0,252000.0,Working,Secondary / secondary special,Married,House / apartment,-10750,-2443,1,0,0,0,High skill tech staff,2.0,-57,0
8733,5009341,M,Y,N,0,252000.0,Working,Secondary / secondary special,Married,House / apartment,-10750,-2443,1,0,0,0,High skill tech staff,2.0,-26,C
8734,5009341,M,Y,N,0,252000.0,Working,Secondary / secondary special,Married,House / apartment,-10750,-2443,1,0,0,0,High skill tech staff,2.0,-27,C
8735,5009341,M,Y,N,0,252000.0,Working,Secondary / secondary special,Married,House / apartment,-10750,-2443,1,0,0,0,High skill tech staff,2.0,-28,C
8736,5009341,M,Y,N,0,252000.0,Working,Secondary / secondary special,Married,House / apartment,-10750,-2443,1,0,0,0,High skill tech staff,2.0,-29,C
8737,5009341,M,Y,N,0,252000.0,Working,Secondary / secondary special,Married,House / apartment,-10750,-2443,1,0,0,0,High skill tech staff,2.0,-30,C
8738,5009341,M,Y,N,0,252000.0,Working,Secondary / secondary special,Married,House / apartment,-10750,-2443,1,0,0,0,High skill tech staff,2.0,-31,C
8739,5009341,M,Y,N,0,252000.0,Working,Secondary / secondary special,Married,House / apartment,-10750,-2443,1,0,0,0,High skill tech staff,2.0,-32,C
8740,5009341,M,Y,N,0,252000.0,Working,Secondary / secondary special,Married,House / apartment,-10750,-2443,1,0,0,0,High skill tech staff,2.0,-33,C
8741,5009341,M,Y,N,0,252000.0,Working,Secondary / secondary special,Married,House / apartment,-10750,-2443,1,0,0,0,High skill tech staff,2.0,-34,C
8742,5009341,M,Y,N,0,252000.0,Working,Secondary / secondary special,Married,House / apartment,-10750,-2443,1,0,0,0,High skill tech staff,2.0,-35,C
8743,5009341,M,Y,N,0,252000.0,Working,Secondary / secondary special,Married,House / apartment,-10750,-2443,1,0,0,0,High skill tech staff,2.0,-36,C
8744,5009341,M,Y,N,0,252000.0,Working,Secondary / secondary special,Married,House / apartment,-10750,-2443,1,0,0,0,High skill tech staff,2.0,-37,C
8745,5009341,M,Y,N,0,252000.0,Working,Secondary / secondary special,Married,House / apartment,-10750,-2443,1,0,0,0,High skill tech staff,2.0,-38,C
8746,5009341,M,Y,N,0,252000.0,Working,Secondary / secondary special,Married,House / apartment,-10750,-2443,1,0,0,0,High skill tech staff,2.0,-39,C
8747,5009341,M,Y,N,0,252000.0,Working,Secondary / secondary special,Married,House / apartment,-10750,-2443,1,0,0,0,High skill tech staff,2.0,-40,C
8748,5009341,M,Y,N,0,252000.0,Working,Secondary / secondary special,Married,House / apartment,-10750,-2443,1,0,0,0,High skill tech staff,2.0,-41,C
8749,5009341,M,Y,N,0,252000.0,Working,Secondary / secondary special,Married,House / apartment,-10750,-2443,1,0,0,0,High skill tech staff,2.0,-42,C
8750,5009341,M,Y,N,0,252000.0,Working,Secondary / secondary special,Married,House / apartment,-10750,-2443,1,0,0,0,High skill tech staff,2.0,-43,0
8751,5009341,M,Y,N,0,252000.0,Working,Secondary / secondary special,Married,House / apartment,-10750,-2443,1,0,0,0,High skill tech staff,2.0,-44,0
8752,5009341,M,Y,N,0,252000.0,Working,Secondary / secondary special,Married,House / apartment,-10750,-2443,1,0,0,0,High skill tech staff,2.0,-45,0
8753,5009341,M,Y,N,0,252000.0,Working,Secondary / secondary special,Married,House / apartment,-10750,-2443,1,0,0,0,High skill tech staff,2.0,-46,0
8754,5009341,M,Y,N,0,252000.0,Working,Secondary / secondary special,Married,House / apartment,-10750,-2443,1,0,0,0,High skill tech staff,2.0,-47,0
8755,5009341,M,Y,N,0,252000.0,Working,Secondary / secondary special,Married,House / apartment,-10750,-2443,1,0,0,0,High skill tech staff,2.0,-48,0
8756,5009341,M,Y,N,0,252000.0,Working,Secondary / secondary special,Married,House / apartment,-10750,-2443,1,0,0,0,High skill tech staff,2.0,-49,0
8757,5009341,M,Y,N,0,252000.0,Working,Secondary / secondary special,Married,House / apartment,-10750,-2443,1,0,0,0,High skill tech staff,2.0,-50,0
8758,5009341,M,Y,N,0,252000.0,Working,Secondary / secondary special,Married,House / apartment,-10750,-2443,1,0,0,0,High skill tech staff,2.0,-51,0
8759,5009341,M,Y,N,0,252000.0,Working,Secondary / secondary special,Married,House / apartment,-10750,-2443,1,0,0,0,High skill tech staff,2.0,-52,0
8760,5009341,M,Y,N,0,252000.0,Working,Secondary / secondary special,Married,House / apartment,-10750,-2443,1,0,0,0,High skill tech staff,2.0,-53,0
8761,5009341,M,Y,N,0,252000.0,Working,Secondary / secondary special,Married,House / apartment,-10750,-2443,1,0,0,0,High skill tech staff,2.0,-54,0
8762,5009341,M,Y,N,0,252000.0,Working,Secondary / secondary special,Married,House / apartment,-10750,-2443,1,0,0,0,High skill tech staff,2.0,-55,0
8763,5009341,M,Y,N,0,252000.0,Working,Secondary / secondary special,Married,House / apartment,-10750,-2443,1,0,0,0,High skill tech staff,2.0,-56,0
8764,5009341,M,Y,N,0,252000.0,Working,Secondary / secondary special,Married,House / apartment,-10750,-2443,1,0,0,0,High skill tech staff,2.0,-57,0
8765,5009341,M,Y,N,0,252000.0,Working,Secondary / secondary special,Married,House / apartment,-10750,-2443,1,0,0,0,High skill tech staff,2.0,-58,0
8766,5009341,M,Y,N,0,252000.0,Working,Secondary / secondary special,Married,House / apartment,-10750,-2443,1,0,0,0,High skill tech staff,2.0,-59,0
8767,5009341,M,Y,N,0,252000.0,Working,Secondary / secondary special,Married,House / apartment,-10750,-2443,1,0,0,0,High skill tech staff,2.0,-60,0
8768,5009342,M,Y,N,0,252000.0,Working,Secondary / secondary special,Married,House / apartment,-10750,-2443,1,0,0,0,High skill tech staff,2.0,-6,X
8769,5009342,M,Y,N,0,252000.0,Working,Secondary / secondary special,Married,House / apartment,-10750,-2443,1,0,0,0,High skill tech staff,2.0,-7,X
8770,5009342,M,Y,N,0,252000.0,Working,Secondary / secondary special,Married,House / apartment,-10750,-2443,1,0,0,0,High skill tech staff,2.0,-8,X
8771,5009342,M,Y,N,0,252000.0,Working,Secondary / secondary special,Married,House / apartment,-10750,-2443,1,0,0,0,High skill tech staff,2.0,-9,X
8772,5009342,M,Y,N,0,252000.0,Working,Secondary / secondary special,Married,House / apartment,-10750,-2443,1,0,0,0,High skill tech staff,2.0,-10,0
8773,5009342,M,Y,N,0,252000.0,Working,Secondary / secondary special,Married,House / apartment,-10750,-2443,1,0,0,0,High skill tech staff,2.0,-11,0
8774,5009342,M,Y,N,0,252000.0,Working,Secondary / secondary special,Married,House / apartment,-10750,-2443,1,0,0,0,High skill tech staff,2.0,-12,0
8775,5009342,M,Y,N,0,252000.0,Working,Secondary / secondary special,Married,House / apartment,-10750,-2443,1,0,0,0,High skill tech staff,2.0,-13,0
8776,5009342,M,Y,N,0,252000.0,Working,Secondary / secondary special,Married,House / apartment,-10750,-2443,1,0,0,0,High skill tech staff,2.0,-14,0
8777,5009342,M,Y,N,0,252000.0,Working,Secondary / secondary special,Married,House / apartment,-10750,-2443,1,0,0,0,High skill tech staff,2.0,-15,0
8778,5009342,M,Y,N,0,252000.0,Working,Secondary / secondary special,Married,House / apartment,-10750,-2443,1,0,0,0,High skill tech staff,2.0,-16,0
8779,5009342,M,Y,N,0,252000.0,Working,Secondary / secondary special,Married,House / apartment,-10750,-2443,1,0,0,0,High skill tech staff,2.0,-17,0
8780,5009342,M,Y,N,0,252000.0,Working,Secondary / secondary special,Married,House / apartment,-10750,-2443,1,0,0,0,High skill tech staff,2.0,-18,0
8781,5009342,M,Y,N,0,252000.0,Working,Secondary / secondary special,Married,House / apartment,-10750,-2443,1,0,0,0,High skill tech staff,2.0,-19,0
8782,5009342,M,Y,N,0,252000.0,Working,Secondary / secondary special,Married,House / apartment,-10750,-2443,1,0,0,0,High skill tech staff,2.0,-20,0
8783,5009342,M,Y,N,0,252000.0,Working,Secondary / secondary special,Married,House / apartment,-10750,-2443,1,0,0,0,High skill tech staff,2.0,-21,0
8784,5009342,M,Y,N,0,252000.0,Working,Secondary / secondary special,Married,House / apartment,-10750,-2443,1,0,0,0,High skill tech staff,2.0,-22,0
8785,5009342,M,Y,N,0,252000.0,Working,Secondary / secondary special,Married,House / apartment,-10750,-2443,1,0,0,0,High skill tech staff,2.0,-23,0
8786,5009342,M,Y,N,0,252000.0,Working,Secondary / secondary special,Married,House / apartment,-10750,-2443,1,0,0,0,High skill tech staff,2.0,-24,0
8787,5009342,M,Y,N,0,252000.0,Working,Secondary / secondary special,Married,House / apartment,-10750,-2443,1,0,0,0,High skill tech staff,2.0,-25,0
8788,5009342,M,Y,N,0,252000.0,Working,Secondary / secondary special,Married,House / apartment,-10750,-2443,1,0,0,0,High skill tech staff,2.0,-26,0
8789,5009342,M,Y,N,0,252000.0,Working,Secondary / secondary special,Married,House / apartment,-10750,-2443,1,0,0,0,High skill tech staff,2.0,-27,0
8790,5009342,M,Y,N,0,252000.0,Working,Secondary / secondary special,Married,House / apartment,-10750,-2443,1,0,0,0,High skill tech staff,2.0,-28,0
8791,5009342,M,Y,N,0,252000.0,Working,Secondary / secondary special,Married,House / apartment,-10750,-2443,1,0,0,0,High skill tech staff,2.0,-29,0
8792,5009342,M,Y,N,0,252000.0,Working,Secondary / secondary special,Married,House / apartment,-10750,-2443,1,0,0,0,High skill tech staff,2.0,-30,0
8793,5009342,M,Y,N,0,252000.0,Working,Secondary / secondary special,Married,House / apartment,-10750,-2443,1,0,0,0,High skill tech staff,2.0,-31,0
8794,5009342,M,Y,N,0,252000.0,Working,Secondary / secondary special,Married,House / apartment,-10750,-2443,1,0,0,0,High skill tech staff,2.0,-32,0
8795,5009342,M,Y,N,0,252000.0,Working,Secondary / secondary special,Married,House / apartment,-10750,-2443,1,0,0,0,High skill tech staff,2.0,-33,0
8796,5009342,M,Y,N,0,252000.0,Working,Secondary / secondary special,Married,House / apartment,-10750,-2443,1,0,0,0,High skill tech staff,2.0,-34,0
8797,5009343,M,Y,N,0,252000.0,Working,Secondary / secondary special,Married,House / apartment,-10750,-2443,1,0,0,0,High skill tech staff,2.0,0,C
8798,5009343,M,Y,N,0,252000.0,Working,Secondary / secondary special,Married,House / apartment,-10750,-2443,1,0,0,0,High skill tech staff,2.0,-1,C
8799,5009343,M,Y,N,0,252000.0,Working,Secondary / secondary special,Married,House / apartment,-10750,-2443,1,0,0,0,High skill tech staff,2.0,-2,C
8800,5009343,M,Y,N,0,252000.0,Working,Secondary / secondary special,Married,House / apartment,-10750,-2443,1,0,0,0,High skill tech staff,2.0,-3,C
8801,5009343,M,Y,N,0,252000.0,Working,Secondary / secondary special,Married,House / apartment,-10750,-2443,1,0,0,0,High skill tech staff,2.0,-4,C
8802,5009343,M,Y,N,0,252000.0,Working,Secondary / secondary special,Married,House / apartment,-10750,-2443,1,0,0,0,High skill tech staff,2.0,-5,C
8803,5009343,M,Y,N,0,252000.0,Working,Secondary / secondary special,Married,House / apartment,-10750,-2443,1,0,0,0,High skill tech staff,2.0,-6,C
8804,5009343,M,Y,N,0,252000.0,Working,Secondary / secondary special,Married,House / apartment,-10750,-2443,1,0,0,0,High skill tech staff,2.0,-7,C
8805,5009343,M,Y,N,0,252000.0,Working,Secondary / secondary special,Married,House / apartment,-10750,-2443,1,0,0,0,High skill tech staff,2.0,-8,C
8806,5009343,M,Y,N,0,252000.0,Working,Secondary / secondary special,Married,House / apartment,-10750,-2443,1,0,0,0,High skill tech staff,2.0,-9,C
8807,5009343,M,Y,N,0,252000.0,Working,Secondary / secondary special,Married,House / apartment,-10750,-2443,1,0,0,0,High skill tech staff,2.0,-10,C
8808,5009343,M,Y,N,0,252000.0,Working,Secondary / secondary special,Married,House / apartment,-10750,-2443,1,0,0,0,High skill tech staff,2.0,-11,0
8809,5009343,M,Y,N,0,252000.0,Working,Secondary / secondary special,Married,House / apartment,-10750,-2443,1,0,0,0,High skill tech staff,2.0,-12,0
8810,5009343,M,Y,N,0,252000.0,Working,Secondary / secondary special,Married,House / apartment,-10750,-2443,1,0,0,0,High skill tech staff,2.0,-13,0
8811,5009343,M,Y,N,0,252000.0,Working,Secondary / secondary special,Married,House / apartment,-10750,-2443,1,0,0,0,High skill tech staff,2.0,-14,0
8812,5009343,M,Y,N,0,252000.0,Working,Secondary / secondary special,Married,House / apartment,-10750,-2443,1,0,0,0,High skill tech staff,2.0,-15,0
8813,5009343,M,Y,N,0,252000.0,Working,Secondary / secondary special,Married,House / apartment,-10750,-2443,1,0,0,0,High skill tech staff,2.0,-16,0
8814,5009343,M,Y,N,0,252000.0,Working,Secondary / secondary special,Married,House / apartment,-10750,-2443,1,0,0,0,High skill tech staff,2.0,-17,0
8815,5009343,M,Y,N,0,252000.0,Working,Secondary / secondary special,Married,House / apartment,-10750,-2443,1,0,0,0,High skill tech staff,2.0,-18,0
8816,5009343,M,Y,N,0,252000.0,Working,Secondary / secondary special,Married,House / apartment,-10750,-2443,1,0,0,0,High skill tech staff,2.0,-19,0
8817,5009343,M,Y,N,0,252000.0,Working,Secondary / secondary special,Married,House / apartment,-10750,-2443,1,0,0,0,High skill tech staff,2.0,-20,0
8818,5009343,M,Y,N,0,252000.0,Working,Secondary / secondary special,Married,House / apartment,-10750,-2443,1,0,0,0,High skill tech staff,2.0,-21,0
8819,5009343,M,Y,N,0,252000.0,Working,Secondary / secondary special,Married,House / apartment,-10750,-2443,1,0,0,0,High skill tech staff,2.0,-22,0
8820,5009343,M,Y,N,0,252000.0,Working,Secondary / secondary special,Married,House / apartment,-10750,-2443,1,0,0,0,High skill tech staff,2.0,-23,0
8821,5009343,M,Y,N,0,252000.0,Working,Secondary / secondary special,Married,House / apartment,-10750,-2443,1,0,0,0,High skill tech staff,2.0,-24,0
8822,5009343,M,Y,N,0,252000.0,Working,Secondary / secondary special,Married,House / apartment,-10750,-2443,1,0,0,0,High skill tech staff,2.0,-25,0
8823,5009343,M,Y,N,0,252000.0,Working,Secondary / secondary special,Married,House / apartment,-10750,-2443,1,0,0,0,High skill tech staff,2.0,-26,0
8824,5009343,M,Y,N,0,252000.0,Working,Secondary / secondary special,Married,House / apartment,-10750,-2443,1,0,0,0,High skill tech staff,2.0,-27,0
8825,5009343,M,Y,N,0,252000.0,Working,Secondary / secondary special,Married,House / apartment,-10750,-2443,1,0,0,0,High skill tech staff,2.0,-28,0
8826,5009344,M,Y,N,0,252000.0,Working,Secondary / secondary special,Married,House / apartment,-10750,-2443,1,0,0,0,High skill tech staff,2.0,0,0
8827,5009344,M,Y,N,0,252000.0,Working,Secondary / secondary special,Married,House / apartment,-10750,-2443,1,0,0,0,High skill tech staff,2.0,-1,0
8828,5009344,M,Y,N,0,252000.0,Working,Secondary / secondary special,Married,House / apartment,-10750,-2443,1,0,0,0,High skill tech staff,2.0,-2,0
8829,5009344,M,Y,N,0,252000.0,Working,Secondary / secondary special,Married,House / apartment,-10750,-2443,1,0,0,0,High skill tech staff,2.0,-3,0
8830,5009344,M,Y,N,0,252000.0,Working,Secondary / secondary special,Married,House / apartment,-10750,-2443,1,0,0,0,High skill tech staff,2.0,-4,0
8831,5009344,M,Y,N,0,252000.0,Working,Secondary / secondary special,Married,House / apartment,-10750,-2443,1,0,0,0,High skill tech staff,2.0,-5,0
8832,5009344,M,Y,N,0,252000.0,Working,Secondary / secondary special,Married,House / apartment,-10750,-2443,1,0,0,0,High skill tech staff,2.0,-6,0
8833,5009344,M,Y,N,0,252000.0,Working,Secondary / secondary special,Married,House / apartment,-10750,-2443,1,0,0,0,High skill tech staff,2.0,-7,0
8834,5009344,M,Y,N,0,252000.0,Working,Secondary / secondary special,Married,House / apartment,-10750,-2443,1,0,0,0,High skill tech staff,2.0,-8,0
8835,5009344,M,Y,N,0,252000.0,Working,Secondary / secondary special,Married,House / apartment,-10750,-2443,1,0,0,0,High skill tech staff,2.0,-9,0
8836,5009344,M,Y,N,0,252000.0,Working,Secondary / secondary special,Married,House / apartment,-10750,-2443,1,0,0,0,High skill tech staff,2.0,-10,0
8837,5009344,M,Y,N,0,252000.0,Working,Secondary / secondary special,Married,House / apartment,-10750,-2443,1,0,0,0,High skill tech staff,2.0,-11,0
8838,5009344,M,Y,N,0,252000.0,Working,Secondary / secondary special,Married,House / apartment,-10750,-2443,1,0,0,0,High skill tech staff,2.0,-12,0
8839,5009344,M,Y,N,0,252000.0,Working,Secondary / secondary special,Married,House / apartment,-10750,-2443,1,0,0,0,High skill tech staff,2.0,-13,0
8840,5009344,M,Y,N,0,252000.0,Working,Secondary / secondary special,Married,House / apartment,-10750,-2443,1,0,0,0,High skill tech staff,2.0,-14,0
8841,5009344,M,Y,N,0,252000.0,Working,Secondary / secondary special,Married,House / apartment,-10750,-2443,1,0,0,0,High skill tech staff,2.0,-15,0
8842,5009345,M,Y,N,0,252000.0,Working,Secondary / secondary special,Married,House / apartment,-10750,-2443,1,0,0,0,High skill tech staff,2.0,0,C
8843,5009345,M,Y,N,0,252000.0,Working,Secondary / secondary special,Married,House / apartment,-10750,-2443,1,0,0,0,High skill tech staff,2.0,-1,C
8844,5009345,M,Y,N,0,252000.0,Working,Secondary / secondary special,Married,House / apartment,-10750,-2443,1,0,0,0,High skill tech staff,2.0,-2,C
8845,5009345,M,Y,N,0,252000.0,Working,Secondary / secondary special,Married,House / apartment,-10750,-2443,1,0,0,0,High skill tech staff,2.0,-3,C
8846,5009345,M,Y,N,0,252000.0,Working,Secondary / secondary special,Married,House / apartment,-10750,-2443,1,0,0,0,High skill tech staff,2.0,-4,C
8847,5009345,M,Y,N,0,252000.0,Working,Secondary / secondary special,Married,House / apartment,-10750,-2443,1,0,0,0,High skill tech staff,2.0,-5,C
8848,5009345,M,Y,N,0,252000.0,Working,Secondary / secondary special,Married,House / apartment,-10750,-2443,1,0,0,0,High skill tech staff,2.0,-6,0
8849,5009345,M,Y,N,0,252000.0,Working,Secondary / secondary special,Married,House / apartment,-10750,-2443,1,0,0,0,High skill tech staff,2.0,-7,0
8850,5009345,M,Y,N,0,252000.0,Working,Secondary / secondary special,Married,House / apartment,-10750,-2443,1,0,0,0,High skill tech staff,2.0,-8,0
8851,5009345,M,Y,N,0,252000.0,Working,Secondary / secondary special,Married,House / apartment,-10750,-2443,1,0,0,0,High skill tech staff,2.0,-9,0
8852,5009345,M,Y,N,0,252000.0,Working,Secondary / secondary special,Married,House / apartment,-10750,-2443,1,0,0,0,High skill tech staff,2.0,-10,0
8853,5009345,M,Y,N,0,252000.0,Working,Secondary / secondary special,Married,House / apartment,-10750,-2443,1,0,0,0,High skill tech staff,2.0,-11,0
8854,5009345,M,Y,N,0,252000.0,Working,Secondary / secondary special,Married,House / apartment,-10750,-2443,1,0,0,0,High skill tech staff,2.0,-12,0
8855,5009345,M,Y,N,0,252000.0,Working,Secondary / secondary special,Married,House / apartment,-10750,-2443,1,0,0,0,High skill tech staff,2.0,-13,0
8856,5009345,M,Y,N,0,252000.0,Working,Secondary / secondary special,Married,House / apartment,-10750,-2443,1,0,0,0,High skill tech staff,2.0,-14,0
8857,5009345,M,Y,N,0,252000.0,Working,Secondary / secondary special,Married,House / apartment,-10750,-2443,1,0,0,0,High skill tech staff,2.0,-15,0
8858,5009345,M,Y,N,0,252000.0,Working,Secondary / secondary special,Married,House / apartment,-10750,-2443,1,0,0,0,High skill tech staff,2.0,-16,0
8859,5009345,M,Y,N,0,252000.0,Working,Secondary / secondary special,Married,House / apartment,-10750,-2443,1,0,0,0,High skill tech staff,2.0,-17,0
8860,5009345,M,Y,N,0,252000.0,Working,Secondary / secondary special,Married,House / apartment,-10750,-2443,1,0,0,0,High skill tech staff,2.0,-18,0
8861,5009345,M,Y,N,0,252000.0,Working,Secondary / secondary special,Married,House / apartment,-10750,-2443,1,0,0,0,High skill tech staff,2.0,-19,0
8862,5009345,M,Y,N,0,252000.0,Working,Secondary / secondary special,Married,House / apartment,-10750,-2443,1,0,0,0,High skill tech staff,2.0,-20,0
8863,5009345,M,Y,N,0,252000.0,Working,Secondary / secondary special,Married,House / apartment,-10750,-2443,1,0,0,0,High skill tech staff,2.0,-21,0
8864,5009345,M,Y,N,0,252000.0,Working,Secondary / secondary special,Married,House / apartment,-10750,-2443,1,0,0,0,High skill tech staff,2.0,-22,0
8865,5009345,M,Y,N,0,252000.0,Working,Secondary / secondary special,Married,House / apartment,-10750,-2443,1,0,0,0,High skill tech staff,2.0,-23,0
8866,5009346,M,Y,N,0,252000.0,Working,Secondary / secondary special,Married,House / apartment,-10750,-2443,1,0,0,0,High skill tech staff,2.0,0,0
8867,5009346,M,Y,N,0,252000.0,Working,Secondary / secondary special,Married,House / apartment,-10750,-2443,1,0,0,0,High skill tech staff,2.0,-1,0
8868,5009346,M,Y,N,0,252000.0,Working,Secondary / secondary special,Married,House / apartment,-10750,-2443,1,0,0,0,High skill tech staff,2.0,-2,0
8869,5009346,M,Y,N,0,252000.0,Working,Secondary / secondary special,Married,House / apartment,-10750,-2443,1,0,0,0,High skill tech staff,2.0,-3,0
8870,5009346,M,Y,N,0,252000.0,Working,Secondary / secondary special,Married,House / apartment,-10750,-2443,1,0,0,0,High skill tech staff,2.0,-4,0
8871,5009346,M,Y,N,0,252000.0,Working,Secondary / secondary special,Married,House / apartment,-10750,-2443,1,0,0,0,High skill tech staff,2.0,-5,0
8872,5009346,M,Y,N,0,252000.0,Working,Secondary / secondary special,Married,House / apartment,-10750,-2443,1,0,0,0,High skill tech staff,2.0,-6,0
8873,5009346,M,Y,N,0,252000.0,Working,Secondary / secondary special,Married,House / apartment,-10750,-2443,1,0,0,0,High skill tech staff,2.0,-7,0
8874,5009346,M,Y,N,0,252000.0,Working,Secondary / secondary special,Married,House / apartment,-10750,-2443,1,0,0,0,High skill tech staff,2.0,-8,0
8875,5009346,M,Y,N,0,252000.0,Working,Secondary / secondary special,Married,House / apartment,-10750,-2443,1,0,0,0,High skill tech staff,2.0,-9,X
8876,5009349,M,N,N,0,180000.0,Commercial associate,Lower secondary,Married,House / apartment,-21155,-130,1,0,1,0,Drivers,2.0,0,X
8877,5009349,M,N,N,0,180000.0,Commercial associate,Lower secondary,Married,House / apartment,-21155,-130,1,0,1,0,Drivers,2.0,-1,X
8878,5009349,M,N,N,0,180000.0,Commercial associate,Lower secondary,Married,House / apartment,-21155,-130,1,0,1,0,Drivers,2.0,-2,X
8879,5009349,M,N,N,0,180000.0,Commercial associate,Lower secondary,Married,House / apartment,-21155,-130,1,0,1,0,Drivers,2.0,-3,X
8880,5009349,M,N,N,0,180000.0,Commercial associate,Lower secondary,Married,House / apartment,-21155,-130,1,0,1,0,Drivers,2.0,-4,X
8881,5009349,M,N,N,0,180000.0,Commercial associate,Lower secondary,Married,House / apartment,-21155,-130,1,0,1,0,Drivers,2.0,-5,X
8882,5009349,M,N,N,0,180000.0,Commercial associate,Lower secondary,Married,House / apartment,-21155,-130,1,0,1,0,Drivers,2.0,-6,X
8883,5009349,M,N,N,0,180000.0,Commercial associate,Lower secondary,Married,House / apartment,-21155,-130,1,0,1,0,Drivers,2.0,-7,X
8884,5009349,M,N,N,0,180000.0,Commercial associate,Lower secondary,Married,House / apartment,-21155,-130,1,0,1,0,Drivers,2.0,-8,X
8885,5009349,M,N,N,0,180000.0,Commercial associate,Lower secondary,Married,House / apartment,-21155,-130,1,0,1,0,Drivers,2.0,-9,X
8886,5009349,M,N,N,0,180000.0,Commercial associate,Lower secondary,Married,House / apartment,-21155,-130,1,0,1,0,Drivers,2.0,-10,X
8887,5009349,M,N,N,0,180000.0,Commercial associate,Lower secondary,Married,House / apartment,-21155,-130,1,0,1,0,Drivers,2.0,-11,X
8888,5009349,M,N,N,0,180000.0,Commercial associate,Lower secondary,Married,House / apartment,-21155,-130,1,0,1,0,Drivers,2.0,-12,X
8889,5009349,M,N,N,0,180000.0,Commercial associate,Lower secondary,Married,House / apartment,-21155,-130,1,0,1,0,Drivers,2.0,-13,X
8890,5009349,M,N,N,0,180000.0,Commercial associate,Lower secondary,Married,House / apartment,-21155,-130,1,0,1,0,Drivers,2.0,-14,X
8891,5009349,M,N,N,0,180000.0,Commercial associate,Lower secondary,Married,House / apartment,-21155,-130,1,0,1,0,Drivers,2.0,-15,X
8892,5009349,M,N,N,0,180000.0,Commercial associate,Lower secondary,Married,House / apartment,-21155,-130,1,0,1,0,Drivers,2.0,-16,X
8893,5009349,M,N,N,0,180000.0,Commercial associate,Lower secondary,Married,House / apartment,-21155,-130,1,0,1,0,Drivers,2.0,-17,X
8894,5009349,M,N,N,0,180000.0,Commercial associate,Lower secondary,Married,House / apartment,-21155,-130,1,0,1,0,Drivers,2.0,-18,0
8895,5009349,M,N,N,0,180000.0,Commercial associate,Lower secondary,Married,House / apartment,-21155,-130,1,0,1,0,Drivers,2.0,-19,0
8896,5009349,M,N,N,0,180000.0,Commercial associate,Lower secondary,Married,House / apartment,-21155,-130,1,0,1,0,Drivers,2.0,-20,0
8897,5009349,M,N,N,0,180000.0,Commercial associate,Lower secondary,Married,House / apartment,-21155,-130,1,0,1,0,Drivers,2.0,-21,0
8898,5009349,M,N,N,0,180000.0,Commercial associate,Lower secondary,Married,House / apartment,-21155,-130,1,0,1,0,Drivers,2.0,-22,0
8899,5009349,M,N,N,0,180000.0,Commercial associate,Lower secondary,Married,House / apartment,-21155,-130,1,0,1,0,Drivers,2.0,-23,0
8900,5009349,M,N,N,0,180000.0,Commercial associate,Lower secondary,Married,House / apartment,-21155,-130,1,0,1,0,Drivers,2.0,-24,0
8901,5009349,M,N,N,0,180000.0,Commercial associate,Lower secondary,Married,House / apartment,-21155,-130,1,0,1,0,Drivers,2.0,-25,0
8902,5009349,M,N,N,0,180000.0,Commercial associate,Lower secondary,Married,House / apartment,-21155,-130,1,0,1,0,Drivers,2.0,-26,X
8903,5009349,M,N,N,0,180000.0,Commercial associate,Lower secondary,Married,House / apartment,-21155,-130,1,0,1,0,Drivers,2.0,-27,0
8904,5009349,M,N,N,0,180000.0,Commercial associate,Lower secondary,Married,House / apartment,-21155,-130,1,0,1,0,Drivers,2.0,-28,0
8905,5009349,M,N,N,0,180000.0,Commercial associate,Lower secondary,Married,House / apartment,-21155,-130,1,0,1,0,Drivers,2.0,-29,0
8906,5009349,M,N,N,0,180000.0,Commercial associate,Lower secondary,Married,House / apartment,-21155,-130,1,0,1,0,Drivers,2.0,-30,X
8907,5009354,M,N,N,0,180000.0,Commercial associate,Lower secondary,Married,House / apartment,-21155,-130,1,0,1,0,Drivers,2.0,0,X
8908,5009354,M,N,N,0,180000.0,Commercial associate,Lower secondary,Married,House / apartment,-21155,-130,1,0,1,0,Drivers,2.0,-1,X
8909,5009354,M,N,N,0,180000.0,Commercial associate,Lower secondary,Married,House / apartment,-21155,-130,1,0,1,0,Drivers,2.0,-2,X
8910,5009354,M,N,N,0,180000.0,Commercial associate,Lower secondary,Married,House / apartment,-21155,-130,1,0,1,0,Drivers,2.0,-3,1
8911,5009354,M,N,N,0,180000.0,Commercial associate,Lower secondary,Married,House / apartment,-21155,-130,1,0,1,0,Drivers,2.0,-4,0
8912,5009354,M,N,N,0,180000.0,Commercial associate,Lower secondary,Married,House / apartment,-21155,-130,1,0,1,0,Drivers,2.0,-5,X
8913,5009355,F,N,N,0,135000.0,Commercial associate,Secondary / secondary special,Married,House / apartment,-19692,-5273,1,1,1,0,Laborers,2.0,0,0
8914,5009355,F,N,N,0,135000.0,Commercial associate,Secondary / secondary special,Married,House / apartment,-19692,-5273,1,1,1,0,Laborers,2.0,-1,0
8915,5009355,F,N,N,0,135000.0,Commercial associate,Secondary / secondary special,Married,House / apartment,-19692,-5273,1,1,1,0,Laborers,2.0,-2,0
8916,5009355,F,N,N,0,135000.0,Commercial associate,Secondary / secondary special,Married,House / apartment,-19692,-5273,1,1,1,0,Laborers,2.0,-3,0
8917,5009355,F,N,N,0,135000.0,Commercial associate,Secondary / secondary special,Married,House / apartment,-19692,-5273,1,1,1,0,Laborers,2.0,-4,0
8918,5009355,F,N,N,0,135000.0,Commercial associate,Secondary / secondary special,Married,House / apartment,-19692,-5273,1,1,1,0,Laborers,2.0,-5,0
8919,5009355,F,N,N,0,135000.0,Commercial associate,Secondary / secondary special,Married,House / apartment,-19692,-5273,1,1,1,0,Laborers,2.0,-6,0
8920,5009355,F,N,N,0,135000.0,Commercial associate,Secondary / secondary special,Married,House / apartment,-19692,-5273,1,1,1,0,Laborers,2.0,-7,0
8921,5009355,F,N,N,0,135000.0,Commercial associate,Secondary / secondary special,Married,House / apartment,-19692,-5273,1,1,1,0,Laborers,2.0,-8,0
8922,5009355,F,N,N,0,135000.0,Commercial associate,Secondary / secondary special,Married,House / apartment,-19692,-5273,1,1,1,0,Laborers,2.0,-9,0
8923,5009355,F,N,N,0,135000.0,Commercial associate,Secondary / secondary special,Married,House / apartment,-19692,-5273,1,1,1,0,Laborers,2.0,-10,0
8924,5009355,F,N,N,0,135000.0,Commercial associate,Secondary / secondary special,Married,House / apartment,-19692,-5273,1,1,1,0,Laborers,2.0,-11,0
8925,5009355,F,N,N,0,135000.0,Commercial associate,Secondary / secondary special,Married,House / apartment,-19692,-5273,1,1,1,0,Laborers,2.0,-12,0
8926,5009355,F,N,N,0,135000.0,Commercial associate,Secondary / secondary special,Married,House / apartment,-19692,-5273,1,1,1,0,Laborers,2.0,-13,0
8927,5009355,F,N,N,0,135000.0,Commercial associate,Secondary / secondary special,Married,House / apartment,-19692,-5273,1,1,1,0,Laborers,2.0,-14,0
8928,5009355,F,N,N,0,135000.0,Commercial associate,Secondary / secondary special,Married,House / apartment,-19692,-5273,1,1,1,0,Laborers,2.0,-15,0
8929,5009355,F,N,N,0,135000.0,Commercial associate,Secondary / secondary special,Married,House / apartment,-19692,-5273,1,1,1,0,Laborers,2.0,-16,0
8930,5009355,F,N,N,0,135000.0,Commercial associate,Secondary / secondary special,Married,House / apartment,-19692,-5273,1,1,1,0,Laborers,2.0,-17,0
8931,5009355,F,N,N,0,135000.0,Commercial associate,Secondary / secondary special,Married,House / apartment,-19692,-5273,1,1,1,0,Laborers,2.0,-18,0
8932,5009355,F,N,N,0,135000.0,Commercial associate,Secondary / secondary special,Married,House / apartment,-19692,-5273,1,1,1,0,Laborers,2.0,-19,0
8933,5009355,F,N,N,0,135000.0,Commercial associate,Secondary / secondary special,Married,House / apartment,-19692,-5273,1,1,1,0,Laborers,2.0,-20,0
8934,5009355,F,N,N,0,135000.0,Commercial associate,Secondary / secondary special,Married,House / apartment,-19692,-5273,1,1,1,0,Laborers,2.0,-21,0
8935,5009355,F,N,N,0,135000.0,Commercial associate,Secondary / secondary special,Married,House / apartment,-19692,-5273,1,1,1,0,Laborers,2.0,-22,0
8936,5009355,F,N,N,0,135000.0,Commercial associate,Secondary / secondary special,Married,House / apartment,-19692,-5273,1,1,1,0,Laborers,2.0,-23,0
8937,5009355,F,N,N,0,135000.0,Commercial associate,Secondary / secondary special,Married,House / apartment,-19692,-5273,1,1,1,0,Laborers,2.0,-24,0
8938,5009355,F,N,N,0,135000.0,Commercial associate,Secondary / secondary special,Married,House / apartment,-19692,-5273,1,1,1,0,Laborers,2.0,-25,X
8939,5009358,F,N,N,0,135000.0,Commercial associate,Secondary / secondary special,Married,House / apartment,-19692,-5273,1,1,1,0,Laborers,2.0,0,X
8940,5009358,F,N,N,0,135000.0,Commercial associate,Secondary / secondary special,Married,House / apartment,-19692,-5273,1,1,1,0,Laborers,2.0,-1,X
8941,5009358,F,N,N,0,135000.0,Commercial associate,Secondary / secondary special,Married,House / apartment,-19692,-5273,1,1,1,0,Laborers,2.0,-2,X
8942,5009358,F,N,N,0,135000.0,Commercial associate,Secondary / secondary special,Married,House / apartment,-19692,-5273,1,1,1,0,Laborers,2.0,-3,X
8943,5009358,F,N,N,0,135000.0,Commercial associate,Secondary / secondary special,Married,House / apartment,-19692,-5273,1,1,1,0,Laborers,2.0,-4,X
8944,5009358,F,N,N,0,135000.0,Commercial associate,Secondary / secondary special,Married,House / apartment,-19692,-5273,1,1,1,0,Laborers,2.0,-5,X
8945,5009358,F,N,N,0,135000.0,Commercial associate,Secondary / secondary special,Married,House / apartment,-19692,-5273,1,1,1,0,Laborers,2.0,-6,X
8946,5009358,F,N,N,0,135000.0,Commercial associate,Secondary / secondary special,Married,House / apartment,-19692,-5273,1,1,1,0,Laborers,2.0,-7,X
8947,5009358,F,N,N,0,135000.0,Commercial associate,Secondary / secondary special,Married,House / apartment,-19692,-5273,1,1,1,0,Laborers,2.0,-8,X
8948,5009358,F,N,N,0,135000.0,Commercial associate,Secondary / secondary special,Married,House / apartment,-19692,-5273,1,1,1,0,Laborers,2.0,-9,X
8949,5009358,F,N,N,0,135000.0,Commercial associate,Secondary / secondary special,Married,House / apartment,-19692,-5273,1,1,1,0,Laborers,2.0,-10,X
8950,5009358,F,N,N,0,135000.0,Commercial associate,Secondary / secondary special,Married,House / apartment,-19692,-5273,1,1,1,0,Laborers,2.0,-11,X
8951,5009358,F,N,N,0,135000.0,Commercial associate,Secondary / secondary special,Married,House / apartment,-19692,-5273,1,1,1,0,Laborers,2.0,-12,X
8952,5009358,F,N,N,0,135000.0,Commercial associate,Secondary / secondary special,Married,House / apartment,-19692,-5273,1,1,1,0,Laborers,2.0,-13,X
8953,5009358,F,N,N,0,135000.0,Commercial associate,Secondary / secondary special,Married,House / apartment,-19692,-5273,1,1,1,0,Laborers,2.0,-14,X
8954,5009358,F,N,N,0,135000.0,Commercial associate,Secondary / secondary special,Married,House / apartment,-19692,-5273,1,1,1,0,Laborers,2.0,-15,X
8955,5009358,F,N,N,0,135000.0,Commercial associate,Secondary / secondary special,Married,House / apartment,-19692,-5273,1,1,1,0,Laborers,2.0,-16,X
8956,5009358,F,N,N,0,135000.0,Commercial associate,Secondary / secondary special,Married,House / apartment,-19692,-5273,1,1,1,0,Laborers,2.0,-17,X
8957,5009358,F,N,N,0,135000.0,Commercial associate,Secondary / secondary special,Married,House / apartment,-19692,-5273,1,1,1,0,Laborers,2.0,-18,X
8958,5009358,F,N,N,0,135000.0,Commercial associate,Secondary / secondary special,Married,House / apartment,-19692,-5273,1,1,1,0,Laborers,2.0,-19,X
8959,5009358,F,N,N,0,135000.0,Commercial associate,Secondary / secondary special,Married,House / apartment,-19692,-5273,1,1,1,0,Laborers,2.0,-20,X
8960,5009358,F,N,N,0,135000.0,Commercial associate,Secondary / secondary special,Married,House / apartment,-19692,-5273,1,1,1,0,Laborers,2.0,-21,X
8961,5009358,F,N,N,0,135000.0,Commercial associate,Secondary / secondary special,Married,House / apartment,-19692,-5273,1,1,1,0,Laborers,2.0,-22,X
8962,5009358,F,N,N,0,135000.0,Commercial associate,Secondary / secondary special,Married,House / apartment,-19692,-5273,1,1,1,0,Laborers,2.0,-23,X
8963,5009358,F,N,N,0,135000.0,Commercial associate,Secondary / secondary special,Married,House / apartment,-19692,-5273,1,1,1,0,Laborers,2.0,-24,X
8964,5009358,F,N,N,0,135000.0,Commercial associate,Secondary / secondary special,Married,House / apartment,-19692,-5273,1,1,1,0,Laborers,2.0,-25,X
8965,5009359,F,Y,N,0,900000.0,Working,Higher education,Single / not married,House / apartment,-19063,-7404,1,0,0,0,Managers,1.0,0,C
8966,5009359,F,Y,N,0,900000.0,Working,Higher education,Single / not married,House / apartment,-19063,-7404,1,0,0,0,Managers,1.0,-1,C
8967,5009359,F,Y,N,0,900000.0,Working,Higher education,Single / not married,House / apartment,-19063,-7404,1,0,0,0,Managers,1.0,-2,C
8968,5009359,F,Y,N,0,900000.0,Working,Higher education,Single / not married,House / apartment,-19063,-7404,1,0,0,0,Managers,1.0,-3,C
8969,5009359,F,Y,N,0,900000.0,Working,Higher education,Single / not married,House / apartment,-19063,-7404,1,0,0,0,Managers,1.0,-4,C
8970,5009359,F,Y,N,0,900000.0,Working,Higher education,Single / not married,House / apartment,-19063,-7404,1,0,0,0,Managers,1.0,-5,C
8971,5009359,F,Y,N,0,900000.0,Working,Higher education,Single / not married,House / apartment,-19063,-7404,1,0,0,0,Managers,1.0,-6,C
8972,5009359,F,Y,N,0,900000.0,Working,Higher education,Single / not married,House / apartment,-19063,-7404,1,0,0,0,Managers,1.0,-7,1
8973,5009359,F,Y,N,0,900000.0,Working,Higher education,Single / not married,House / apartment,-19063,-7404,1,0,0,0,Managers,1.0,-8,1
8974,5009359,F,Y,N,0,900000.0,Working,Higher education,Single / not married,House / apartment,-19063,-7404,1,0,0,0,Managers,1.0,-9,1
8975,5009359,F,Y,N,0,900000.0,Working,Higher education,Single / not married,House / apartment,-19063,-7404,1,0,0,0,Managers,1.0,-10,1
8976,5009359,F,Y,N,0,900000.0,Working,Higher education,Single / not married,House / apartment,-19063,-7404,1,0,0,0,Managers,1.0,-11,1
8977,5009359,F,Y,N,0,900000.0,Working,Higher education,Single / not married,House / apartment,-19063,-7404,1,0,0,0,Managers,1.0,-12,1
8978,5009359,F,Y,N,0,900000.0,Working,Higher education,Single / not married,House / apartment,-19063,-7404,1,0,0,0,Managers,1.0,-13,0
8979,5009359,F,Y,N,0,900000.0,Working,Higher education,Single / not married,House / apartment,-19063,-7404,1,0,0,0,Managers,1.0,-14,0
8980,5009359,F,Y,N,0,900000.0,Working,Higher education,Single / not married,House / apartment,-19063,-7404,1,0,0,0,Managers,1.0,-15,0
8981,5009360,F,Y,N,0,900000.0,Working,Higher education,Single / not married,House / apartment,-19063,-7404,1,0,0,0,Managers,1.0,0,0
8982,5009360,F,Y,N,0,900000.0,Working,Higher education,Single / not married,House / apartment,-19063,-7404,1,0,0,0,Managers,1.0,-1,1
8983,5009360,F,Y,N,0,900000.0,Working,Higher education,Single / not married,House / apartment,-19063,-7404,1,0,0,0,Managers,1.0,-2,0
8984,5009360,F,Y,N,0,900000.0,Working,Higher education,Single / not married,House / apartment,-19063,-7404,1,0,0,0,Managers,1.0,-3,0
8985,5009360,F,Y,N,0,900000.0,Working,Higher education,Single / not married,House / apartment,-19063,-7404,1,0,0,0,Managers,1.0,-4,1
8986,5009360,F,Y,N,0,900000.0,Working,Higher education,Single / not married,House / apartment,-19063,-7404,1,0,0,0,Managers,1.0,-5,0
8987,5009360,F,Y,N,0,900000.0,Working,Higher education,Single / not married,House / apartment,-19063,-7404,1,0,0,0,Managers,1.0,-6,0
8988,5009360,F,Y,N,0,900000.0,Working,Higher education,Single / not married,House / apartment,-19063,-7404,1,0,0,0,Managers,1.0,-7,X
8989,5009360,F,Y,N,0,900000.0,Working,Higher education,Single / not married,House / apartment,-19063,-7404,1,0,0,0,Managers,1.0,-8,X
8990,5009361,M,Y,N,0,180000.0,Commercial associate,Higher education,Civil marriage,House / apartment,-14867,-586,1,1,0,0,Drivers,2.0,-27,C
8991,5009361,M,Y,N,0,180000.0,Commercial associate,Higher education,Civil marriage,House / apartment,-14867,-586,1,1,0,0,Drivers,2.0,-28,C
8992,5009361,M,Y,N,0,180000.0,Commercial associate,Higher education,Civil marriage,House / apartment,-14867,-586,1,1,0,0,Drivers,2.0,-29,C
8993,5009361,M,Y,N,0,180000.0,Commercial associate,Higher education,Civil marriage,House / apartment,-14867,-586,1,1,0,0,Drivers,2.0,-30,C
8994,5009361,M,Y,N,0,180000.0,Commercial associate,Higher education,Civil marriage,House / apartment,-14867,-586,1,1,0,0,Drivers,2.0,-31,C
8995,5009361,M,Y,N,0,180000.0,Commercial associate,Higher education,Civil marriage,House / apartment,-14867,-586,1,1,0,0,Drivers,2.0,-32,C
8996,5009361,M,Y,N,0,180000.0,Commercial associate,Higher education,Civil marriage,House / apartment,-14867,-586,1,1,0,0,Drivers,2.0,-33,C
8997,5009361,M,Y,N,0,180000.0,Commercial associate,Higher education,Civil marriage,House / apartment,-14867,-586,1,1,0,0,Drivers,2.0,-34,C
8998,5009361,M,Y,N,0,180000.0,Commercial associate,Higher education,Civil marriage,House / apartment,-14867,-586,1,1,0,0,Drivers,2.0,-35,C
8999,5009361,M,Y,N,0,180000.0,Commercial associate,Higher education,Civil marriage,House / apartment,-14867,-586,1,1,0,0,Drivers,2.0,-36,C
9000,5009361,M,Y,N,0,180000.0,Commercial associate,Higher education,Civil marriage,House / apartment,-14867,-586,1,1,0,0,Drivers,2.0,-37,C
9001,5009361,M,Y,N,0,180000.0,Commercial associate,Higher education,Civil marriage,House / apartment,-14867,-586,1,1,0,0,Drivers,2.0,-38,C
9002,5009361,M,Y,N,0,180000.0,Commercial associate,Higher education,Civil marriage,House / apartment,-14867,-586,1,1,0,0,Drivers,2.0,-39,C
9003,5009361,M,Y,N,0,180000.0,Commercial associate,Higher education,Civil marriage,House / apartment,-14867,-586,1,1,0,0,Drivers,2.0,-40,C
9004,5009361,M,Y,N,0,180000.0,Commercial associate,Higher education,Civil marriage,House / apartment,-14867,-586,1,1,0,0,Drivers,2.0,-41,C
9005,5009361,M,Y,N,0,180000.0,Commercial associate,Higher education,Civil marriage,House / apartment,-14867,-586,1,1,0,0,Drivers,2.0,-42,C
9006,5009361,M,Y,N,0,180000.0,Commercial associate,Higher education,Civil marriage,House / apartment,-14867,-586,1,1,0,0,Drivers,2.0,-43,C
9007,5009361,M,Y,N,0,180000.0,Commercial associate,Higher education,Civil marriage,House / apartment,-14867,-586,1,1,0,0,Drivers,2.0,-44,0
9008,5009361,M,Y,N,0,180000.0,Commercial associate,Higher education,Civil marriage,House / apartment,-14867,-586,1,1,0,0,Drivers,2.0,-45,0
9009,5009361,M,Y,N,0,180000.0,Commercial associate,Higher education,Civil marriage,House / apartment,-14867,-586,1,1,0,0,Drivers,2.0,-46,0
9010,5009361,M,Y,N,0,180000.0,Commercial associate,Higher education,Civil marriage,House / apartment,-14867,-586,1,1,0,0,Drivers,2.0,-47,0
9011,5009362,M,Y,N,0,180000.0,Commercial associate,Higher education,Civil marriage,House / apartment,-14867,-586,1,1,0,0,Drivers,2.0,0,0
9012,5009362,M,Y,N,0,180000.0,Commercial associate,Higher education,Civil marriage,House / apartment,-14867,-586,1,1,0,0,Drivers,2.0,-1,0
9013,5009362,M,Y,N,0,180000.0,Commercial associate,Higher education,Civil marriage,House / apartment,-14867,-586,1,1,0,0,Drivers,2.0,-2,0
9014,5009362,M,Y,N,0,180000.0,Commercial associate,Higher education,Civil marriage,House / apartment,-14867,-586,1,1,0,0,Drivers,2.0,-3,0
9015,5009362,M,Y,N,0,180000.0,Commercial associate,Higher education,Civil marriage,House / apartment,-14867,-586,1,1,0,0,Drivers,2.0,-4,0
9016,5009362,M,Y,N,0,180000.0,Commercial associate,Higher education,Civil marriage,House / apartment,-14867,-586,1,1,0,0,Drivers,2.0,-5,0
9017,5009362,M,Y,N,0,180000.0,Commercial associate,Higher education,Civil marriage,House / apartment,-14867,-586,1,1,0,0,Drivers,2.0,-6,0
9018,5009362,M,Y,N,0,180000.0,Commercial associate,Higher education,Civil marriage,House / apartment,-14867,-586,1,1,0,0,Drivers,2.0,-7,0
9019,5009362,M,Y,N,0,180000.0,Commercial associate,Higher education,Civil marriage,House / apartment,-14867,-586,1,1,0,0,Drivers,2.0,-8,0
9020,5009362,M,Y,N,0,180000.0,Commercial associate,Higher education,Civil marriage,House / apartment,-14867,-586,1,1,0,0,Drivers,2.0,-9,0
9021,5009362,M,Y,N,0,180000.0,Commercial associate,Higher education,Civil marriage,House / apartment,-14867,-586,1,1,0,0,Drivers,2.0,-10,0
9022,5009362,M,Y,N,0,180000.0,Commercial associate,Higher education,Civil marriage,House / apartment,-14867,-586,1,1,0,0,Drivers,2.0,-11,0
9023,5009362,M,Y,N,0,180000.0,Commercial associate,Higher education,Civil marriage,House / apartment,-14867,-586,1,1,0,0,Drivers,2.0,-12,0
9024,5009362,M,Y,N,0,180000.0,Commercial associate,Higher education,Civil marriage,House / apartment,-14867,-586,1,1,0,0,Drivers,2.0,-13,0
9025,5009362,M,Y,N,0,180000.0,Commercial associate,Higher education,Civil marriage,House / apartment,-14867,-586,1,1,0,0,Drivers,2.0,-14,0
9026,5009362,M,Y,N,0,180000.0,Commercial associate,Higher education,Civil marriage,House / apartment,-14867,-586,1,1,0,0,Drivers,2.0,-15,0
9027,5009362,M,Y,N,0,180000.0,Commercial associate,Higher education,Civil marriage,House / apartment,-14867,-586,1,1,0,0,Drivers,2.0,-16,0
9028,5009363,M,Y,N,0,180000.0,Commercial associate,Higher education,Civil marriage,House / apartment,-14867,-586,1,1,0,0,Drivers,2.0,0,C
9029,5009363,M,Y,N,0,180000.0,Commercial associate,Higher education,Civil marriage,House / apartment,-14867,-586,1,1,0,0,Drivers,2.0,-1,C
9030,5009363,M,Y,N,0,180000.0,Commercial associate,Higher education,Civil marriage,House / apartment,-14867,-586,1,1,0,0,Drivers,2.0,-2,C
9031,5009363,M,Y,N,0,180000.0,Commercial associate,Higher education,Civil marriage,House / apartment,-14867,-586,1,1,0,0,Drivers,2.0,-3,C
9032,5009363,M,Y,N,0,180000.0,Commercial associate,Higher education,Civil marriage,House / apartment,-14867,-586,1,1,0,0,Drivers,2.0,-4,C
9033,5009363,M,Y,N,0,180000.0,Commercial associate,Higher education,Civil marriage,House / apartment,-14867,-586,1,1,0,0,Drivers,2.0,-5,C
9034,5009363,M,Y,N,0,180000.0,Commercial associate,Higher education,Civil marriage,House / apartment,-14867,-586,1,1,0,0,Drivers,2.0,-6,C
9035,5009363,M,Y,N,0,180000.0,Commercial associate,Higher education,Civil marriage,House / apartment,-14867,-586,1,1,0,0,Drivers,2.0,-7,0
9036,5009363,M,Y,N,0,180000.0,Commercial associate,Higher education,Civil marriage,House / apartment,-14867,-586,1,1,0,0,Drivers,2.0,-8,0
9037,5009363,M,Y,N,0,180000.0,Commercial associate,Higher education,Civil marriage,House / apartment,-14867,-586,1,1,0,0,Drivers,2.0,-9,0
9038,5009363,M,Y,N,0,180000.0,Commercial associate,Higher education,Civil marriage,House / apartment,-14867,-586,1,1,0,0,Drivers,2.0,-10,0
9039,5009363,M,Y,N,0,180000.0,Commercial associate,Higher education,Civil marriage,House / apartment,-14867,-586,1,1,0,0,Drivers,2.0,-11,0
9040,5009363,M,Y,N,0,180000.0,Commercial associate,Higher education,Civil marriage,House / apartment,-14867,-586,1,1,0,0,Drivers,2.0,-12,0
9041,5009363,M,Y,N,0,180000.0,Commercial associate,Higher education,Civil marriage,House / apartment,-14867,-586,1,1,0,0,Drivers,2.0,-13,0
9042,5009363,M,Y,N,0,180000.0,Commercial associate,Higher education,Civil marriage,House / apartment,-14867,-586,1,1,0,0,Drivers,2.0,-14,0
9043,5009363,M,Y,N,0,180000.0,Commercial associate,Higher education,Civil marriage,House / apartment,-14867,-586,1,1,0,0,Drivers,2.0,-15,0
9044,5009363,M,Y,N,0,180000.0,Commercial associate,Higher education,Civil marriage,House / apartment,-14867,-586,1,1,0,0,Drivers,2.0,-16,X
9045,5009364,M,Y,N,0,180000.0,Commercial associate,Higher education,Civil marriage,House / apartment,-14867,-586,1,1,0,0,Drivers,2.0,0,0
9046,5009364,M,Y,N,0,180000.0,Commercial associate,Higher education,Civil marriage,House / apartment,-14867,-586,1,1,0,0,Drivers,2.0,-1,0
9047,5009364,M,Y,N,0,180000.0,Commercial associate,Higher education,Civil marriage,House / apartment,-14867,-586,1,1,0,0,Drivers,2.0,-2,0
9048,5009364,M,Y,N,0,180000.0,Commercial associate,Higher education,Civil marriage,House / apartment,-14867,-586,1,1,0,0,Drivers,2.0,-3,0
9049,5009364,M,Y,N,0,180000.0,Commercial associate,Higher education,Civil marriage,House / apartment,-14867,-586,1,1,0,0,Drivers,2.0,-4,0
9050,5009365,M,Y,N,0,180000.0,Commercial associate,Higher education,Civil marriage,House / apartment,-14867,-586,1,1,0,0,Drivers,2.0,0,C
9051,5009365,M,Y,N,0,180000.0,Commercial associate,Higher education,Civil marriage,House / apartment,-14867,-586,1,1,0,0,Drivers,2.0,-1,C
9052,5009365,M,Y,N,0,180000.0,Commercial associate,Higher education,Civil marriage,House / apartment,-14867,-586,1,1,0,0,Drivers,2.0,-2,C
9053,5009365,M,Y,N,0,180000.0,Commercial associate,Higher education,Civil marriage,House / apartment,-14867,-586,1,1,0,0,Drivers,2.0,-3,C
9054,5009365,M,Y,N,0,180000.0,Commercial associate,Higher education,Civil marriage,House / apartment,-14867,-586,1,1,0,0,Drivers,2.0,-4,C
9055,5009365,M,Y,N,0,180000.0,Commercial associate,Higher education,Civil marriage,House / apartment,-14867,-586,1,1,0,0,Drivers,2.0,-5,0
9056,5009365,M,Y,N,0,180000.0,Commercial associate,Higher education,Civil marriage,House / apartment,-14867,-586,1,1,0,0,Drivers,2.0,-6,0
9057,5009365,M,Y,N,0,180000.0,Commercial associate,Higher education,Civil marriage,House / apartment,-14867,-586,1,1,0,0,Drivers,2.0,-7,0
9058,5009365,M,Y,N,0,180000.0,Commercial associate,Higher education,Civil marriage,House / apartment,-14867,-586,1,1,0,0,Drivers,2.0,-8,0
9059,5009365,M,Y,N,0,180000.0,Commercial associate,Higher education,Civil marriage,House / apartment,-14867,-586,1,1,0,0,Drivers,2.0,-9,0
9060,5009365,M,Y,N,0,180000.0,Commercial associate,Higher education,Civil marriage,House / apartment,-14867,-586,1,1,0,0,Drivers,2.0,-10,0
9061,5009365,M,Y,N,0,180000.0,Commercial associate,Higher education,Civil marriage,House / apartment,-14867,-586,1,1,0,0,Drivers,2.0,-11,0
9062,5009365,M,Y,N,0,180000.0,Commercial associate,Higher education,Civil marriage,House / apartment,-14867,-586,1,1,0,0,Drivers,2.0,-12,0
9063,5009365,M,Y,N,0,180000.0,Commercial associate,Higher education,Civil marriage,House / apartment,-14867,-586,1,1,0,0,Drivers,2.0,-13,0
9064,5009365,M,Y,N,0,180000.0,Commercial associate,Higher education,Civil marriage,House / apartment,-14867,-586,1,1,0,0,Drivers,2.0,-14,0
9065,5009365,M,Y,N,0,180000.0,Commercial associate,Higher education,Civil marriage,House / apartment,-14867,-586,1,1,0,0,Drivers,2.0,-15,0
9066,5009365,M,Y,N,0,180000.0,Commercial associate,Higher education,Civil marriage,House / apartment,-14867,-586,1,1,0,0,Drivers,2.0,-16,0
9067,5009365,M,Y,N,0,180000.0,Commercial associate,Higher education,Civil marriage,House / apartment,-14867,-586,1,1,0,0,Drivers,2.0,-17,0
9068,5009365,M,Y,N,0,180000.0,Commercial associate,Higher education,Civil marriage,House / apartment,-14867,-586,1,1,0,0,Drivers,2.0,-18,0
9069,5009365,M,Y,N,0,180000.0,Commercial associate,Higher education,Civil marriage,House / apartment,-14867,-586,1,1,0,0,Drivers,2.0,-19,X
9070,5009366,M,Y,N,0,180000.0,Commercial associate,Higher education,Civil marriage,House / apartment,-14867,-586,1,1,0,0,Drivers,2.0,0,C
9071,5009366,M,Y,N,0,180000.0,Commercial associate,Higher education,Civil marriage,House / apartment,-14867,-586,1,1,0,0,Drivers,2.0,-1,C
9072,5009366,M,Y,N,0,180000.0,Commercial associate,Higher education,Civil marriage,House / apartment,-14867,-586,1,1,0,0,Drivers,2.0,-2,C
9073,5009366,M,Y,N,0,180000.0,Commercial associate,Higher education,Civil marriage,House / apartment,-14867,-586,1,1,0,0,Drivers,2.0,-3,C
9074,5009366,M,Y,N,0,180000.0,Commercial associate,Higher education,Civil marriage,House / apartment,-14867,-586,1,1,0,0,Drivers,2.0,-4,C
9075,5009366,M,Y,N,0,180000.0,Commercial associate,Higher education,Civil marriage,House / apartment,-14867,-586,1,1,0,0,Drivers,2.0,-5,C
9076,5009366,M,Y,N,0,180000.0,Commercial associate,Higher education,Civil marriage,House / apartment,-14867,-586,1,1,0,0,Drivers,2.0,-6,C
9077,5009366,M,Y,N,0,180000.0,Commercial associate,Higher education,Civil marriage,House / apartment,-14867,-586,1,1,0,0,Drivers,2.0,-7,C
9078,5009366,M,Y,N,0,180000.0,Commercial associate,Higher education,Civil marriage,House / apartment,-14867,-586,1,1,0,0,Drivers,2.0,-8,C
9079,5009366,M,Y,N,0,180000.0,Commercial associate,Higher education,Civil marriage,House / apartment,-14867,-586,1,1,0,0,Drivers,2.0,-9,C
9080,5009366,M,Y,N,0,180000.0,Commercial associate,Higher education,Civil marriage,House / apartment,-14867,-586,1,1,0,0,Drivers,2.0,-10,C
9081,5009366,M,Y,N,0,180000.0,Commercial associate,Higher education,Civil marriage,House / apartment,-14867,-586,1,1,0,0,Drivers,2.0,-11,C
9082,5009366,M,Y,N,0,180000.0,Commercial associate,Higher education,Civil marriage,House / apartment,-14867,-586,1,1,0,0,Drivers,2.0,-12,C
9083,5009366,M,Y,N,0,180000.0,Commercial associate,Higher education,Civil marriage,House / apartment,-14867,-586,1,1,0,0,Drivers,2.0,-13,C
9084,5009366,M,Y,N,0,180000.0,Commercial associate,Higher education,Civil marriage,House / apartment,-14867,-586,1,1,0,0,Drivers,2.0,-14,C
9085,5009366,M,Y,N,0,180000.0,Commercial associate,Higher education,Civil marriage,House / apartment,-14867,-586,1,1,0,0,Drivers,2.0,-15,C
9086,5009366,M,Y,N,0,180000.0,Commercial associate,Higher education,Civil marriage,House / apartment,-14867,-586,1,1,0,0,Drivers,2.0,-16,C
9087,5009366,M,Y,N,0,180000.0,Commercial associate,Higher education,Civil marriage,House / apartment,-14867,-586,1,1,0,0,Drivers,2.0,-17,C
9088,5009366,M,Y,N,0,180000.0,Commercial associate,Higher education,Civil marriage,House / apartment,-14867,-586,1,1,0,0,Drivers,2.0,-18,C
9089,5009366,M,Y,N,0,180000.0,Commercial associate,Higher education,Civil marriage,House / apartment,-14867,-586,1,1,0,0,Drivers,2.0,-19,C
9090,5009366,M,Y,N,0,180000.0,Commercial associate,Higher education,Civil marriage,House / apartment,-14867,-586,1,1,0,0,Drivers,2.0,-20,C
9091,5009366,M,Y,N,0,180000.0,Commercial associate,Higher education,Civil marriage,House / apartment,-14867,-586,1,1,0,0,Drivers,2.0,-21,C
9092,5009366,M,Y,N,0,180000.0,Commercial associate,Higher education,Civil marriage,House / apartment,-14867,-586,1,1,0,0,Drivers,2.0,-22,C
9093,5009366,M,Y,N,0,180000.0,Commercial associate,Higher education,Civil marriage,House / apartment,-14867,-586,1,1,0,0,Drivers,2.0,-23,C
9094,5009366,M,Y,N,0,180000.0,Commercial associate,Higher education,Civil marriage,House / apartment,-14867,-586,1,1,0,0,Drivers,2.0,-24,C
9095,5009366,M,Y,N,0,180000.0,Commercial associate,Higher education,Civil marriage,House / apartment,-14867,-586,1,1,0,0,Drivers,2.0,-25,C
9096,5009366,M,Y,N,0,180000.0,Commercial associate,Higher education,Civil marriage,House / apartment,-14867,-586,1,1,0,0,Drivers,2.0,-26,C
9097,5009366,M,Y,N,0,180000.0,Commercial associate,Higher education,Civil marriage,House / apartment,-14867,-586,1,1,0,0,Drivers,2.0,-27,C
9098,5009366,M,Y,N,0,180000.0,Commercial associate,Higher education,Civil marriage,House / apartment,-14867,-586,1,1,0,0,Drivers,2.0,-28,C
9099,5009366,M,Y,N,0,180000.0,Commercial associate,Higher education,Civil marriage,House / apartment,-14867,-586,1,1,0,0,Drivers,2.0,-29,C
9100,5009366,M,Y,N,0,180000.0,Commercial associate,Higher education,Civil marriage,House / apartment,-14867,-586,1,1,0,0,Drivers,2.0,-30,C
9101,5009366,M,Y,N,0,180000.0,Commercial associate,Higher education,Civil marriage,House / apartment,-14867,-586,1,1,0,0,Drivers,2.0,-31,C
9102,5009366,M,Y,N,0,180000.0,Commercial associate,Higher education,Civil marriage,House / apartment,-14867,-586,1,1,0,0,Drivers,2.0,-32,C
9103,5009366,M,Y,N,0,180000.0,Commercial associate,Higher education,Civil marriage,House / apartment,-14867,-586,1,1,0,0,Drivers,2.0,-33,C
9104,5009366,M,Y,N,0,180000.0,Commercial associate,Higher education,Civil marriage,House / apartment,-14867,-586,1,1,0,0,Drivers,2.0,-34,C
9105,5009366,M,Y,N,0,180000.0,Commercial associate,Higher education,Civil marriage,House / apartment,-14867,-586,1,1,0,0,Drivers,2.0,-35,C
9106,5009366,M,Y,N,0,180000.0,Commercial associate,Higher education,Civil marriage,House / apartment,-14867,-586,1,1,0,0,Drivers,2.0,-36,C
9107,5009366,M,Y,N,0,180000.0,Commercial associate,Higher education,Civil marriage,House / apartment,-14867,-586,1,1,0,0,Drivers,2.0,-37,C
9108,5009366,M,Y,N,0,180000.0,Commercial associate,Higher education,Civil marriage,House / apartment,-14867,-586,1,1,0,0,Drivers,2.0,-38,C
9109,5009366,M,Y,N,0,180000.0,Commercial associate,Higher education,Civil marriage,House / apartment,-14867,-586,1,1,0,0,Drivers,2.0,-39,C
9110,5009366,M,Y,N,0,180000.0,Commercial associate,Higher education,Civil marriage,House / apartment,-14867,-586,1,1,0,0,Drivers,2.0,-40,C
9111,5009366,M,Y,N,0,180000.0,Commercial associate,Higher education,Civil marriage,House / apartment,-14867,-586,1,1,0,0,Drivers,2.0,-41,C
9112,5009366,M,Y,N,0,180000.0,Commercial associate,Higher education,Civil marriage,House / apartment,-14867,-586,1,1,0,0,Drivers,2.0,-42,C
9113,5009366,M,Y,N,0,180000.0,Commercial associate,Higher education,Civil marriage,House / apartment,-14867,-586,1,1,0,0,Drivers,2.0,-43,C
9114,5009366,M,Y,N,0,180000.0,Commercial associate,Higher education,Civil marriage,House / apartment,-14867,-586,1,1,0,0,Drivers,2.0,-44,C
9115,5009366,M,Y,N,0,180000.0,Commercial associate,Higher education,Civil marriage,House / apartment,-14867,-586,1,1,0,0,Drivers,2.0,-45,C
9116,5009366,M,Y,N,0,180000.0,Commercial associate,Higher education,Civil marriage,House / apartment,-14867,-586,1,1,0,0,Drivers,2.0,-46,C
9117,5009366,M,Y,N,0,180000.0,Commercial associate,Higher education,Civil marriage,House / apartment,-14867,-586,1,1,0,0,Drivers,2.0,-47,C
9118,5009366,M,Y,N,0,180000.0,Commercial associate,Higher education,Civil marriage,House / apartment,-14867,-586,1,1,0,0,Drivers,2.0,-48,C
9119,5009366,M,Y,N,0,180000.0,Commercial associate,Higher education,Civil marriage,House / apartment,-14867,-586,1,1,0,0,Drivers,2.0,-49,0
9120,5009366,M,Y,N,0,180000.0,Commercial associate,Higher education,Civil marriage,House / apartment,-14867,-586,1,1,0,0,Drivers,2.0,-50,0
9121,5009366,M,Y,N,0,180000.0,Commercial associate,Higher education,Civil marriage,House / apartment,-14867,-586,1,1,0,0,Drivers,2.0,-51,0
9122,5009366,M,Y,N,0,180000.0,Commercial associate,Higher education,Civil marriage,House / apartment,-14867,-586,1,1,0,0,Drivers,2.0,-52,0
9123,5009366,M,Y,N,0,180000.0,Commercial associate,Higher education,Civil marriage,House / apartment,-14867,-586,1,1,0,0,Drivers,2.0,-53,1
9124,5009366,M,Y,N,0,180000.0,Commercial associate,Higher education,Civil marriage,House / apartment,-14867,-586,1,1,0,0,Drivers,2.0,-54,0
9125,5009366,M,Y,N,0,180000.0,Commercial associate,Higher education,Civil marriage,House / apartment,-14867,-586,1,1,0,0,Drivers,2.0,-55,0
9126,5009366,M,Y,N,0,180000.0,Commercial associate,Higher education,Civil marriage,House / apartment,-14867,-586,1,1,0,0,Drivers,2.0,-56,0
9127,5009366,M,Y,N,0,180000.0,Commercial associate,Higher education,Civil marriage,House / apartment,-14867,-586,1,1,0,0,Drivers,2.0,-57,0
9128,5009366,M,Y,N,0,180000.0,Commercial associate,Higher education,Civil marriage,House / apartment,-14867,-586,1,1,0,0,Drivers,2.0,-58,0
9129,5009367,M,Y,N,0,180000.0,Commercial associate,Higher education,Civil marriage,House / apartment,-14867,-586,1,1,0,0,Drivers,2.0,0,C
9130,5009367,M,Y,N,0,180000.0,Commercial associate,Higher education,Civil marriage,House / apartment,-14867,-586,1,1,0,0,Drivers,2.0,-1,0
9131,5009367,M,Y,N,0,180000.0,Commercial associate,Higher education,Civil marriage,House / apartment,-14867,-586,1,1,0,0,Drivers,2.0,-2,0
9132,5009367,M,Y,N,0,180000.0,Commercial associate,Higher education,Civil marriage,House / apartment,-14867,-586,1,1,0,0,Drivers,2.0,-3,0
9133,5009367,M,Y,N,0,180000.0,Commercial associate,Higher education,Civil marriage,House / apartment,-14867,-586,1,1,0,0,Drivers,2.0,-4,0
9134,5009367,M,Y,N,0,180000.0,Commercial associate,Higher education,Civil marriage,House / apartment,-14867,-586,1,1,0,0,Drivers,2.0,-5,0
9135,5009367,M,Y,N,0,180000.0,Commercial associate,Higher education,Civil marriage,House / apartment,-14867,-586,1,1,0,0,Drivers,2.0,-6,0
9136,5009367,M,Y,N,0,180000.0,Commercial associate,Higher education,Civil marriage,House / apartment,-14867,-586,1,1,0,0,Drivers,2.0,-7,0
9137,5009367,M,Y,N,0,180000.0,Commercial associate,Higher education,Civil marriage,House / apartment,-14867,-586,1,1,0,0,Drivers,2.0,-8,0
9138,5009367,M,Y,N,0,180000.0,Commercial associate,Higher education,Civil marriage,House / apartment,-14867,-586,1,1,0,0,Drivers,2.0,-9,0
9139,5009367,M,Y,N,0,180000.0,Commercial associate,Higher education,Civil marriage,House / apartment,-14867,-586,1,1,0,0,Drivers,2.0,-10,0
9140,5009367,M,Y,N,0,180000.0,Commercial associate,Higher education,Civil marriage,House / apartment,-14867,-586,1,1,0,0,Drivers,2.0,-11,0
9141,5009367,M,Y,N,0,180000.0,Commercial associate,Higher education,Civil marriage,House / apartment,-14867,-586,1,1,0,0,Drivers,2.0,-12,0
9142,5009367,M,Y,N,0,180000.0,Commercial associate,Higher education,Civil marriage,House / apartment,-14867,-586,1,1,0,0,Drivers,2.0,-13,0
9143,5009367,M,Y,N,0,180000.0,Commercial associate,Higher education,Civil marriage,House / apartment,-14867,-586,1,1,0,0,Drivers,2.0,-14,0
9144,5009367,M,Y,N,0,180000.0,Commercial associate,Higher education,Civil marriage,House / apartment,-14867,-586,1,1,0,0,Drivers,2.0,-15,0
9145,5009367,M,Y,N,0,180000.0,Commercial associate,Higher education,Civil marriage,House / apartment,-14867,-586,1,1,0,0,Drivers,2.0,-16,0
9146,5009367,M,Y,N,0,180000.0,Commercial associate,Higher education,Civil marriage,House / apartment,-14867,-586,1,1,0,0,Drivers,2.0,-17,0
9147,5009367,M,Y,N,0,180000.0,Commercial associate,Higher education,Civil marriage,House / apartment,-14867,-586,1,1,0,0,Drivers,2.0,-18,0
9148,5009367,M,Y,N,0,180000.0,Commercial associate,Higher education,Civil marriage,House / apartment,-14867,-586,1,1,0,0,Drivers,2.0,-19,0
9149,5009367,M,Y,N,0,180000.0,Commercial associate,Higher education,Civil marriage,House / apartment,-14867,-586,1,1,0,0,Drivers,2.0,-20,0
9150,5009367,M,Y,N,0,180000.0,Commercial associate,Higher education,Civil marriage,House / apartment,-14867,-586,1,1,0,0,Drivers,2.0,-21,0
9151,5009367,M,Y,N,0,180000.0,Commercial associate,Higher education,Civil marriage,House / apartment,-14867,-586,1,1,0,0,Drivers,2.0,-22,0
9152,5009367,M,Y,N,0,180000.0,Commercial associate,Higher education,Civil marriage,House / apartment,-14867,-586,1,1,0,0,Drivers,2.0,-23,0
9153,5009367,M,Y,N,0,180000.0,Commercial associate,Higher education,Civil marriage,House / apartment,-14867,-586,1,1,0,0,Drivers,2.0,-24,0
9154,5009367,M,Y,N,0,180000.0,Commercial associate,Higher education,Civil marriage,House / apartment,-14867,-586,1,1,0,0,Drivers,2.0,-25,0
9155,5009367,M,Y,N,0,180000.0,Commercial associate,Higher education,Civil marriage,House / apartment,-14867,-586,1,1,0,0,Drivers,2.0,-26,0
9156,5009367,M,Y,N,0,180000.0,Commercial associate,Higher education,Civil marriage,House / apartment,-14867,-586,1,1,0,0,Drivers,2.0,-27,0
9157,5009367,M,Y,N,0,180000.0,Commercial associate,Higher education,Civil marriage,House / apartment,-14867,-586,1,1,0,0,Drivers,2.0,-28,0
9158,5009367,M,Y,N,0,180000.0,Commercial associate,Higher education,Civil marriage,House / apartment,-14867,-586,1,1,0,0,Drivers,2.0,-29,0
9159,5009367,M,Y,N,0,180000.0,Commercial associate,Higher education,Civil marriage,House / apartment,-14867,-586,1,1,0,0,Drivers,2.0,-30,0
9160,5009367,M,Y,N,0,180000.0,Commercial associate,Higher education,Civil marriage,House / apartment,-14867,-586,1,1,0,0,Drivers,2.0,-31,0
9161,5009367,M,Y,N,0,180000.0,Commercial associate,Higher education,Civil marriage,House / apartment,-14867,-586,1,1,0,0,Drivers,2.0,-32,0
9162,5009367,M,Y,N,0,180000.0,Commercial associate,Higher education,Civil marriage,House / apartment,-14867,-586,1,1,0,0,Drivers,2.0,-33,0
9163,5009367,M,Y,N,0,180000.0,Commercial associate,Higher education,Civil marriage,House / apartment,-14867,-586,1,1,0,0,Drivers,2.0,-34,0
9164,5009367,M,Y,N,0,180000.0,Commercial associate,Higher education,Civil marriage,House / apartment,-14867,-586,1,1,0,0,Drivers,2.0,-35,0
9165,5009367,M,Y,N,0,180000.0,Commercial associate,Higher education,Civil marriage,House / apartment,-14867,-586,1,1,0,0,Drivers,2.0,-36,0
9166,5009367,M,Y,N,0,180000.0,Commercial associate,Higher education,Civil marriage,House / apartment,-14867,-586,1,1,0,0,Drivers,2.0,-37,0
9167,5009367,M,Y,N,0,180000.0,Commercial associate,Higher education,Civil marriage,House / apartment,-14867,-586,1,1,0,0,Drivers,2.0,-38,0
9168,5009367,M,Y,N,0,180000.0,Commercial associate,Higher education,Civil marriage,House / apartment,-14867,-586,1,1,0,0,Drivers,2.0,-39,0
9169,5009367,M,Y,N,0,180000.0,Commercial associate,Higher education,Civil marriage,House / apartment,-14867,-586,1,1,0,0,Drivers,2.0,-40,0
9170,5009367,M,Y,N,0,180000.0,Commercial associate,Higher education,Civil marriage,House / apartment,-14867,-586,1,1,0,0,Drivers,2.0,-41,0
9171,5009367,M,Y,N,0,180000.0,Commercial associate,Higher education,Civil marriage,House / apartment,-14867,-586,1,1,0,0,Drivers,2.0,-42,0
9172,5009367,M,Y,N,0,180000.0,Commercial associate,Higher education,Civil marriage,House / apartment,-14867,-586,1,1,0,0,Drivers,2.0,-43,0
9173,5009368,M,Y,N,0,115290.0,Pensioner,Secondary / secondary special,Married,House / apartment,-23187,365243,1,0,1,1,,2.0,-27,C
9174,5009368,M,Y,N,0,115290.0,Pensioner,Secondary / secondary special,Married,House / apartment,-23187,365243,1,0,1,1,,2.0,-28,C
9175,5009368,M,Y,N,0,115290.0,Pensioner,Secondary / secondary special,Married,House / apartment,-23187,365243,1,0,1,1,,2.0,-29,C
9176,5009368,M,Y,N,0,115290.0,Pensioner,Secondary / secondary special,Married,House / apartment,-23187,365243,1,0,1,1,,2.0,-30,C
9177,5009368,M,Y,N,0,115290.0,Pensioner,Secondary / secondary special,Married,House / apartment,-23187,365243,1,0,1,1,,2.0,-31,C
9178,5009368,M,Y,N,0,115290.0,Pensioner,Secondary / secondary special,Married,House / apartment,-23187,365243,1,0,1,1,,2.0,-32,C
9179,5009368,M,Y,N,0,115290.0,Pensioner,Secondary / secondary special,Married,House / apartment,-23187,365243,1,0,1,1,,2.0,-33,C
9180,5009368,M,Y,N,0,115290.0,Pensioner,Secondary / secondary special,Married,House / apartment,-23187,365243,1,0,1,1,,2.0,-34,C
9181,5009368,M,Y,N,0,115290.0,Pensioner,Secondary / secondary special,Married,House / apartment,-23187,365243,1,0,1,1,,2.0,-35,0
9182,5009368,M,Y,N,0,115290.0,Pensioner,Secondary / secondary special,Married,House / apartment,-23187,365243,1,0,1,1,,2.0,-36,0
9183,5009368,M,Y,N,0,115290.0,Pensioner,Secondary / secondary special,Married,House / apartment,-23187,365243,1,0,1,1,,2.0,-37,0
9184,5009368,M,Y,N,0,115290.0,Pensioner,Secondary / secondary special,Married,House / apartment,-23187,365243,1,0,1,1,,2.0,-38,0
9185,5009368,M,Y,N,0,115290.0,Pensioner,Secondary / secondary special,Married,House / apartment,-23187,365243,1,0,1,1,,2.0,-39,0
9186,5009368,M,Y,N,0,115290.0,Pensioner,Secondary / secondary special,Married,House / apartment,-23187,365243,1,0,1,1,,2.0,-40,X
9187,5009369,M,Y,N,0,115290.0,Pensioner,Secondary / secondary special,Married,House / apartment,-23187,365243,1,0,1,1,,2.0,-11,0
9188,5009369,M,Y,N,0,115290.0,Pensioner,Secondary / secondary special,Married,House / apartment,-23187,365243,1,0,1,1,,2.0,-12,0
9189,5009369,M,Y,N,0,115290.0,Pensioner,Secondary / secondary special,Married,House / apartment,-23187,365243,1,0,1,1,,2.0,-13,0
9190,5009369,M,Y,N,0,115290.0,Pensioner,Secondary / secondary special,Married,House / apartment,-23187,365243,1,0,1,1,,2.0,-14,0
9191,5009369,M,Y,N,0,115290.0,Pensioner,Secondary / secondary special,Married,House / apartment,-23187,365243,1,0,1,1,,2.0,-15,1
9192,5009369,M,Y,N,0,115290.0,Pensioner,Secondary / secondary special,Married,House / apartment,-23187,365243,1,0,1,1,,2.0,-16,1
9193,5009369,M,Y,N,0,115290.0,Pensioner,Secondary / secondary special,Married,House / apartment,-23187,365243,1,0,1,1,,2.0,-17,0
9194,5009369,M,Y,N,0,115290.0,Pensioner,Secondary / secondary special,Married,House / apartment,-23187,365243,1,0,1,1,,2.0,-18,0
9195,5009369,M,Y,N,0,115290.0,Pensioner,Secondary / secondary special,Married,House / apartment,-23187,365243,1,0,1,1,,2.0,-19,0
9196,5009369,M,Y,N,0,115290.0,Pensioner,Secondary / secondary special,Married,House / apartment,-23187,365243,1,0,1,1,,2.0,-20,X
9197,5009370,M,Y,N,0,115290.0,Pensioner,Secondary / secondary special,Married,House / apartment,-23187,365243,1,0,1,1,,2.0,0,0
9198,5009370,M,Y,N,0,115290.0,Pensioner,Secondary / secondary special,Married,House / apartment,-23187,365243,1,0,1,1,,2.0,-1,0
9199,5009370,M,Y,N,0,115290.0,Pensioner,Secondary / secondary special,Married,House / apartment,-23187,365243,1,0,1,1,,2.0,-2,0
9200,5009370,M,Y,N,0,115290.0,Pensioner,Secondary / secondary special,Married,House / apartment,-23187,365243,1,0,1,1,,2.0,-3,0
9201,5009370,M,Y,N,0,115290.0,Pensioner,Secondary / secondary special,Married,House / apartment,-23187,365243,1,0,1,1,,2.0,-4,0
9202,5009370,M,Y,N,0,115290.0,Pensioner,Secondary / secondary special,Married,House / apartment,-23187,365243,1,0,1,1,,2.0,-5,0
9203,5009370,M,Y,N,0,115290.0,Pensioner,Secondary / secondary special,Married,House / apartment,-23187,365243,1,0,1,1,,2.0,-6,0
9204,5009370,M,Y,N,0,115290.0,Pensioner,Secondary / secondary special,Married,House / apartment,-23187,365243,1,0,1,1,,2.0,-7,0
9205,5009370,M,Y,N,0,115290.0,Pensioner,Secondary / secondary special,Married,House / apartment,-23187,365243,1,0,1,1,,2.0,-8,X
9206,5009371,M,Y,N,0,115290.0,Pensioner,Secondary / secondary special,Married,House / apartment,-23187,365243,1,0,1,1,,2.0,-3,0
9207,5009371,M,Y,N,0,115290.0,Pensioner,Secondary / secondary special,Married,House / apartment,-23187,365243,1,0,1,1,,2.0,-4,0
9208,5009371,M,Y,N,0,115290.0,Pensioner,Secondary / secondary special,Married,House / apartment,-23187,365243,1,0,1,1,,2.0,-5,0
9209,5009371,M,Y,N,0,115290.0,Pensioner,Secondary / secondary special,Married,House / apartment,-23187,365243,1,0,1,1,,2.0,-6,0
9210,5009371,M,Y,N,0,115290.0,Pensioner,Secondary / secondary special,Married,House / apartment,-23187,365243,1,0,1,1,,2.0,-7,0
9211,5009371,M,Y,N,0,115290.0,Pensioner,Secondary / secondary special,Married,House / apartment,-23187,365243,1,0,1,1,,2.0,-8,0
9212,5009371,M,Y,N,0,115290.0,Pensioner,Secondary / secondary special,Married,House / apartment,-23187,365243,1,0,1,1,,2.0,-9,0
9213,5009371,M,Y,N,0,115290.0,Pensioner,Secondary / secondary special,Married,House / apartment,-23187,365243,1,0,1,1,,2.0,-10,0
9214,5009371,M,Y,N,0,115290.0,Pensioner,Secondary / secondary special,Married,House / apartment,-23187,365243,1,0,1,1,,2.0,-11,X
9215,5009372,M,Y,N,0,115290.0,Pensioner,Secondary / secondary special,Married,House / apartment,-23187,365243,1,0,1,1,,2.0,-48,0
9216,5009372,M,Y,N,0,115290.0,Pensioner,Secondary / secondary special,Married,House / apartment,-23187,365243,1,0,1,1,,2.0,-49,0
9217,5009372,M,Y,N,0,115290.0,Pensioner,Secondary / secondary special,Married,House / apartment,-23187,365243,1,0,1,1,,2.0,-50,0
9218,5009372,M,Y,N,0,115290.0,Pensioner,Secondary / secondary special,Married,House / apartment,-23187,365243,1,0,1,1,,2.0,-51,0
9219,5009372,M,Y,N,0,115290.0,Pensioner,Secondary / secondary special,Married,House / apartment,-23187,365243,1,0,1,1,,2.0,-52,0
9220,5009372,M,Y,N,0,115290.0,Pensioner,Secondary / secondary special,Married,House / apartment,-23187,365243,1,0,1,1,,2.0,-53,0
9221,5009372,M,Y,N,0,115290.0,Pensioner,Secondary / secondary special,Married,House / apartment,-23187,365243,1,0,1,1,,2.0,-54,0
9222,5009372,M,Y,N,0,115290.0,Pensioner,Secondary / secondary special,Married,House / apartment,-23187,365243,1,0,1,1,,2.0,-55,0
9223,5009372,M,Y,N,0,115290.0,Pensioner,Secondary / secondary special,Married,House / apartment,-23187,365243,1,0,1,1,,2.0,-56,X
9224,5009373,M,Y,N,0,115290.0,Pensioner,Secondary / secondary special,Married,House / apartment,-23187,365243,1,0,1,1,,2.0,0,C
9225,5009373,M,Y,N,0,115290.0,Pensioner,Secondary / secondary special,Married,House / apartment,-23187,365243,1,0,1,1,,2.0,-1,C
9226,5009373,M,Y,N,0,115290.0,Pensioner,Secondary / secondary special,Married,House / apartment,-23187,365243,1,0,1,1,,2.0,-2,C
9227,5009373,M,Y,N,0,115290.0,Pensioner,Secondary / secondary special,Married,House / apartment,-23187,365243,1,0,1,1,,2.0,-3,C
9228,5009373,M,Y,N,0,115290.0,Pensioner,Secondary / secondary special,Married,House / apartment,-23187,365243,1,0,1,1,,2.0,-4,C
9229,5009373,M,Y,N,0,115290.0,Pensioner,Secondary / secondary special,Married,House / apartment,-23187,365243,1,0,1,1,,2.0,-5,0
9230,5009373,M,Y,N,0,115290.0,Pensioner,Secondary / secondary special,Married,House / apartment,-23187,365243,1,0,1,1,,2.0,-6,0
9231,5009373,M,Y,N,0,115290.0,Pensioner,Secondary / secondary special,Married,House / apartment,-23187,365243,1,0,1,1,,2.0,-7,0
9232,5009373,M,Y,N,0,115290.0,Pensioner,Secondary / secondary special,Married,House / apartment,-23187,365243,1,0,1,1,,2.0,-8,0
9233,5009373,M,Y,N,0,115290.0,Pensioner,Secondary / secondary special,Married,House / apartment,-23187,365243,1,0,1,1,,2.0,-9,0
9234,5009373,M,Y,N,0,115290.0,Pensioner,Secondary / secondary special,Married,House / apartment,-23187,365243,1,0,1,1,,2.0,-10,0
9235,5009373,M,Y,N,0,115290.0,Pensioner,Secondary / secondary special,Married,House / apartment,-23187,365243,1,0,1,1,,2.0,-11,0
9236,5009373,M,Y,N,0,115290.0,Pensioner,Secondary / secondary special,Married,House / apartment,-23187,365243,1,0,1,1,,2.0,-12,0
9237,5009373,M,Y,N,0,115290.0,Pensioner,Secondary / secondary special,Married,House / apartment,-23187,365243,1,0,1,1,,2.0,-13,0
9238,5009373,M,Y,N,0,115290.0,Pensioner,Secondary / secondary special,Married,House / apartment,-23187,365243,1,0,1,1,,2.0,-14,0
9239,5009373,M,Y,N,0,115290.0,Pensioner,Secondary / secondary special,Married,House / apartment,-23187,365243,1,0,1,1,,2.0,-15,0
9240,5009373,M,Y,N,0,115290.0,Pensioner,Secondary / secondary special,Married,House / apartment,-23187,365243,1,0,1,1,,2.0,-16,X
9241,5009378,F,N,N,2,225000.0,Working,Higher education,Married,House / apartment,-11281,-1744,1,1,0,1,Core staff,4.0,0,C
9242,5009378,F,N,N,2,225000.0,Working,Higher education,Married,House / apartment,-11281,-1744,1,1,0,1,Core staff,4.0,-1,C
9243,5009378,F,N,N,2,225000.0,Working,Higher education,Married,House / apartment,-11281,-1744,1,1,0,1,Core staff,4.0,-2,C
9244,5009378,F,N,N,2,225000.0,Working,Higher education,Married,House / apartment,-11281,-1744,1,1,0,1,Core staff,4.0,-3,C
9245,5009378,F,N,N,2,225000.0,Working,Higher education,Married,House / apartment,-11281,-1744,1,1,0,1,Core staff,4.0,-4,C
9246,5009378,F,N,N,2,225000.0,Working,Higher education,Married,House / apartment,-11281,-1744,1,1,0,1,Core staff,4.0,-5,C
9247,5009378,F,N,N,2,225000.0,Working,Higher education,Married,House / apartment,-11281,-1744,1,1,0,1,Core staff,4.0,-6,C
9248,5009378,F,N,N,2,225000.0,Working,Higher education,Married,House / apartment,-11281,-1744,1,1,0,1,Core staff,4.0,-7,C
9249,5009378,F,N,N,2,225000.0,Working,Higher education,Married,House / apartment,-11281,-1744,1,1,0,1,Core staff,4.0,-8,C
9250,5009378,F,N,N,2,225000.0,Working,Higher education,Married,House / apartment,-11281,-1744,1,1,0,1,Core staff,4.0,-9,C
9251,5009378,F,N,N,2,225000.0,Working,Higher education,Married,House / apartment,-11281,-1744,1,1,0,1,Core staff,4.0,-10,C
9252,5009378,F,N,N,2,225000.0,Working,Higher education,Married,House / apartment,-11281,-1744,1,1,0,1,Core staff,4.0,-11,C
9253,5009378,F,N,N,2,225000.0,Working,Higher education,Married,House / apartment,-11281,-1744,1,1,0,1,Core staff,4.0,-12,C
9254,5009378,F,N,N,2,225000.0,Working,Higher education,Married,House / apartment,-11281,-1744,1,1,0,1,Core staff,4.0,-13,C
9255,5009378,F,N,N,2,225000.0,Working,Higher education,Married,House / apartment,-11281,-1744,1,1,0,1,Core staff,4.0,-14,C
9256,5009378,F,N,N,2,225000.0,Working,Higher education,Married,House / apartment,-11281,-1744,1,1,0,1,Core staff,4.0,-15,C
9257,5009378,F,N,N,2,225000.0,Working,Higher education,Married,House / apartment,-11281,-1744,1,1,0,1,Core staff,4.0,-16,C
9258,5009378,F,N,N,2,225000.0,Working,Higher education,Married,House / apartment,-11281,-1744,1,1,0,1,Core staff,4.0,-17,C
9259,5009378,F,N,N,2,225000.0,Working,Higher education,Married,House / apartment,-11281,-1744,1,1,0,1,Core staff,4.0,-18,C
9260,5009378,F,N,N,2,225000.0,Working,Higher education,Married,House / apartment,-11281,-1744,1,1,0,1,Core staff,4.0,-19,C
9261,5009378,F,N,N,2,225000.0,Working,Higher education,Married,House / apartment,-11281,-1744,1,1,0,1,Core staff,4.0,-20,C
9262,5009378,F,N,N,2,225000.0,Working,Higher education,Married,House / apartment,-11281,-1744,1,1,0,1,Core staff,4.0,-21,C
9263,5009378,F,N,N,2,225000.0,Working,Higher education,Married,House / apartment,-11281,-1744,1,1,0,1,Core staff,4.0,-22,C
9264,5009378,F,N,N,2,225000.0,Working,Higher education,Married,House / apartment,-11281,-1744,1,1,0,1,Core staff,4.0,-23,C
9265,5009378,F,N,N,2,225000.0,Working,Higher education,Married,House / apartment,-11281,-1744,1,1,0,1,Core staff,4.0,-24,C
9266,5009378,F,N,N,2,225000.0,Working,Higher education,Married,House / apartment,-11281,-1744,1,1,0,1,Core staff,4.0,-25,C
9267,5009378,F,N,N,2,225000.0,Working,Higher education,Married,House / apartment,-11281,-1744,1,1,0,1,Core staff,4.0,-26,C
9268,5009378,F,N,N,2,225000.0,Working,Higher education,Married,House / apartment,-11281,-1744,1,1,0,1,Core staff,4.0,-27,C
9269,5009378,F,N,N,2,225000.0,Working,Higher education,Married,House / apartment,-11281,-1744,1,1,0,1,Core staff,4.0,-28,C
9270,5009378,F,N,N,2,225000.0,Working,Higher education,Married,House / apartment,-11281,-1744,1,1,0,1,Core staff,4.0,-29,C
9271,5009378,F,N,N,2,225000.0,Working,Higher education,Married,House / apartment,-11281,-1744,1,1,0,1,Core staff,4.0,-30,C
9272,5009378,F,N,N,2,225000.0,Working,Higher education,Married,House / apartment,-11281,-1744,1,1,0,1,Core staff,4.0,-31,C
9273,5009378,F,N,N,2,225000.0,Working,Higher education,Married,House / apartment,-11281,-1744,1,1,0,1,Core staff,4.0,-32,C
9274,5009378,F,N,N,2,225000.0,Working,Higher education,Married,House / apartment,-11281,-1744,1,1,0,1,Core staff,4.0,-33,C
9275,5009378,F,N,N,2,225000.0,Working,Higher education,Married,House / apartment,-11281,-1744,1,1,0,1,Core staff,4.0,-34,0
9276,5009378,F,N,N,2,225000.0,Working,Higher education,Married,House / apartment,-11281,-1744,1,1,0,1,Core staff,4.0,-35,0
9277,5009378,F,N,N,2,225000.0,Working,Higher education,Married,House / apartment,-11281,-1744,1,1,0,1,Core staff,4.0,-36,0
9278,5009378,F,N,N,2,225000.0,Working,Higher education,Married,House / apartment,-11281,-1744,1,1,0,1,Core staff,4.0,-37,0
9279,5009378,F,N,N,2,225000.0,Working,Higher education,Married,House / apartment,-11281,-1744,1,1,0,1,Core staff,4.0,-38,0
9280,5009378,F,N,N,2,225000.0,Working,Higher education,Married,House / apartment,-11281,-1744,1,1,0,1,Core staff,4.0,-39,0
9281,5009379,M,Y,N,1,135000.0,Working,Secondary / secondary special,Married,House / apartment,-9430,-1195,1,1,0,0,Sales staff,3.0,-28,X
9282,5009379,M,Y,N,1,135000.0,Working,Secondary / secondary special,Married,House / apartment,-9430,-1195,1,1,0,0,Sales staff,3.0,-29,0
9283,5009379,M,Y,N,1,135000.0,Working,Secondary / secondary special,Married,House / apartment,-9430,-1195,1,1,0,0,Sales staff,3.0,-30,0
9284,5009379,M,Y,N,1,135000.0,Working,Secondary / secondary special,Married,House / apartment,-9430,-1195,1,1,0,0,Sales staff,3.0,-31,0
9285,5009379,M,Y,N,1,135000.0,Working,Secondary / secondary special,Married,House / apartment,-9430,-1195,1,1,0,0,Sales staff,3.0,-32,0
9286,5009380,M,Y,N,1,135000.0,Working,Secondary / secondary special,Married,House / apartment,-9430,-1195,1,1,0,0,Sales staff,3.0,-20,X
9287,5009380,M,Y,N,1,135000.0,Working,Secondary / secondary special,Married,House / apartment,-9430,-1195,1,1,0,0,Sales staff,3.0,-21,0
9288,5009380,M,Y,N,1,135000.0,Working,Secondary / secondary special,Married,House / apartment,-9430,-1195,1,1,0,0,Sales staff,3.0,-22,0
9289,5009380,M,Y,N,1,135000.0,Working,Secondary / secondary special,Married,House / apartment,-9430,-1195,1,1,0,0,Sales staff,3.0,-23,0
9290,5009380,M,Y,N,1,135000.0,Working,Secondary / secondary special,Married,House / apartment,-9430,-1195,1,1,0,0,Sales staff,3.0,-24,0
9291,5009381,M,Y,N,1,135000.0,Working,Secondary / secondary special,Married,House / apartment,-9430,-1195,1,1,0,0,Sales staff,3.0,0,C
9292,5009381,M,Y,N,1,135000.0,Working,Secondary / secondary special,Married,House / apartment,-9430,-1195,1,1,0,0,Sales staff,3.0,-1,C
9293,5009381,M,Y,N,1,135000.0,Working,Secondary / secondary special,Married,House / apartment,-9430,-1195,1,1,0,0,Sales staff,3.0,-2,C
9294,5009381,M,Y,N,1,135000.0,Working,Secondary / secondary special,Married,House / apartment,-9430,-1195,1,1,0,0,Sales staff,3.0,-3,0
9295,5009381,M,Y,N,1,135000.0,Working,Secondary / secondary special,Married,House / apartment,-9430,-1195,1,1,0,0,Sales staff,3.0,-4,0
9296,5009381,M,Y,N,1,135000.0,Working,Secondary / secondary special,Married,House / apartment,-9430,-1195,1,1,0,0,Sales staff,3.0,-5,0
9297,5009381,M,Y,N,1,135000.0,Working,Secondary / secondary special,Married,House / apartment,-9430,-1195,1,1,0,0,Sales staff,3.0,-6,0
9298,5009381,M,Y,N,1,135000.0,Working,Secondary / secondary special,Married,House / apartment,-9430,-1195,1,1,0,0,Sales staff,3.0,-7,0
9299,5009381,M,Y,N,1,135000.0,Working,Secondary / secondary special,Married,House / apartment,-9430,-1195,1,1,0,0,Sales staff,3.0,-8,0
9300,5009382,M,Y,N,1,135000.0,Working,Secondary / secondary special,Married,House / apartment,-9430,-1195,1,1,0,0,Sales staff,3.0,-2,X
9301,5009382,M,Y,N,1,135000.0,Working,Secondary / secondary special,Married,House / apartment,-9430,-1195,1,1,0,0,Sales staff,3.0,-3,0
9302,5009382,M,Y,N,1,135000.0,Working,Secondary / secondary special,Married,House / apartment,-9430,-1195,1,1,0,0,Sales staff,3.0,-4,0
9303,5009382,M,Y,N,1,135000.0,Working,Secondary / secondary special,Married,House / apartment,-9430,-1195,1,1,0,0,Sales staff,3.0,-5,0
9304,5009382,M,Y,N,1,135000.0,Working,Secondary / secondary special,Married,House / apartment,-9430,-1195,1,1,0,0,Sales staff,3.0,-6,0
9305,5009382,M,Y,N,1,135000.0,Working,Secondary / secondary special,Married,House / apartment,-9430,-1195,1,1,0,0,Sales staff,3.0,-7,0
9306,5009382,M,Y,N,1,135000.0,Working,Secondary / secondary special,Married,House / apartment,-9430,-1195,1,1,0,0,Sales staff,3.0,-8,0
9307,5009382,M,Y,N,1,135000.0,Working,Secondary / secondary special,Married,House / apartment,-9430,-1195,1,1,0,0,Sales staff,3.0,-9,0
9308,5009382,M,Y,N,1,135000.0,Working,Secondary / secondary special,Married,House / apartment,-9430,-1195,1,1,0,0,Sales staff,3.0,-10,0
9309,5009382,M,Y,N,1,135000.0,Working,Secondary / secondary special,Married,House / apartment,-9430,-1195,1,1,0,0,Sales staff,3.0,-11,0
9310,5009383,F,N,N,0,450000.0,State servant,Higher education,Married,House / apartment,-14718,-5578,1,0,1,0,Managers,2.0,0,C
9311,5009383,F,N,N,0,450000.0,State servant,Higher education,Married,House / apartment,-14718,-5578,1,0,1,0,Managers,2.0,-1,C
9312,5009383,F,N,N,0,450000.0,State servant,Higher education,Married,House / apartment,-14718,-5578,1,0,1,0,Managers,2.0,-2,C
9313,5009383,F,N,N,0,450000.0,State servant,Higher education,Married,House / apartment,-14718,-5578,1,0,1,0,Managers,2.0,-3,C
9314,5009383,F,N,N,0,450000.0,State servant,Higher education,Married,House / apartment,-14718,-5578,1,0,1,0,Managers,2.0,-4,C
9315,5009383,F,N,N,0,450000.0,State servant,Higher education,Married,House / apartment,-14718,-5578,1,0,1,0,Managers,2.0,-5,C
9316,5009383,F,N,N,0,450000.0,State servant,Higher education,Married,House / apartment,-14718,-5578,1,0,1,0,Managers,2.0,-6,C
9317,5009383,F,N,N,0,450000.0,State servant,Higher education,Married,House / apartment,-14718,-5578,1,0,1,0,Managers,2.0,-7,0
9318,5009383,F,N,N,0,450000.0,State servant,Higher education,Married,House / apartment,-14718,-5578,1,0,1,0,Managers,2.0,-8,0
9319,5009383,F,N,N,0,450000.0,State servant,Higher education,Married,House / apartment,-14718,-5578,1,0,1,0,Managers,2.0,-9,0
9320,5009383,F,N,N,0,450000.0,State servant,Higher education,Married,House / apartment,-14718,-5578,1,0,1,0,Managers,2.0,-10,0
9321,5009383,F,N,N,0,450000.0,State servant,Higher education,Married,House / apartment,-14718,-5578,1,0,1,0,Managers,2.0,-11,0
9322,5009383,F,N,N,0,450000.0,State servant,Higher education,Married,House / apartment,-14718,-5578,1,0,1,0,Managers,2.0,-12,0
9323,5009383,F,N,N,0,450000.0,State servant,Higher education,Married,House / apartment,-14718,-5578,1,0,1,0,Managers,2.0,-13,0
9324,5009383,F,N,N,0,450000.0,State servant,Higher education,Married,House / apartment,-14718,-5578,1,0,1,0,Managers,2.0,-14,0
9325,5009383,F,N,N,0,450000.0,State servant,Higher education,Married,House / apartment,-14718,-5578,1,0,1,0,Managers,2.0,-15,0
9326,5009383,F,N,N,0,450000.0,State servant,Higher education,Married,House / apartment,-14718,-5578,1,0,1,0,Managers,2.0,-16,0
9327,5009383,F,N,N,0,450000.0,State servant,Higher education,Married,House / apartment,-14718,-5578,1,0,1,0,Managers,2.0,-17,0
9328,5009383,F,N,N,0,450000.0,State servant,Higher education,Married,House / apartment,-14718,-5578,1,0,1,0,Managers,2.0,-18,0
9329,5009383,F,N,N,0,450000.0,State servant,Higher education,Married,House / apartment,-14718,-5578,1,0,1,0,Managers,2.0,-19,0
9330,5009383,F,N,N,0,450000.0,State servant,Higher education,Married,House / apartment,-14718,-5578,1,0,1,0,Managers,2.0,-20,0
9331,5009383,F,N,N,0,450000.0,State servant,Higher education,Married,House / apartment,-14718,-5578,1,0,1,0,Managers,2.0,-21,0
9332,5009383,F,N,N,0,450000.0,State servant,Higher education,Married,House / apartment,-14718,-5578,1,0,1,0,Managers,2.0,-22,0
9333,5009383,F,N,N,0,450000.0,State servant,Higher education,Married,House / apartment,-14718,-5578,1,0,1,0,Managers,2.0,-23,0
9334,5009383,F,N,N,0,450000.0,State servant,Higher education,Married,House / apartment,-14718,-5578,1,0,1,0,Managers,2.0,-24,0
9335,5009383,F,N,N,0,450000.0,State servant,Higher education,Married,House / apartment,-14718,-5578,1,0,1,0,Managers,2.0,-25,0
9336,5009383,F,N,N,0,450000.0,State servant,Higher education,Married,House / apartment,-14718,-5578,1,0,1,0,Managers,2.0,-26,0
9337,5009383,F,N,N,0,450000.0,State servant,Higher education,Married,House / apartment,-14718,-5578,1,0,1,0,Managers,2.0,-27,0
9338,5009383,F,N,N,0,450000.0,State servant,Higher education,Married,House / apartment,-14718,-5578,1,0,1,0,Managers,2.0,-28,0
9339,5009383,F,N,N,0,450000.0,State servant,Higher education,Married,House / apartment,-14718,-5578,1,0,1,0,Managers,2.0,-29,0
9340,5009383,F,N,N,0,450000.0,State servant,Higher education,Married,House / apartment,-14718,-5578,1,0,1,0,Managers,2.0,-30,X
9341,5009384,F,N,N,0,450000.0,State servant,Higher education,Married,House / apartment,-14718,-5578,1,0,1,0,Managers,2.0,0,C
9342,5009384,F,N,N,0,450000.0,State servant,Higher education,Married,House / apartment,-14718,-5578,1,0,1,0,Managers,2.0,-1,C
9343,5009384,F,N,N,0,450000.0,State servant,Higher education,Married,House / apartment,-14718,-5578,1,0,1,0,Managers,2.0,-2,C
9344,5009384,F,N,N,0,450000.0,State servant,Higher education,Married,House / apartment,-14718,-5578,1,0,1,0,Managers,2.0,-3,C
9345,5009384,F,N,N,0,450000.0,State servant,Higher education,Married,House / apartment,-14718,-5578,1,0,1,0,Managers,2.0,-4,C
9346,5009384,F,N,N,0,450000.0,State servant,Higher education,Married,House / apartment,-14718,-5578,1,0,1,0,Managers,2.0,-5,C
9347,5009384,F,N,N,0,450000.0,State servant,Higher education,Married,House / apartment,-14718,-5578,1,0,1,0,Managers,2.0,-6,C
9348,5009384,F,N,N,0,450000.0,State servant,Higher education,Married,House / apartment,-14718,-5578,1,0,1,0,Managers,2.0,-7,C
9349,5009384,F,N,N,0,450000.0,State servant,Higher education,Married,House / apartment,-14718,-5578,1,0,1,0,Managers,2.0,-8,C
9350,5009384,F,N,N,0,450000.0,State servant,Higher education,Married,House / apartment,-14718,-5578,1,0,1,0,Managers,2.0,-9,C
9351,5009384,F,N,N,0,450000.0,State servant,Higher education,Married,House / apartment,-14718,-5578,1,0,1,0,Managers,2.0,-10,0
9352,5009384,F,N,N,0,450000.0,State servant,Higher education,Married,House / apartment,-14718,-5578,1,0,1,0,Managers,2.0,-11,0
9353,5009384,F,N,N,0,450000.0,State servant,Higher education,Married,House / apartment,-14718,-5578,1,0,1,0,Managers,2.0,-12,0
9354,5009384,F,N,N,0,450000.0,State servant,Higher education,Married,House / apartment,-14718,-5578,1,0,1,0,Managers,2.0,-13,0
9355,5009384,F,N,N,0,450000.0,State servant,Higher education,Married,House / apartment,-14718,-5578,1,0,1,0,Managers,2.0,-14,0
9356,5009384,F,N,N,0,450000.0,State servant,Higher education,Married,House / apartment,-14718,-5578,1,0,1,0,Managers,2.0,-15,0
9357,5009384,F,N,N,0,450000.0,State servant,Higher education,Married,House / apartment,-14718,-5578,1,0,1,0,Managers,2.0,-16,0
9358,5009384,F,N,N,0,450000.0,State servant,Higher education,Married,House / apartment,-14718,-5578,1,0,1,0,Managers,2.0,-17,0
9359,5009384,F,N,N,0,450000.0,State servant,Higher education,Married,House / apartment,-14718,-5578,1,0,1,0,Managers,2.0,-18,0
9360,5009384,F,N,N,0,450000.0,State servant,Higher education,Married,House / apartment,-14718,-5578,1,0,1,0,Managers,2.0,-19,0
9361,5009384,F,N,N,0,450000.0,State servant,Higher education,Married,House / apartment,-14718,-5578,1,0,1,0,Managers,2.0,-20,0
9362,5009384,F,N,N,0,450000.0,State servant,Higher education,Married,House / apartment,-14718,-5578,1,0,1,0,Managers,2.0,-21,0
9363,5009384,F,N,N,0,450000.0,State servant,Higher education,Married,House / apartment,-14718,-5578,1,0,1,0,Managers,2.0,-22,0
9364,5009384,F,N,N,0,450000.0,State servant,Higher education,Married,House / apartment,-14718,-5578,1,0,1,0,Managers,2.0,-23,0
9365,5009384,F,N,N,0,450000.0,State servant,Higher education,Married,House / apartment,-14718,-5578,1,0,1,0,Managers,2.0,-24,0
9366,5009384,F,N,N,0,450000.0,State servant,Higher education,Married,House / apartment,-14718,-5578,1,0,1,0,Managers,2.0,-25,0
9367,5009384,F,N,N,0,450000.0,State servant,Higher education,Married,House / apartment,-14718,-5578,1,0,1,0,Managers,2.0,-26,0
9368,5009384,F,N,N,0,450000.0,State servant,Higher education,Married,House / apartment,-14718,-5578,1,0,1,0,Managers,2.0,-27,0
9369,5009384,F,N,N,0,450000.0,State servant,Higher education,Married,House / apartment,-14718,-5578,1,0,1,0,Managers,2.0,-28,0
9370,5009384,F,N,N,0,450000.0,State servant,Higher education,Married,House / apartment,-14718,-5578,1,0,1,0,Managers,2.0,-29,0
9371,5009384,F,N,N,0,450000.0,State servant,Higher education,Married,House / apartment,-14718,-5578,1,0,1,0,Managers,2.0,-30,0
9372,5009384,F,N,N,0,450000.0,State servant,Higher education,Married,House / apartment,-14718,-5578,1,0,1,0,Managers,2.0,-31,0
9373,5009384,F,N,N,0,450000.0,State servant,Higher education,Married,House / apartment,-14718,-5578,1,0,1,0,Managers,2.0,-32,0
9374,5009384,F,N,N,0,450000.0,State servant,Higher education,Married,House / apartment,-14718,-5578,1,0,1,0,Managers,2.0,-33,X
9375,5009386,F,N,N,0,450000.0,State servant,Higher education,Married,House / apartment,-14718,-5578,1,0,1,0,Managers,2.0,0,X
9376,5009386,F,N,N,0,450000.0,State servant,Higher education,Married,House / apartment,-14718,-5578,1,0,1,0,Managers,2.0,-1,X
9377,5009386,F,N,N,0,450000.0,State servant,Higher education,Married,House / apartment,-14718,-5578,1,0,1,0,Managers,2.0,-2,X
9378,5009386,F,N,N,0,450000.0,State servant,Higher education,Married,House / apartment,-14718,-5578,1,0,1,0,Managers,2.0,-3,X
9379,5009386,F,N,N,0,450000.0,State servant,Higher education,Married,House / apartment,-14718,-5578,1,0,1,0,Managers,2.0,-4,X
9380,5009386,F,N,N,0,450000.0,State servant,Higher education,Married,House / apartment,-14718,-5578,1,0,1,0,Managers,2.0,-5,X
9381,5009386,F,N,N,0,450000.0,State servant,Higher education,Married,House / apartment,-14718,-5578,1,0,1,0,Managers,2.0,-6,X
9382,5009387,F,N,N,0,450000.0,State servant,Higher education,Married,House / apartment,-14718,-5578,1,0,1,0,Managers,2.0,0,0
9383,5009387,F,N,N,0,450000.0,State servant,Higher education,Married,House / apartment,-14718,-5578,1,0,1,0,Managers,2.0,-1,0
9384,5009387,F,N,N,0,450000.0,State servant,Higher education,Married,House / apartment,-14718,-5578,1,0,1,0,Managers,2.0,-2,0
9385,5009387,F,N,N,0,450000.0,State servant,Higher education,Married,House / apartment,-14718,-5578,1,0,1,0,Managers,2.0,-3,0
9386,5009387,F,N,N,0,450000.0,State servant,Higher education,Married,House / apartment,-14718,-5578,1,0,1,0,Managers,2.0,-4,0
9387,5009387,F,N,N,0,450000.0,State servant,Higher education,Married,House / apartment,-14718,-5578,1,0,1,0,Managers,2.0,-5,0
9388,5009387,F,N,N,0,450000.0,State servant,Higher education,Married,House / apartment,-14718,-5578,1,0,1,0,Managers,2.0,-6,X
9389,5009389,M,N,N,0,279000.0,State servant,Higher education,Single / not married,House / apartment,-11042,-3174,1,0,0,0,Core staff,1.0,-5,C
9390,5009389,M,N,N,0,279000.0,State servant,Higher education,Single / not married,House / apartment,-11042,-3174,1,0,0,0,Core staff,1.0,-6,C
9391,5009389,M,N,N,0,279000.0,State servant,Higher education,Single / not married,House / apartment,-11042,-3174,1,0,0,0,Core staff,1.0,-7,C
9392,5009389,M,N,N,0,279000.0,State servant,Higher education,Single / not married,House / apartment,-11042,-3174,1,0,0,0,Core staff,1.0,-8,C
9393,5009389,M,N,N,0,279000.0,State servant,Higher education,Single / not married,House / apartment,-11042,-3174,1,0,0,0,Core staff,1.0,-9,C
9394,5009389,M,N,N,0,279000.0,State servant,Higher education,Single / not married,House / apartment,-11042,-3174,1,0,0,0,Core staff,1.0,-10,C
9395,5009389,M,N,N,0,279000.0,State servant,Higher education,Single / not married,House / apartment,-11042,-3174,1,0,0,0,Core staff,1.0,-11,C
9396,5009389,M,N,N,0,279000.0,State servant,Higher education,Single / not married,House / apartment,-11042,-3174,1,0,0,0,Core staff,1.0,-12,0
9397,5009389,M,N,N,0,279000.0,State servant,Higher education,Single / not married,House / apartment,-11042,-3174,1,0,0,0,Core staff,1.0,-13,0
9398,5009389,M,N,N,0,279000.0,State servant,Higher education,Single / not married,House / apartment,-11042,-3174,1,0,0,0,Core staff,1.0,-14,1
9399,5009389,M,N,N,0,279000.0,State servant,Higher education,Single / not married,House / apartment,-11042,-3174,1,0,0,0,Core staff,1.0,-15,0
9400,5009389,M,N,N,0,279000.0,State servant,Higher education,Single / not married,House / apartment,-11042,-3174,1,0,0,0,Core staff,1.0,-16,0
9401,5009389,M,N,N,0,279000.0,State servant,Higher education,Single / not married,House / apartment,-11042,-3174,1,0,0,0,Core staff,1.0,-17,0
9402,5009389,M,N,N,0,279000.0,State servant,Higher education,Single / not married,House / apartment,-11042,-3174,1,0,0,0,Core staff,1.0,-18,0
9403,5009389,M,N,N,0,279000.0,State servant,Higher education,Single / not married,House / apartment,-11042,-3174,1,0,0,0,Core staff,1.0,-19,0
9404,5009389,M,N,N,0,279000.0,State servant,Higher education,Single / not married,House / apartment,-11042,-3174,1,0,0,0,Core staff,1.0,-20,0
9405,5009389,M,N,N,0,279000.0,State servant,Higher education,Single / not married,House / apartment,-11042,-3174,1,0,0,0,Core staff,1.0,-21,0
9406,5009391,M,N,N,0,279000.0,State servant,Higher education,Single / not married,House / apartment,-11042,-3174,1,0,0,0,Core staff,1.0,0,0
9407,5009391,M,N,N,0,279000.0,State servant,Higher education,Single / not married,House / apartment,-11042,-3174,1,0,0,0,Core staff,1.0,-1,0
9408,5009391,M,N,N,0,279000.0,State servant,Higher education,Single / not married,House / apartment,-11042,-3174,1,0,0,0,Core staff,1.0,-2,X
9409,5009391,M,N,N,0,279000.0,State servant,Higher education,Single / not married,House / apartment,-11042,-3174,1,0,0,0,Core staff,1.0,-3,0
9410,5009391,M,N,N,0,279000.0,State servant,Higher education,Single / not married,House / apartment,-11042,-3174,1,0,0,0,Core staff,1.0,-4,0
9411,5009391,M,N,N,0,279000.0,State servant,Higher education,Single / not married,House / apartment,-11042,-3174,1,0,0,0,Core staff,1.0,-5,0
9412,5009391,M,N,N,0,279000.0,State servant,Higher education,Single / not married,House / apartment,-11042,-3174,1,0,0,0,Core staff,1.0,-6,0
9413,5009391,M,N,N,0,279000.0,State servant,Higher education,Single / not married,House / apartment,-11042,-3174,1,0,0,0,Core staff,1.0,-7,0
9414,5009391,M,N,N,0,279000.0,State servant,Higher education,Single / not married,House / apartment,-11042,-3174,1,0,0,0,Core staff,1.0,-8,0
9415,5009391,M,N,N,0,279000.0,State servant,Higher education,Single / not married,House / apartment,-11042,-3174,1,0,0,0,Core staff,1.0,-9,0
9416,5009391,M,N,N,0,279000.0,State servant,Higher education,Single / not married,House / apartment,-11042,-3174,1,0,0,0,Core staff,1.0,-10,0
9417,5009391,M,N,N,0,279000.0,State servant,Higher education,Single / not married,House / apartment,-11042,-3174,1,0,0,0,Core staff,1.0,-11,0
9418,5009391,M,N,N,0,279000.0,State servant,Higher education,Single / not married,House / apartment,-11042,-3174,1,0,0,0,Core staff,1.0,-12,0
9419,5009391,M,N,N,0,279000.0,State servant,Higher education,Single / not married,House / apartment,-11042,-3174,1,0,0,0,Core staff,1.0,-13,0
9420,5009391,M,N,N,0,279000.0,State servant,Higher education,Single / not married,House / apartment,-11042,-3174,1,0,0,0,Core staff,1.0,-14,0
9421,5009391,M,N,N,0,279000.0,State servant,Higher education,Single / not married,House / apartment,-11042,-3174,1,0,0,0,Core staff,1.0,-15,0
9422,5009391,M,N,N,0,279000.0,State servant,Higher education,Single / not married,House / apartment,-11042,-3174,1,0,0,0,Core staff,1.0,-16,X
9423,5009391,M,N,N,0,279000.0,State servant,Higher education,Single / not married,House / apartment,-11042,-3174,1,0,0,0,Core staff,1.0,-17,0
9424,5009391,M,N,N,0,279000.0,State servant,Higher education,Single / not married,House / apartment,-11042,-3174,1,0,0,0,Core staff,1.0,-18,0
9425,5009391,M,N,N,0,279000.0,State servant,Higher education,Single / not married,House / apartment,-11042,-3174,1,0,0,0,Core staff,1.0,-19,0
9426,5009391,M,N,N,0,279000.0,State servant,Higher education,Single / not married,House / apartment,-11042,-3174,1,0,0,0,Core staff,1.0,-20,0
9427,5009391,M,N,N,0,279000.0,State servant,Higher education,Single / not married,House / apartment,-11042,-3174,1,0,0,0,Core staff,1.0,-21,0
9428,5009391,M,N,N,0,279000.0,State servant,Higher education,Single / not married,House / apartment,-11042,-3174,1,0,0,0,Core staff,1.0,-22,0
9429,5009391,M,N,N,0,279000.0,State servant,Higher education,Single / not married,House / apartment,-11042,-3174,1,0,0,0,Core staff,1.0,-23,0
9430,5009391,M,N,N,0,279000.0,State servant,Higher education,Single / not married,House / apartment,-11042,-3174,1,0,0,0,Core staff,1.0,-24,0
9431,5009391,M,N,N,0,279000.0,State servant,Higher education,Single / not married,House / apartment,-11042,-3174,1,0,0,0,Core staff,1.0,-25,1
9432,5009391,M,N,N,0,279000.0,State servant,Higher education,Single / not married,House / apartment,-11042,-3174,1,0,0,0,Core staff,1.0,-26,0
9433,5009391,M,N,N,0,279000.0,State servant,Higher education,Single / not married,House / apartment,-11042,-3174,1,0,0,0,Core staff,1.0,-27,0
9434,5009391,M,N,N,0,279000.0,State servant,Higher education,Single / not married,House / apartment,-11042,-3174,1,0,0,0,Core staff,1.0,-28,0
9435,5009391,M,N,N,0,279000.0,State servant,Higher education,Single / not married,House / apartment,-11042,-3174,1,0,0,0,Core staff,1.0,-29,0
9436,5009391,M,N,N,0,279000.0,State servant,Higher education,Single / not married,House / apartment,-11042,-3174,1,0,0,0,Core staff,1.0,-30,0
9437,5009391,M,N,N,0,279000.0,State servant,Higher education,Single / not married,House / apartment,-11042,-3174,1,0,0,0,Core staff,1.0,-31,0
9438,5009391,M,N,N,0,279000.0,State servant,Higher education,Single / not married,House / apartment,-11042,-3174,1,0,0,0,Core staff,1.0,-32,0
9439,5009391,M,N,N,0,279000.0,State servant,Higher education,Single / not married,House / apartment,-11042,-3174,1,0,0,0,Core staff,1.0,-33,0
9440,5009391,M,N,N,0,279000.0,State servant,Higher education,Single / not married,House / apartment,-11042,-3174,1,0,0,0,Core staff,1.0,-34,0
9441,5009392,M,N,N,0,279000.0,State servant,Higher education,Single / not married,House / apartment,-11042,-3174,1,0,0,0,Core staff,1.0,-13,X
9442,5009392,M,N,N,0,279000.0,State servant,Higher education,Single / not married,House / apartment,-11042,-3174,1,0,0,0,Core staff,1.0,-14,0
9443,5009392,M,N,N,0,279000.0,State servant,Higher education,Single / not married,House / apartment,-11042,-3174,1,0,0,0,Core staff,1.0,-15,0
9444,5009392,M,N,N,0,279000.0,State servant,Higher education,Single / not married,House / apartment,-11042,-3174,1,0,0,0,Core staff,1.0,-16,0
9445,5009392,M,N,N,0,279000.0,State servant,Higher education,Single / not married,House / apartment,-11042,-3174,1,0,0,0,Core staff,1.0,-17,0
9446,5009392,M,N,N,0,279000.0,State servant,Higher education,Single / not married,House / apartment,-11042,-3174,1,0,0,0,Core staff,1.0,-18,0
9447,5009392,M,N,N,0,279000.0,State servant,Higher education,Single / not married,House / apartment,-11042,-3174,1,0,0,0,Core staff,1.0,-19,0
9448,5009392,M,N,N,0,279000.0,State servant,Higher education,Single / not married,House / apartment,-11042,-3174,1,0,0,0,Core staff,1.0,-20,0
9449,5009392,M,N,N,0,279000.0,State servant,Higher education,Single / not married,House / apartment,-11042,-3174,1,0,0,0,Core staff,1.0,-21,0
9450,5009392,M,N,N,0,279000.0,State servant,Higher education,Single / not married,House / apartment,-11042,-3174,1,0,0,0,Core staff,1.0,-22,0
9451,5009392,M,N,N,0,279000.0,State servant,Higher education,Single / not married,House / apartment,-11042,-3174,1,0,0,0,Core staff,1.0,-23,0
9452,5009392,M,N,N,0,279000.0,State servant,Higher education,Single / not married,House / apartment,-11042,-3174,1,0,0,0,Core staff,1.0,-24,0
9453,5009392,M,N,N,0,279000.0,State servant,Higher education,Single / not married,House / apartment,-11042,-3174,1,0,0,0,Core staff,1.0,-25,0
9454,5009392,M,N,N,0,279000.0,State servant,Higher education,Single / not married,House / apartment,-11042,-3174,1,0,0,0,Core staff,1.0,-26,0
9455,5009392,M,N,N,0,279000.0,State servant,Higher education,Single / not married,House / apartment,-11042,-3174,1,0,0,0,Core staff,1.0,-27,0
9456,5009392,M,N,N,0,279000.0,State servant,Higher education,Single / not married,House / apartment,-11042,-3174,1,0,0,0,Core staff,1.0,-28,0
9457,5009392,M,N,N,0,279000.0,State servant,Higher education,Single / not married,House / apartment,-11042,-3174,1,0,0,0,Core staff,1.0,-29,0
9458,5009392,M,N,N,0,279000.0,State servant,Higher education,Single / not married,House / apartment,-11042,-3174,1,0,0,0,Core staff,1.0,-30,0
9459,5009392,M,N,N,0,279000.0,State servant,Higher education,Single / not married,House / apartment,-11042,-3174,1,0,0,0,Core staff,1.0,-31,0
9460,5009392,M,N,N,0,279000.0,State servant,Higher education,Single / not married,House / apartment,-11042,-3174,1,0,0,0,Core staff,1.0,-32,0
9461,5009392,M,N,N,0,279000.0,State servant,Higher education,Single / not married,House / apartment,-11042,-3174,1,0,0,0,Core staff,1.0,-33,X
9462,5009392,M,N,N,0,279000.0,State servant,Higher education,Single / not married,House / apartment,-11042,-3174,1,0,0,0,Core staff,1.0,-34,X
9463,5009392,M,N,N,0,279000.0,State servant,Higher education,Single / not married,House / apartment,-11042,-3174,1,0,0,0,Core staff,1.0,-35,X
9464,5009392,M,N,N,0,279000.0,State servant,Higher education,Single / not married,House / apartment,-11042,-3174,1,0,0,0,Core staff,1.0,-36,X
9465,5009392,M,N,N,0,279000.0,State servant,Higher education,Single / not married,House / apartment,-11042,-3174,1,0,0,0,Core staff,1.0,-37,X
9466,5009392,M,N,N,0,279000.0,State servant,Higher education,Single / not married,House / apartment,-11042,-3174,1,0,0,0,Core staff,1.0,-38,X
9467,5009392,M,N,N,0,279000.0,State servant,Higher education,Single / not married,House / apartment,-11042,-3174,1,0,0,0,Core staff,1.0,-39,X
9468,5009392,M,N,N,0,279000.0,State servant,Higher education,Single / not married,House / apartment,-11042,-3174,1,0,0,0,Core staff,1.0,-40,X
9469,5009392,M,N,N,0,279000.0,State servant,Higher education,Single / not married,House / apartment,-11042,-3174,1,0,0,0,Core staff,1.0,-41,X
9470,5009392,M,N,N,0,279000.0,State servant,Higher education,Single / not married,House / apartment,-11042,-3174,1,0,0,0,Core staff,1.0,-42,X
9471,5009392,M,N,N,0,279000.0,State servant,Higher education,Single / not married,House / apartment,-11042,-3174,1,0,0,0,Core staff,1.0,-43,X
9472,5009392,M,N,N,0,279000.0,State servant,Higher education,Single / not married,House / apartment,-11042,-3174,1,0,0,0,Core staff,1.0,-44,X
9473,5009392,M,N,N,0,279000.0,State servant,Higher education,Single / not married,House / apartment,-11042,-3174,1,0,0,0,Core staff,1.0,-45,X
9474,5009392,M,N,N,0,279000.0,State servant,Higher education,Single / not married,House / apartment,-11042,-3174,1,0,0,0,Core staff,1.0,-46,X
9475,5009392,M,N,N,0,279000.0,State servant,Higher education,Single / not married,House / apartment,-11042,-3174,1,0,0,0,Core staff,1.0,-47,X
9476,5009392,M,N,N,0,279000.0,State servant,Higher education,Single / not married,House / apartment,-11042,-3174,1,0,0,0,Core staff,1.0,-48,X
9477,5009393,M,N,N,0,279000.0,State servant,Higher education,Single / not married,House / apartment,-11042,-3174,1,0,0,0,Core staff,1.0,0,C
9478,5009393,M,N,N,0,279000.0,State servant,Higher education,Single / not married,House / apartment,-11042,-3174,1,0,0,0,Core staff,1.0,-1,C
9479,5009393,M,N,N,0,279000.0,State servant,Higher education,Single / not married,House / apartment,-11042,-3174,1,0,0,0,Core staff,1.0,-2,C
9480,5009393,M,N,N,0,279000.0,State servant,Higher education,Single / not married,House / apartment,-11042,-3174,1,0,0,0,Core staff,1.0,-3,C
9481,5009393,M,N,N,0,279000.0,State servant,Higher education,Single / not married,House / apartment,-11042,-3174,1,0,0,0,Core staff,1.0,-4,C
9482,5009393,M,N,N,0,279000.0,State servant,Higher education,Single / not married,House / apartment,-11042,-3174,1,0,0,0,Core staff,1.0,-5,C
9483,5009393,M,N,N,0,279000.0,State servant,Higher education,Single / not married,House / apartment,-11042,-3174,1,0,0,0,Core staff,1.0,-6,C
9484,5009393,M,N,N,0,279000.0,State servant,Higher education,Single / not married,House / apartment,-11042,-3174,1,0,0,0,Core staff,1.0,-7,C
9485,5009393,M,N,N,0,279000.0,State servant,Higher education,Single / not married,House / apartment,-11042,-3174,1,0,0,0,Core staff,1.0,-8,C
9486,5009393,M,N,N,0,279000.0,State servant,Higher education,Single / not married,House / apartment,-11042,-3174,1,0,0,0,Core staff,1.0,-9,C
9487,5009393,M,N,N,0,279000.0,State servant,Higher education,Single / not married,House / apartment,-11042,-3174,1,0,0,0,Core staff,1.0,-10,C
9488,5009393,M,N,N,0,279000.0,State servant,Higher education,Single / not married,House / apartment,-11042,-3174,1,0,0,0,Core staff,1.0,-11,C
9489,5009393,M,N,N,0,279000.0,State servant,Higher education,Single / not married,House / apartment,-11042,-3174,1,0,0,0,Core staff,1.0,-12,C
9490,5009393,M,N,N,0,279000.0,State servant,Higher education,Single / not married,House / apartment,-11042,-3174,1,0,0,0,Core staff,1.0,-13,C
9491,5009393,M,N,N,0,279000.0,State servant,Higher education,Single / not married,House / apartment,-11042,-3174,1,0,0,0,Core staff,1.0,-14,C
9492,5009393,M,N,N,0,279000.0,State servant,Higher education,Single / not married,House / apartment,-11042,-3174,1,0,0,0,Core staff,1.0,-15,C
9493,5009393,M,N,N,0,279000.0,State servant,Higher education,Single / not married,House / apartment,-11042,-3174,1,0,0,0,Core staff,1.0,-16,C
9494,5009393,M,N,N,0,279000.0,State servant,Higher education,Single / not married,House / apartment,-11042,-3174,1,0,0,0,Core staff,1.0,-17,C
9495,5009393,M,N,N,0,279000.0,State servant,Higher education,Single / not married,House / apartment,-11042,-3174,1,0,0,0,Core staff,1.0,-18,C
9496,5009393,M,N,N,0,279000.0,State servant,Higher education,Single / not married,House / apartment,-11042,-3174,1,0,0,0,Core staff,1.0,-19,C
9497,5009393,M,N,N,0,279000.0,State servant,Higher education,Single / not married,House / apartment,-11042,-3174,1,0,0,0,Core staff,1.0,-20,C
9498,5009393,M,N,N,0,279000.0,State servant,Higher education,Single / not married,House / apartment,-11042,-3174,1,0,0,0,Core staff,1.0,-21,C
9499,5009393,M,N,N,0,279000.0,State servant,Higher education,Single / not married,House / apartment,-11042,-3174,1,0,0,0,Core staff,1.0,-22,C
9500,5009393,M,N,N,0,279000.0,State servant,Higher education,Single / not married,House / apartment,-11042,-3174,1,0,0,0,Core staff,1.0,-23,C
9501,5009393,M,N,N,0,279000.0,State servant,Higher education,Single / not married,House / apartment,-11042,-3174,1,0,0,0,Core staff,1.0,-24,C
9502,5009393,M,N,N,0,279000.0,State servant,Higher education,Single / not married,House / apartment,-11042,-3174,1,0,0,0,Core staff,1.0,-25,C
9503,5009393,M,N,N,0,279000.0,State servant,Higher education,Single / not married,House / apartment,-11042,-3174,1,0,0,0,Core staff,1.0,-26,C
9504,5009393,M,N,N,0,279000.0,State servant,Higher education,Single / not married,House / apartment,-11042,-3174,1,0,0,0,Core staff,1.0,-27,C
9505,5009393,M,N,N,0,279000.0,State servant,Higher education,Single / not married,House / apartment,-11042,-3174,1,0,0,0,Core staff,1.0,-28,0
9506,5009393,M,N,N,0,279000.0,State servant,Higher education,Single / not married,House / apartment,-11042,-3174,1,0,0,0,Core staff,1.0,-29,0
9507,5009393,M,N,N,0,279000.0,State servant,Higher education,Single / not married,House / apartment,-11042,-3174,1,0,0,0,Core staff,1.0,-30,0
9508,5009393,M,N,N,0,279000.0,State servant,Higher education,Single / not married,House / apartment,-11042,-3174,1,0,0,0,Core staff,1.0,-31,X
9509,5009394,M,N,N,0,279000.0,State servant,Higher education,Single / not married,House / apartment,-11042,-3174,1,0,0,0,Core staff,1.0,0,0
9510,5009394,M,N,N,0,279000.0,State servant,Higher education,Single / not married,House / apartment,-11042,-3174,1,0,0,0,Core staff,1.0,-1,0
9511,5009394,M,N,N,0,279000.0,State servant,Higher education,Single / not married,House / apartment,-11042,-3174,1,0,0,0,Core staff,1.0,-2,1
9512,5009394,M,N,N,0,279000.0,State servant,Higher education,Single / not married,House / apartment,-11042,-3174,1,0,0,0,Core staff,1.0,-3,0
9513,5009394,M,N,N,0,279000.0,State servant,Higher education,Single / not married,House / apartment,-11042,-3174,1,0,0,0,Core staff,1.0,-4,0
9514,5009394,M,N,N,0,279000.0,State servant,Higher education,Single / not married,House / apartment,-11042,-3174,1,0,0,0,Core staff,1.0,-5,0
9515,5009394,M,N,N,0,279000.0,State servant,Higher education,Single / not married,House / apartment,-11042,-3174,1,0,0,0,Core staff,1.0,-6,0
9516,5009394,M,N,N,0,279000.0,State servant,Higher education,Single / not married,House / apartment,-11042,-3174,1,0,0,0,Core staff,1.0,-7,0
9517,5009394,M,N,N,0,279000.0,State servant,Higher education,Single / not married,House / apartment,-11042,-3174,1,0,0,0,Core staff,1.0,-8,0
9518,5009394,M,N,N,0,279000.0,State servant,Higher education,Single / not married,House / apartment,-11042,-3174,1,0,0,0,Core staff,1.0,-9,0
9519,5009394,M,N,N,0,279000.0,State servant,Higher education,Single / not married,House / apartment,-11042,-3174,1,0,0,0,Core staff,1.0,-10,0
9520,5009394,M,N,N,0,279000.0,State servant,Higher education,Single / not married,House / apartment,-11042,-3174,1,0,0,0,Core staff,1.0,-11,0
9521,5009395,M,N,N,0,279000.0,State servant,Higher education,Single / not married,House / apartment,-11042,-3174,1,0,0,0,Core staff,1.0,0,0
9522,5009395,M,N,N,0,279000.0,State servant,Higher education,Single / not married,House / apartment,-11042,-3174,1,0,0,0,Core staff,1.0,-1,0
9523,5009395,M,N,N,0,279000.0,State servant,Higher education,Single / not married,House / apartment,-11042,-3174,1,0,0,0,Core staff,1.0,-2,0
9524,5009395,M,N,N,0,279000.0,State servant,Higher education,Single / not married,House / apartment,-11042,-3174,1,0,0,0,Core staff,1.0,-3,0
9525,5009395,M,N,N,0,279000.0,State servant,Higher education,Single / not married,House / apartment,-11042,-3174,1,0,0,0,Core staff,1.0,-4,0
9526,5009395,M,N,N,0,279000.0,State servant,Higher education,Single / not married,House / apartment,-11042,-3174,1,0,0,0,Core staff,1.0,-5,X
9527,5009396,F,N,N,1,76500.0,Working,Higher education,Civil marriage,House / apartment,-12506,-495,1,1,0,0,Accountants,3.0,0,C
9528,5009396,F,N,N,1,76500.0,Working,Higher education,Civil marriage,House / apartment,-12506,-495,1,1,0,0,Accountants,3.0,-1,C
9529,5009396,F,N,N,1,76500.0,Working,Higher education,Civil marriage,House / apartment,-12506,-495,1,1,0,0,Accountants,3.0,-2,C
9530,5009396,F,N,N,1,76500.0,Working,Higher education,Civil marriage,House / apartment,-12506,-495,1,1,0,0,Accountants,3.0,-3,C
9531,5009396,F,N,N,1,76500.0,Working,Higher education,Civil marriage,House / apartment,-12506,-495,1,1,0,0,Accountants,3.0,-4,C
9532,5009396,F,N,N,1,76500.0,Working,Higher education,Civil marriage,House / apartment,-12506,-495,1,1,0,0,Accountants,3.0,-5,C
9533,5009396,F,N,N,1,76500.0,Working,Higher education,Civil marriage,House / apartment,-12506,-495,1,1,0,0,Accountants,3.0,-6,C
9534,5009396,F,N,N,1,76500.0,Working,Higher education,Civil marriage,House / apartment,-12506,-495,1,1,0,0,Accountants,3.0,-7,C
9535,5009396,F,N,N,1,76500.0,Working,Higher education,Civil marriage,House / apartment,-12506,-495,1,1,0,0,Accountants,3.0,-8,C
9536,5009396,F,N,N,1,76500.0,Working,Higher education,Civil marriage,House / apartment,-12506,-495,1,1,0,0,Accountants,3.0,-9,C
9537,5009396,F,N,N,1,76500.0,Working,Higher education,Civil marriage,House / apartment,-12506,-495,1,1,0,0,Accountants,3.0,-10,C
9538,5009396,F,N,N,1,76500.0,Working,Higher education,Civil marriage,House / apartment,-12506,-495,1,1,0,0,Accountants,3.0,-11,C
9539,5009396,F,N,N,1,76500.0,Working,Higher education,Civil marriage,House / apartment,-12506,-495,1,1,0,0,Accountants,3.0,-12,C
9540,5009396,F,N,N,1,76500.0,Working,Higher education,Civil marriage,House / apartment,-12506,-495,1,1,0,0,Accountants,3.0,-13,C
9541,5009396,F,N,N,1,76500.0,Working,Higher education,Civil marriage,House / apartment,-12506,-495,1,1,0,0,Accountants,3.0,-14,C
9542,5009396,F,N,N,1,76500.0,Working,Higher education,Civil marriage,House / apartment,-12506,-495,1,1,0,0,Accountants,3.0,-15,C
9543,5009396,F,N,N,1,76500.0,Working,Higher education,Civil marriage,House / apartment,-12506,-495,1,1,0,0,Accountants,3.0,-16,C
9544,5009396,F,N,N,1,76500.0,Working,Higher education,Civil marriage,House / apartment,-12506,-495,1,1,0,0,Accountants,3.0,-17,C
9545,5009396,F,N,N,1,76500.0,Working,Higher education,Civil marriage,House / apartment,-12506,-495,1,1,0,0,Accountants,3.0,-18,C
9546,5009396,F,N,N,1,76500.0,Working,Higher education,Civil marriage,House / apartment,-12506,-495,1,1,0,0,Accountants,3.0,-19,C
9547,5009396,F,N,N,1,76500.0,Working,Higher education,Civil marriage,House / apartment,-12506,-495,1,1,0,0,Accountants,3.0,-20,C
9548,5009396,F,N,N,1,76500.0,Working,Higher education,Civil marriage,House / apartment,-12506,-495,1,1,0,0,Accountants,3.0,-21,C
9549,5009396,F,N,N,1,76500.0,Working,Higher education,Civil marriage,House / apartment,-12506,-495,1,1,0,0,Accountants,3.0,-22,C
9550,5009396,F,N,N,1,76500.0,Working,Higher education,Civil marriage,House / apartment,-12506,-495,1,1,0,0,Accountants,3.0,-23,C
9551,5009396,F,N,N,1,76500.0,Working,Higher education,Civil marriage,House / apartment,-12506,-495,1,1,0,0,Accountants,3.0,-24,C
9552,5009396,F,N,N,1,76500.0,Working,Higher education,Civil marriage,House / apartment,-12506,-495,1,1,0,0,Accountants,3.0,-25,C
9553,5009396,F,N,N,1,76500.0,Working,Higher education,Civil marriage,House / apartment,-12506,-495,1,1,0,0,Accountants,3.0,-26,C
9554,5009396,F,N,N,1,76500.0,Working,Higher education,Civil marriage,House / apartment,-12506,-495,1,1,0,0,Accountants,3.0,-27,C
9555,5009396,F,N,N,1,76500.0,Working,Higher education,Civil marriage,House / apartment,-12506,-495,1,1,0,0,Accountants,3.0,-28,C
9556,5009396,F,N,N,1,76500.0,Working,Higher education,Civil marriage,House / apartment,-12506,-495,1,1,0,0,Accountants,3.0,-29,C
9557,5009396,F,N,N,1,76500.0,Working,Higher education,Civil marriage,House / apartment,-12506,-495,1,1,0,0,Accountants,3.0,-30,C
9558,5009396,F,N,N,1,76500.0,Working,Higher education,Civil marriage,House / apartment,-12506,-495,1,1,0,0,Accountants,3.0,-31,C
9559,5009396,F,N,N,1,76500.0,Working,Higher education,Civil marriage,House / apartment,-12506,-495,1,1,0,0,Accountants,3.0,-32,C
9560,5009396,F,N,N,1,76500.0,Working,Higher education,Civil marriage,House / apartment,-12506,-495,1,1,0,0,Accountants,3.0,-33,C
9561,5009396,F,N,N,1,76500.0,Working,Higher education,Civil marriage,House / apartment,-12506,-495,1,1,0,0,Accountants,3.0,-34,C
9562,5009396,F,N,N,1,76500.0,Working,Higher education,Civil marriage,House / apartment,-12506,-495,1,1,0,0,Accountants,3.0,-35,C
9563,5009396,F,N,N,1,76500.0,Working,Higher education,Civil marriage,House / apartment,-12506,-495,1,1,0,0,Accountants,3.0,-36,C
9564,5009396,F,N,N,1,76500.0,Working,Higher education,Civil marriage,House / apartment,-12506,-495,1,1,0,0,Accountants,3.0,-37,C
9565,5009396,F,N,N,1,76500.0,Working,Higher education,Civil marriage,House / apartment,-12506,-495,1,1,0,0,Accountants,3.0,-38,C
9566,5009396,F,N,N,1,76500.0,Working,Higher education,Civil marriage,House / apartment,-12506,-495,1,1,0,0,Accountants,3.0,-39,C
9567,5009396,F,N,N,1,76500.0,Working,Higher education,Civil marriage,House / apartment,-12506,-495,1,1,0,0,Accountants,3.0,-40,C
9568,5009396,F,N,N,1,76500.0,Working,Higher education,Civil marriage,House / apartment,-12506,-495,1,1,0,0,Accountants,3.0,-41,C
9569,5009396,F,N,N,1,76500.0,Working,Higher education,Civil marriage,House / apartment,-12506,-495,1,1,0,0,Accountants,3.0,-42,C
9570,5009396,F,N,N,1,76500.0,Working,Higher education,Civil marriage,House / apartment,-12506,-495,1,1,0,0,Accountants,3.0,-43,C
9571,5009396,F,N,N,1,76500.0,Working,Higher education,Civil marriage,House / apartment,-12506,-495,1,1,0,0,Accountants,3.0,-44,C
9572,5009396,F,N,N,1,76500.0,Working,Higher education,Civil marriage,House / apartment,-12506,-495,1,1,0,0,Accountants,3.0,-45,C
9573,5009396,F,N,N,1,76500.0,Working,Higher education,Civil marriage,House / apartment,-12506,-495,1,1,0,0,Accountants,3.0,-46,C
9574,5009396,F,N,N,1,76500.0,Working,Higher education,Civil marriage,House / apartment,-12506,-495,1,1,0,0,Accountants,3.0,-47,C
9575,5009396,F,N,N,1,76500.0,Working,Higher education,Civil marriage,House / apartment,-12506,-495,1,1,0,0,Accountants,3.0,-48,C
9576,5009396,F,N,N,1,76500.0,Working,Higher education,Civil marriage,House / apartment,-12506,-495,1,1,0,0,Accountants,3.0,-49,C
9577,5009396,F,N,N,1,76500.0,Working,Higher education,Civil marriage,House / apartment,-12506,-495,1,1,0,0,Accountants,3.0,-50,C
9578,5009396,F,N,N,1,76500.0,Working,Higher education,Civil marriage,House / apartment,-12506,-495,1,1,0,0,Accountants,3.0,-51,C
9579,5009396,F,N,N,1,76500.0,Working,Higher education,Civil marriage,House / apartment,-12506,-495,1,1,0,0,Accountants,3.0,-52,0
9580,5009396,F,N,N,1,76500.0,Working,Higher education,Civil marriage,House / apartment,-12506,-495,1,1,0,0,Accountants,3.0,-53,0
9581,5009396,F,N,N,1,76500.0,Working,Higher education,Civil marriage,House / apartment,-12506,-495,1,1,0,0,Accountants,3.0,-54,0
9582,5009396,F,N,N,1,76500.0,Working,Higher education,Civil marriage,House / apartment,-12506,-495,1,1,0,0,Accountants,3.0,-55,0
9583,5009397,F,N,N,1,76500.0,Working,Higher education,Civil marriage,House / apartment,-12506,-495,1,1,0,0,Accountants,3.0,0,C
9584,5009397,F,N,N,1,76500.0,Working,Higher education,Civil marriage,House / apartment,-12506,-495,1,1,0,0,Accountants,3.0,-1,C
9585,5009397,F,N,N,1,76500.0,Working,Higher education,Civil marriage,House / apartment,-12506,-495,1,1,0,0,Accountants,3.0,-2,C
9586,5009397,F,N,N,1,76500.0,Working,Higher education,Civil marriage,House / apartment,-12506,-495,1,1,0,0,Accountants,3.0,-3,C
9587,5009397,F,N,N,1,76500.0,Working,Higher education,Civil marriage,House / apartment,-12506,-495,1,1,0,0,Accountants,3.0,-4,C
9588,5009397,F,N,N,1,76500.0,Working,Higher education,Civil marriage,House / apartment,-12506,-495,1,1,0,0,Accountants,3.0,-5,C
9589,5009397,F,N,N,1,76500.0,Working,Higher education,Civil marriage,House / apartment,-12506,-495,1,1,0,0,Accountants,3.0,-6,C
9590,5009397,F,N,N,1,76500.0,Working,Higher education,Civil marriage,House / apartment,-12506,-495,1,1,0,0,Accountants,3.0,-7,C
9591,5009397,F,N,N,1,76500.0,Working,Higher education,Civil marriage,House / apartment,-12506,-495,1,1,0,0,Accountants,3.0,-8,C
9592,5009397,F,N,N,1,76500.0,Working,Higher education,Civil marriage,House / apartment,-12506,-495,1,1,0,0,Accountants,3.0,-9,C
9593,5009397,F,N,N,1,76500.0,Working,Higher education,Civil marriage,House / apartment,-12506,-495,1,1,0,0,Accountants,3.0,-10,C
9594,5009397,F,N,N,1,76500.0,Working,Higher education,Civil marriage,House / apartment,-12506,-495,1,1,0,0,Accountants,3.0,-11,C
9595,5009397,F,N,N,1,76500.0,Working,Higher education,Civil marriage,House / apartment,-12506,-495,1,1,0,0,Accountants,3.0,-12,C
9596,5009397,F,N,N,1,76500.0,Working,Higher education,Civil marriage,House / apartment,-12506,-495,1,1,0,0,Accountants,3.0,-13,C
9597,5009397,F,N,N,1,76500.0,Working,Higher education,Civil marriage,House / apartment,-12506,-495,1,1,0,0,Accountants,3.0,-14,C
9598,5009397,F,N,N,1,76500.0,Working,Higher education,Civil marriage,House / apartment,-12506,-495,1,1,0,0,Accountants,3.0,-15,C
9599,5009397,F,N,N,1,76500.0,Working,Higher education,Civil marriage,House / apartment,-12506,-495,1,1,0,0,Accountants,3.0,-16,C
9600,5009397,F,N,N,1,76500.0,Working,Higher education,Civil marriage,House / apartment,-12506,-495,1,1,0,0,Accountants,3.0,-17,C
9601,5009397,F,N,N,1,76500.0,Working,Higher education,Civil marriage,House / apartment,-12506,-495,1,1,0,0,Accountants,3.0,-18,C
9602,5009397,F,N,N,1,76500.0,Working,Higher education,Civil marriage,House / apartment,-12506,-495,1,1,0,0,Accountants,3.0,-19,C
9603,5009397,F,N,N,1,76500.0,Working,Higher education,Civil marriage,House / apartment,-12506,-495,1,1,0,0,Accountants,3.0,-20,C
9604,5009397,F,N,N,1,76500.0,Working,Higher education,Civil marriage,House / apartment,-12506,-495,1,1,0,0,Accountants,3.0,-21,C
9605,5009397,F,N,N,1,76500.0,Working,Higher education,Civil marriage,House / apartment,-12506,-495,1,1,0,0,Accountants,3.0,-22,C
9606,5009397,F,N,N,1,76500.0,Working,Higher education,Civil marriage,House / apartment,-12506,-495,1,1,0,0,Accountants,3.0,-23,C
9607,5009397,F,N,N,1,76500.0,Working,Higher education,Civil marriage,House / apartment,-12506,-495,1,1,0,0,Accountants,3.0,-24,C
9608,5009397,F,N,N,1,76500.0,Working,Higher education,Civil marriage,House / apartment,-12506,-495,1,1,0,0,Accountants,3.0,-25,C
9609,5009397,F,N,N,1,76500.0,Working,Higher education,Civil marriage,House / apartment,-12506,-495,1,1,0,0,Accountants,3.0,-26,C
9610,5009397,F,N,N,1,76500.0,Working,Higher education,Civil marriage,House / apartment,-12506,-495,1,1,0,0,Accountants,3.0,-27,C
9611,5009397,F,N,N,1,76500.0,Working,Higher education,Civil marriage,House / apartment,-12506,-495,1,1,0,0,Accountants,3.0,-28,C
9612,5009397,F,N,N,1,76500.0,Working,Higher education,Civil marriage,House / apartment,-12506,-495,1,1,0,0,Accountants,3.0,-29,C
9613,5009397,F,N,N,1,76500.0,Working,Higher education,Civil marriage,House / apartment,-12506,-495,1,1,0,0,Accountants,3.0,-30,C
9614,5009397,F,N,N,1,76500.0,Working,Higher education,Civil marriage,House / apartment,-12506,-495,1,1,0,0,Accountants,3.0,-31,C
9615,5009397,F,N,N,1,76500.0,Working,Higher education,Civil marriage,House / apartment,-12506,-495,1,1,0,0,Accountants,3.0,-32,C
9616,5009397,F,N,N,1,76500.0,Working,Higher education,Civil marriage,House / apartment,-12506,-495,1,1,0,0,Accountants,3.0,-33,C
9617,5009397,F,N,N,1,76500.0,Working,Higher education,Civil marriage,House / apartment,-12506,-495,1,1,0,0,Accountants,3.0,-34,C
9618,5009397,F,N,N,1,76500.0,Working,Higher education,Civil marriage,House / apartment,-12506,-495,1,1,0,0,Accountants,3.0,-35,C
9619,5009397,F,N,N,1,76500.0,Working,Higher education,Civil marriage,House / apartment,-12506,-495,1,1,0,0,Accountants,3.0,-36,C
9620,5009397,F,N,N,1,76500.0,Working,Higher education,Civil marriage,House / apartment,-12506,-495,1,1,0,0,Accountants,3.0,-37,C
9621,5009397,F,N,N,1,76500.0,Working,Higher education,Civil marriage,House / apartment,-12506,-495,1,1,0,0,Accountants,3.0,-38,C
9622,5009397,F,N,N,1,76500.0,Working,Higher education,Civil marriage,House / apartment,-12506,-495,1,1,0,0,Accountants,3.0,-39,C
9623,5009397,F,N,N,1,76500.0,Working,Higher education,Civil marriage,House / apartment,-12506,-495,1,1,0,0,Accountants,3.0,-40,C
9624,5009397,F,N,N,1,76500.0,Working,Higher education,Civil marriage,House / apartment,-12506,-495,1,1,0,0,Accountants,3.0,-41,C
9625,5009397,F,N,N,1,76500.0,Working,Higher education,Civil marriage,House / apartment,-12506,-495,1,1,0,0,Accountants,3.0,-42,C
9626,5009397,F,N,N,1,76500.0,Working,Higher education,Civil marriage,House / apartment,-12506,-495,1,1,0,0,Accountants,3.0,-43,C
9627,5009397,F,N,N,1,76500.0,Working,Higher education,Civil marriage,House / apartment,-12506,-495,1,1,0,0,Accountants,3.0,-44,C
9628,5009397,F,N,N,1,76500.0,Working,Higher education,Civil marriage,House / apartment,-12506,-495,1,1,0,0,Accountants,3.0,-45,C
9629,5009397,F,N,N,1,76500.0,Working,Higher education,Civil marriage,House / apartment,-12506,-495,1,1,0,0,Accountants,3.0,-46,C
9630,5009397,F,N,N,1,76500.0,Working,Higher education,Civil marriage,House / apartment,-12506,-495,1,1,0,0,Accountants,3.0,-47,C
9631,5009397,F,N,N,1,76500.0,Working,Higher education,Civil marriage,House / apartment,-12506,-495,1,1,0,0,Accountants,3.0,-48,C
9632,5009397,F,N,N,1,76500.0,Working,Higher education,Civil marriage,House / apartment,-12506,-495,1,1,0,0,Accountants,3.0,-49,C
9633,5009397,F,N,N,1,76500.0,Working,Higher education,Civil marriage,House / apartment,-12506,-495,1,1,0,0,Accountants,3.0,-50,C
9634,5009397,F,N,N,1,76500.0,Working,Higher education,Civil marriage,House / apartment,-12506,-495,1,1,0,0,Accountants,3.0,-51,C
9635,5009397,F,N,N,1,76500.0,Working,Higher education,Civil marriage,House / apartment,-12506,-495,1,1,0,0,Accountants,3.0,-52,C
9636,5009397,F,N,N,1,76500.0,Working,Higher education,Civil marriage,House / apartment,-12506,-495,1,1,0,0,Accountants,3.0,-53,C
9637,5009397,F,N,N,1,76500.0,Working,Higher education,Civil marriage,House / apartment,-12506,-495,1,1,0,0,Accountants,3.0,-54,C
9638,5009397,F,N,N,1,76500.0,Working,Higher education,Civil marriage,House / apartment,-12506,-495,1,1,0,0,Accountants,3.0,-55,0
9639,5009397,F,N,N,1,76500.0,Working,Higher education,Civil marriage,House / apartment,-12506,-495,1,1,0,0,Accountants,3.0,-56,0
9640,5009397,F,N,N,1,76500.0,Working,Higher education,Civil marriage,House / apartment,-12506,-495,1,1,0,0,Accountants,3.0,-57,0
9641,5009397,F,N,N,1,76500.0,Working,Higher education,Civil marriage,House / apartment,-12506,-495,1,1,0,0,Accountants,3.0,-58,0
9642,5009398,F,N,N,1,76500.0,Working,Higher education,Civil marriage,House / apartment,-12506,-495,1,1,0,0,Accountants,3.0,-22,C
9643,5009398,F,N,N,1,76500.0,Working,Higher education,Civil marriage,House / apartment,-12506,-495,1,1,0,0,Accountants,3.0,-23,C
9644,5009398,F,N,N,1,76500.0,Working,Higher education,Civil marriage,House / apartment,-12506,-495,1,1,0,0,Accountants,3.0,-24,C
9645,5009398,F,N,N,1,76500.0,Working,Higher education,Civil marriage,House / apartment,-12506,-495,1,1,0,0,Accountants,3.0,-25,C
9646,5009398,F,N,N,1,76500.0,Working,Higher education,Civil marriage,House / apartment,-12506,-495,1,1,0,0,Accountants,3.0,-26,C
9647,5009398,F,N,N,1,76500.0,Working,Higher education,Civil marriage,House / apartment,-12506,-495,1,1,0,0,Accountants,3.0,-27,C
9648,5009398,F,N,N,1,76500.0,Working,Higher education,Civil marriage,House / apartment,-12506,-495,1,1,0,0,Accountants,3.0,-28,C
9649,5009398,F,N,N,1,76500.0,Working,Higher education,Civil marriage,House / apartment,-12506,-495,1,1,0,0,Accountants,3.0,-29,C
9650,5009398,F,N,N,1,76500.0,Working,Higher education,Civil marriage,House / apartment,-12506,-495,1,1,0,0,Accountants,3.0,-30,C
9651,5009398,F,N,N,1,76500.0,Working,Higher education,Civil marriage,House / apartment,-12506,-495,1,1,0,0,Accountants,3.0,-31,C
9652,5009398,F,N,N,1,76500.0,Working,Higher education,Civil marriage,House / apartment,-12506,-495,1,1,0,0,Accountants,3.0,-32,C
9653,5009398,F,N,N,1,76500.0,Working,Higher education,Civil marriage,House / apartment,-12506,-495,1,1,0,0,Accountants,3.0,-33,C
9654,5009398,F,N,N,1,76500.0,Working,Higher education,Civil marriage,House / apartment,-12506,-495,1,1,0,0,Accountants,3.0,-34,C
9655,5009398,F,N,N,1,76500.0,Working,Higher education,Civil marriage,House / apartment,-12506,-495,1,1,0,0,Accountants,3.0,-35,C
9656,5009398,F,N,N,1,76500.0,Working,Higher education,Civil marriage,House / apartment,-12506,-495,1,1,0,0,Accountants,3.0,-36,C
9657,5009398,F,N,N,1,76500.0,Working,Higher education,Civil marriage,House / apartment,-12506,-495,1,1,0,0,Accountants,3.0,-37,C
9658,5009398,F,N,N,1,76500.0,Working,Higher education,Civil marriage,House / apartment,-12506,-495,1,1,0,0,Accountants,3.0,-38,C
9659,5009398,F,N,N,1,76500.0,Working,Higher education,Civil marriage,House / apartment,-12506,-495,1,1,0,0,Accountants,3.0,-39,C
9660,5009398,F,N,N,1,76500.0,Working,Higher education,Civil marriage,House / apartment,-12506,-495,1,1,0,0,Accountants,3.0,-40,0
9661,5009398,F,N,N,1,76500.0,Working,Higher education,Civil marriage,House / apartment,-12506,-495,1,1,0,0,Accountants,3.0,-41,0
9662,5009398,F,N,N,1,76500.0,Working,Higher education,Civil marriage,House / apartment,-12506,-495,1,1,0,0,Accountants,3.0,-42,0
9663,5009398,F,N,N,1,76500.0,Working,Higher education,Civil marriage,House / apartment,-12506,-495,1,1,0,0,Accountants,3.0,-43,0
9664,5009398,F,N,N,1,76500.0,Working,Higher education,Civil marriage,House / apartment,-12506,-495,1,1,0,0,Accountants,3.0,-44,0
9665,5009398,F,N,N,1,76500.0,Working,Higher education,Civil marriage,House / apartment,-12506,-495,1,1,0,0,Accountants,3.0,-45,0
9666,5009398,F,N,N,1,76500.0,Working,Higher education,Civil marriage,House / apartment,-12506,-495,1,1,0,0,Accountants,3.0,-46,0
9667,5009398,F,N,N,1,76500.0,Working,Higher education,Civil marriage,House / apartment,-12506,-495,1,1,0,0,Accountants,3.0,-47,0
9668,5009398,F,N,N,1,76500.0,Working,Higher education,Civil marriage,House / apartment,-12506,-495,1,1,0,0,Accountants,3.0,-48,0
9669,5009398,F,N,N,1,76500.0,Working,Higher education,Civil marriage,House / apartment,-12506,-495,1,1,0,0,Accountants,3.0,-49,0
9670,5009398,F,N,N,1,76500.0,Working,Higher education,Civil marriage,House / apartment,-12506,-495,1,1,0,0,Accountants,3.0,-50,0
9671,5009398,F,N,N,1,76500.0,Working,Higher education,Civil marriage,House / apartment,-12506,-495,1,1,0,0,Accountants,3.0,-51,0
9672,5009398,F,N,N,1,76500.0,Working,Higher education,Civil marriage,House / apartment,-12506,-495,1,1,0,0,Accountants,3.0,-52,0
9673,5009398,F,N,N,1,76500.0,Working,Higher education,Civil marriage,House / apartment,-12506,-495,1,1,0,0,Accountants,3.0,-53,0
9674,5009398,F,N,N,1,76500.0,Working,Higher education,Civil marriage,House / apartment,-12506,-495,1,1,0,0,Accountants,3.0,-54,0
9675,5009398,F,N,N,1,76500.0,Working,Higher education,Civil marriage,House / apartment,-12506,-495,1,1,0,0,Accountants,3.0,-55,0
9676,5009399,F,N,N,1,76500.0,Working,Higher education,Civil marriage,House / apartment,-12506,-495,1,1,0,0,Accountants,3.0,0,C
9677,5009399,F,N,N,1,76500.0,Working,Higher education,Civil marriage,House / apartment,-12506,-495,1,1,0,0,Accountants,3.0,-1,C
9678,5009399,F,N,N,1,76500.0,Working,Higher education,Civil marriage,House / apartment,-12506,-495,1,1,0,0,Accountants,3.0,-2,C
9679,5009399,F,N,N,1,76500.0,Working,Higher education,Civil marriage,House / apartment,-12506,-495,1,1,0,0,Accountants,3.0,-3,C
9680,5009399,F,N,N,1,76500.0,Working,Higher education,Civil marriage,House / apartment,-12506,-495,1,1,0,0,Accountants,3.0,-4,C
9681,5009399,F,N,N,1,76500.0,Working,Higher education,Civil marriage,House / apartment,-12506,-495,1,1,0,0,Accountants,3.0,-5,C
9682,5009399,F,N,N,1,76500.0,Working,Higher education,Civil marriage,House / apartment,-12506,-495,1,1,0,0,Accountants,3.0,-6,C
9683,5009399,F,N,N,1,76500.0,Working,Higher education,Civil marriage,House / apartment,-12506,-495,1,1,0,0,Accountants,3.0,-7,C
9684,5009399,F,N,N,1,76500.0,Working,Higher education,Civil marriage,House / apartment,-12506,-495,1,1,0,0,Accountants,3.0,-8,C
9685,5009399,F,N,N,1,76500.0,Working,Higher education,Civil marriage,House / apartment,-12506,-495,1,1,0,0,Accountants,3.0,-9,C
9686,5009399,F,N,N,1,76500.0,Working,Higher education,Civil marriage,House / apartment,-12506,-495,1,1,0,0,Accountants,3.0,-10,C
9687,5009399,F,N,N,1,76500.0,Working,Higher education,Civil marriage,House / apartment,-12506,-495,1,1,0,0,Accountants,3.0,-11,C
9688,5009399,F,N,N,1,76500.0,Working,Higher education,Civil marriage,House / apartment,-12506,-495,1,1,0,0,Accountants,3.0,-12,C
9689,5009399,F,N,N,1,76500.0,Working,Higher education,Civil marriage,House / apartment,-12506,-495,1,1,0,0,Accountants,3.0,-13,C
9690,5009399,F,N,N,1,76500.0,Working,Higher education,Civil marriage,House / apartment,-12506,-495,1,1,0,0,Accountants,3.0,-14,C
9691,5009399,F,N,N,1,76500.0,Working,Higher education,Civil marriage,House / apartment,-12506,-495,1,1,0,0,Accountants,3.0,-15,C
9692,5009399,F,N,N,1,76500.0,Working,Higher education,Civil marriage,House / apartment,-12506,-495,1,1,0,0,Accountants,3.0,-16,C
9693,5009399,F,N,N,1,76500.0,Working,Higher education,Civil marriage,House / apartment,-12506,-495,1,1,0,0,Accountants,3.0,-17,C
9694,5009399,F,N,N,1,76500.0,Working,Higher education,Civil marriage,House / apartment,-12506,-495,1,1,0,0,Accountants,3.0,-18,C
9695,5009399,F,N,N,1,76500.0,Working,Higher education,Civil marriage,House / apartment,-12506,-495,1,1,0,0,Accountants,3.0,-19,C
9696,5009399,F,N,N,1,76500.0,Working,Higher education,Civil marriage,House / apartment,-12506,-495,1,1,0,0,Accountants,3.0,-20,C
9697,5009399,F,N,N,1,76500.0,Working,Higher education,Civil marriage,House / apartment,-12506,-495,1,1,0,0,Accountants,3.0,-21,C
9698,5009399,F,N,N,1,76500.0,Working,Higher education,Civil marriage,House / apartment,-12506,-495,1,1,0,0,Accountants,3.0,-22,C
9699,5009399,F,N,N,1,76500.0,Working,Higher education,Civil marriage,House / apartment,-12506,-495,1,1,0,0,Accountants,3.0,-23,C
9700,5009399,F,N,N,1,76500.0,Working,Higher education,Civil marriage,House / apartment,-12506,-495,1,1,0,0,Accountants,3.0,-24,C
9701,5009399,F,N,N,1,76500.0,Working,Higher education,Civil marriage,House / apartment,-12506,-495,1,1,0,0,Accountants,3.0,-25,C
9702,5009399,F,N,N,1,76500.0,Working,Higher education,Civil marriage,House / apartment,-12506,-495,1,1,0,0,Accountants,3.0,-26,C
9703,5009399,F,N,N,1,76500.0,Working,Higher education,Civil marriage,House / apartment,-12506,-495,1,1,0,0,Accountants,3.0,-27,C
9704,5009399,F,N,N,1,76500.0,Working,Higher education,Civil marriage,House / apartment,-12506,-495,1,1,0,0,Accountants,3.0,-28,C
9705,5009399,F,N,N,1,76500.0,Working,Higher education,Civil marriage,House / apartment,-12506,-495,1,1,0,0,Accountants,3.0,-29,C
9706,5009399,F,N,N,1,76500.0,Working,Higher education,Civil marriage,House / apartment,-12506,-495,1,1,0,0,Accountants,3.0,-30,C
9707,5009399,F,N,N,1,76500.0,Working,Higher education,Civil marriage,House / apartment,-12506,-495,1,1,0,0,Accountants,3.0,-31,C
9708,5009399,F,N,N,1,76500.0,Working,Higher education,Civil marriage,House / apartment,-12506,-495,1,1,0,0,Accountants,3.0,-32,C
9709,5009399,F,N,N,1,76500.0,Working,Higher education,Civil marriage,House / apartment,-12506,-495,1,1,0,0,Accountants,3.0,-33,C
9710,5009399,F,N,N,1,76500.0,Working,Higher education,Civil marriage,House / apartment,-12506,-495,1,1,0,0,Accountants,3.0,-34,C
9711,5009399,F,N,N,1,76500.0,Working,Higher education,Civil marriage,House / apartment,-12506,-495,1,1,0,0,Accountants,3.0,-35,C
9712,5009399,F,N,N,1,76500.0,Working,Higher education,Civil marriage,House / apartment,-12506,-495,1,1,0,0,Accountants,3.0,-36,C
9713,5009399,F,N,N,1,76500.0,Working,Higher education,Civil marriage,House / apartment,-12506,-495,1,1,0,0,Accountants,3.0,-37,C
9714,5009399,F,N,N,1,76500.0,Working,Higher education,Civil marriage,House / apartment,-12506,-495,1,1,0,0,Accountants,3.0,-38,C
9715,5009399,F,N,N,1,76500.0,Working,Higher education,Civil marriage,House / apartment,-12506,-495,1,1,0,0,Accountants,3.0,-39,C
9716,5009399,F,N,N,1,76500.0,Working,Higher education,Civil marriage,House / apartment,-12506,-495,1,1,0,0,Accountants,3.0,-40,C
9717,5009399,F,N,N,1,76500.0,Working,Higher education,Civil marriage,House / apartment,-12506,-495,1,1,0,0,Accountants,3.0,-41,C
9718,5009399,F,N,N,1,76500.0,Working,Higher education,Civil marriage,House / apartment,-12506,-495,1,1,0,0,Accountants,3.0,-42,C
9719,5009399,F,N,N,1,76500.0,Working,Higher education,Civil marriage,House / apartment,-12506,-495,1,1,0,0,Accountants,3.0,-43,C
9720,5009399,F,N,N,1,76500.0,Working,Higher education,Civil marriage,House / apartment,-12506,-495,1,1,0,0,Accountants,3.0,-44,C
9721,5009399,F,N,N,1,76500.0,Working,Higher education,Civil marriage,House / apartment,-12506,-495,1,1,0,0,Accountants,3.0,-45,C
9722,5009399,F,N,N,1,76500.0,Working,Higher education,Civil marriage,House / apartment,-12506,-495,1,1,0,0,Accountants,3.0,-46,C
9723,5009399,F,N,N,1,76500.0,Working,Higher education,Civil marriage,House / apartment,-12506,-495,1,1,0,0,Accountants,3.0,-47,C
9724,5009399,F,N,N,1,76500.0,Working,Higher education,Civil marriage,House / apartment,-12506,-495,1,1,0,0,Accountants,3.0,-48,C
9725,5009399,F,N,N,1,76500.0,Working,Higher education,Civil marriage,House / apartment,-12506,-495,1,1,0,0,Accountants,3.0,-49,C
9726,5009399,F,N,N,1,76500.0,Working,Higher education,Civil marriage,House / apartment,-12506,-495,1,1,0,0,Accountants,3.0,-50,C
9727,5009399,F,N,N,1,76500.0,Working,Higher education,Civil marriage,House / apartment,-12506,-495,1,1,0,0,Accountants,3.0,-51,C
9728,5009399,F,N,N,1,76500.0,Working,Higher education,Civil marriage,House / apartment,-12506,-495,1,1,0,0,Accountants,3.0,-52,C
9729,5009399,F,N,N,1,76500.0,Working,Higher education,Civil marriage,House / apartment,-12506,-495,1,1,0,0,Accountants,3.0,-53,C
9730,5009399,F,N,N,1,76500.0,Working,Higher education,Civil marriage,House / apartment,-12506,-495,1,1,0,0,Accountants,3.0,-54,C
9731,5009399,F,N,N,1,76500.0,Working,Higher education,Civil marriage,House / apartment,-12506,-495,1,1,0,0,Accountants,3.0,-55,0
9732,5009399,F,N,N,1,76500.0,Working,Higher education,Civil marriage,House / apartment,-12506,-495,1,1,0,0,Accountants,3.0,-56,0
9733,5009399,F,N,N,1,76500.0,Working,Higher education,Civil marriage,House / apartment,-12506,-495,1,1,0,0,Accountants,3.0,-57,0
9734,5009399,F,N,N,1,76500.0,Working,Higher education,Civil marriage,House / apartment,-12506,-495,1,1,0,0,Accountants,3.0,-58,0
9735,5009400,F,N,N,1,76500.0,Working,Higher education,Civil marriage,House / apartment,-12506,-495,1,1,0,0,Accountants,3.0,0,C
9736,5009400,F,N,N,1,76500.0,Working,Higher education,Civil marriage,House / apartment,-12506,-495,1,1,0,0,Accountants,3.0,-1,C
9737,5009400,F,N,N,1,76500.0,Working,Higher education,Civil marriage,House / apartment,-12506,-495,1,1,0,0,Accountants,3.0,-2,C
9738,5009400,F,N,N,1,76500.0,Working,Higher education,Civil marriage,House / apartment,-12506,-495,1,1,0,0,Accountants,3.0,-3,C
9739,5009400,F,N,N,1,76500.0,Working,Higher education,Civil marriage,House / apartment,-12506,-495,1,1,0,0,Accountants,3.0,-4,C
9740,5009400,F,N,N,1,76500.0,Working,Higher education,Civil marriage,House / apartment,-12506,-495,1,1,0,0,Accountants,3.0,-5,C
9741,5009400,F,N,N,1,76500.0,Working,Higher education,Civil marriage,House / apartment,-12506,-495,1,1,0,0,Accountants,3.0,-6,C
9742,5009400,F,N,N,1,76500.0,Working,Higher education,Civil marriage,House / apartment,-12506,-495,1,1,0,0,Accountants,3.0,-7,C
9743,5009400,F,N,N,1,76500.0,Working,Higher education,Civil marriage,House / apartment,-12506,-495,1,1,0,0,Accountants,3.0,-8,C
9744,5009400,F,N,N,1,76500.0,Working,Higher education,Civil marriage,House / apartment,-12506,-495,1,1,0,0,Accountants,3.0,-9,C
9745,5009400,F,N,N,1,76500.0,Working,Higher education,Civil marriage,House / apartment,-12506,-495,1,1,0,0,Accountants,3.0,-10,C
9746,5009400,F,N,N,1,76500.0,Working,Higher education,Civil marriage,House / apartment,-12506,-495,1,1,0,0,Accountants,3.0,-11,C
9747,5009400,F,N,N,1,76500.0,Working,Higher education,Civil marriage,House / apartment,-12506,-495,1,1,0,0,Accountants,3.0,-12,C
9748,5009400,F,N,N,1,76500.0,Working,Higher education,Civil marriage,House / apartment,-12506,-495,1,1,0,0,Accountants,3.0,-13,C
9749,5009400,F,N,N,1,76500.0,Working,Higher education,Civil marriage,House / apartment,-12506,-495,1,1,0,0,Accountants,3.0,-14,C
9750,5009400,F,N,N,1,76500.0,Working,Higher education,Civil marriage,House / apartment,-12506,-495,1,1,0,0,Accountants,3.0,-15,C
9751,5009400,F,N,N,1,76500.0,Working,Higher education,Civil marriage,House / apartment,-12506,-495,1,1,0,0,Accountants,3.0,-16,C
9752,5009400,F,N,N,1,76500.0,Working,Higher education,Civil marriage,House / apartment,-12506,-495,1,1,0,0,Accountants,3.0,-17,C
9753,5009400,F,N,N,1,76500.0,Working,Higher education,Civil marriage,House / apartment,-12506,-495,1,1,0,0,Accountants,3.0,-18,C
9754,5009400,F,N,N,1,76500.0,Working,Higher education,Civil marriage,House / apartment,-12506,-495,1,1,0,0,Accountants,3.0,-19,C
9755,5009400,F,N,N,1,76500.0,Working,Higher education,Civil marriage,House / apartment,-12506,-495,1,1,0,0,Accountants,3.0,-20,C
9756,5009400,F,N,N,1,76500.0,Working,Higher education,Civil marriage,House / apartment,-12506,-495,1,1,0,0,Accountants,3.0,-21,C
9757,5009400,F,N,N,1,76500.0,Working,Higher education,Civil marriage,House / apartment,-12506,-495,1,1,0,0,Accountants,3.0,-22,C
9758,5009400,F,N,N,1,76500.0,Working,Higher education,Civil marriage,House / apartment,-12506,-495,1,1,0,0,Accountants,3.0,-23,C
9759,5009400,F,N,N,1,76500.0,Working,Higher education,Civil marriage,House / apartment,-12506,-495,1,1,0,0,Accountants,3.0,-24,C
9760,5009400,F,N,N,1,76500.0,Working,Higher education,Civil marriage,House / apartment,-12506,-495,1,1,0,0,Accountants,3.0,-25,C
9761,5009400,F,N,N,1,76500.0,Working,Higher education,Civil marriage,House / apartment,-12506,-495,1,1,0,0,Accountants,3.0,-26,C
9762,5009400,F,N,N,1,76500.0,Working,Higher education,Civil marriage,House / apartment,-12506,-495,1,1,0,0,Accountants,3.0,-27,C
9763,5009400,F,N,N,1,76500.0,Working,Higher education,Civil marriage,House / apartment,-12506,-495,1,1,0,0,Accountants,3.0,-28,C
9764,5009400,F,N,N,1,76500.0,Working,Higher education,Civil marriage,House / apartment,-12506,-495,1,1,0,0,Accountants,3.0,-29,C
9765,5009400,F,N,N,1,76500.0,Working,Higher education,Civil marriage,House / apartment,-12506,-495,1,1,0,0,Accountants,3.0,-30,C
9766,5009400,F,N,N,1,76500.0,Working,Higher education,Civil marriage,House / apartment,-12506,-495,1,1,0,0,Accountants,3.0,-31,C
9767,5009400,F,N,N,1,76500.0,Working,Higher education,Civil marriage,House / apartment,-12506,-495,1,1,0,0,Accountants,3.0,-32,C
9768,5009400,F,N,N,1,76500.0,Working,Higher education,Civil marriage,House / apartment,-12506,-495,1,1,0,0,Accountants,3.0,-33,C
9769,5009400,F,N,N,1,76500.0,Working,Higher education,Civil marriage,House / apartment,-12506,-495,1,1,0,0,Accountants,3.0,-34,C
9770,5009400,F,N,N,1,76500.0,Working,Higher education,Civil marriage,House / apartment,-12506,-495,1,1,0,0,Accountants,3.0,-35,C
9771,5009400,F,N,N,1,76500.0,Working,Higher education,Civil marriage,House / apartment,-12506,-495,1,1,0,0,Accountants,3.0,-36,C
9772,5009400,F,N,N,1,76500.0,Working,Higher education,Civil marriage,House / apartment,-12506,-495,1,1,0,0,Accountants,3.0,-37,C
9773,5009400,F,N,N,1,76500.0,Working,Higher education,Civil marriage,House / apartment,-12506,-495,1,1,0,0,Accountants,3.0,-38,C
9774,5009400,F,N,N,1,76500.0,Working,Higher education,Civil marriage,House / apartment,-12506,-495,1,1,0,0,Accountants,3.0,-39,C
9775,5009400,F,N,N,1,76500.0,Working,Higher education,Civil marriage,House / apartment,-12506,-495,1,1,0,0,Accountants,3.0,-40,C
9776,5009400,F,N,N,1,76500.0,Working,Higher education,Civil marriage,House / apartment,-12506,-495,1,1,0,0,Accountants,3.0,-41,C
9777,5009400,F,N,N,1,76500.0,Working,Higher education,Civil marriage,House / apartment,-12506,-495,1,1,0,0,Accountants,3.0,-42,C
9778,5009400,F,N,N,1,76500.0,Working,Higher education,Civil marriage,House / apartment,-12506,-495,1,1,0,0,Accountants,3.0,-43,C
9779,5009400,F,N,N,1,76500.0,Working,Higher education,Civil marriage,House / apartment,-12506,-495,1,1,0,0,Accountants,3.0,-44,C
9780,5009400,F,N,N,1,76500.0,Working,Higher education,Civil marriage,House / apartment,-12506,-495,1,1,0,0,Accountants,3.0,-45,C
9781,5009400,F,N,N,1,76500.0,Working,Higher education,Civil marriage,House / apartment,-12506,-495,1,1,0,0,Accountants,3.0,-46,C
9782,5009400,F,N,N,1,76500.0,Working,Higher education,Civil marriage,House / apartment,-12506,-495,1,1,0,0,Accountants,3.0,-47,0
9783,5009400,F,N,N,1,76500.0,Working,Higher education,Civil marriage,House / apartment,-12506,-495,1,1,0,0,Accountants,3.0,-48,0
9784,5009400,F,N,N,1,76500.0,Working,Higher education,Civil marriage,House / apartment,-12506,-495,1,1,0,0,Accountants,3.0,-49,0
9785,5009400,F,N,N,1,76500.0,Working,Higher education,Civil marriage,House / apartment,-12506,-495,1,1,0,0,Accountants,3.0,-50,0
9786,5009401,F,N,N,1,76500.0,Working,Higher education,Civil marriage,House / apartment,-12506,-495,1,1,0,0,Accountants,3.0,0,C
9787,5009401,F,N,N,1,76500.0,Working,Higher education,Civil marriage,House / apartment,-12506,-495,1,1,0,0,Accountants,3.0,-1,C
9788,5009401,F,N,N,1,76500.0,Working,Higher education,Civil marriage,House / apartment,-12506,-495,1,1,0,0,Accountants,3.0,-2,C
9789,5009401,F,N,N,1,76500.0,Working,Higher education,Civil marriage,House / apartment,-12506,-495,1,1,0,0,Accountants,3.0,-3,C
9790,5009401,F,N,N,1,76500.0,Working,Higher education,Civil marriage,House / apartment,-12506,-495,1,1,0,0,Accountants,3.0,-4,C
9791,5009401,F,N,N,1,76500.0,Working,Higher education,Civil marriage,House / apartment,-12506,-495,1,1,0,0,Accountants,3.0,-5,C
9792,5009401,F,N,N,1,76500.0,Working,Higher education,Civil marriage,House / apartment,-12506,-495,1,1,0,0,Accountants,3.0,-6,C
9793,5009401,F,N,N,1,76500.0,Working,Higher education,Civil marriage,House / apartment,-12506,-495,1,1,0,0,Accountants,3.0,-7,C
9794,5009401,F,N,N,1,76500.0,Working,Higher education,Civil marriage,House / apartment,-12506,-495,1,1,0,0,Accountants,3.0,-8,C
9795,5009401,F,N,N,1,76500.0,Working,Higher education,Civil marriage,House / apartment,-12506,-495,1,1,0,0,Accountants,3.0,-9,C
9796,5009401,F,N,N,1,76500.0,Working,Higher education,Civil marriage,House / apartment,-12506,-495,1,1,0,0,Accountants,3.0,-10,C
9797,5009401,F,N,N,1,76500.0,Working,Higher education,Civil marriage,House / apartment,-12506,-495,1,1,0,0,Accountants,3.0,-11,C
9798,5009401,F,N,N,1,76500.0,Working,Higher education,Civil marriage,House / apartment,-12506,-495,1,1,0,0,Accountants,3.0,-12,C
9799,5009401,F,N,N,1,76500.0,Working,Higher education,Civil marriage,House / apartment,-12506,-495,1,1,0,0,Accountants,3.0,-13,C
9800,5009401,F,N,N,1,76500.0,Working,Higher education,Civil marriage,House / apartment,-12506,-495,1,1,0,0,Accountants,3.0,-14,C
9801,5009401,F,N,N,1,76500.0,Working,Higher education,Civil marriage,House / apartment,-12506,-495,1,1,0,0,Accountants,3.0,-15,C
9802,5009401,F,N,N,1,76500.0,Working,Higher education,Civil marriage,House / apartment,-12506,-495,1,1,0,0,Accountants,3.0,-16,C
9803,5009401,F,N,N,1,76500.0,Working,Higher education,Civil marriage,House / apartment,-12506,-495,1,1,0,0,Accountants,3.0,-17,C
9804,5009401,F,N,N,1,76500.0,Working,Higher education,Civil marriage,House / apartment,-12506,-495,1,1,0,0,Accountants,3.0,-18,C
9805,5009401,F,N,N,1,76500.0,Working,Higher education,Civil marriage,House / apartment,-12506,-495,1,1,0,0,Accountants,3.0,-19,C
9806,5009401,F,N,N,1,76500.0,Working,Higher education,Civil marriage,House / apartment,-12506,-495,1,1,0,0,Accountants,3.0,-20,C
9807,5009401,F,N,N,1,76500.0,Working,Higher education,Civil marriage,House / apartment,-12506,-495,1,1,0,0,Accountants,3.0,-21,C
9808,5009401,F,N,N,1,76500.0,Working,Higher education,Civil marriage,House / apartment,-12506,-495,1,1,0,0,Accountants,3.0,-22,C
9809,5009401,F,N,N,1,76500.0,Working,Higher education,Civil marriage,House / apartment,-12506,-495,1,1,0,0,Accountants,3.0,-23,C
9810,5009401,F,N,N,1,76500.0,Working,Higher education,Civil marriage,House / apartment,-12506,-495,1,1,0,0,Accountants,3.0,-24,C
9811,5009401,F,N,N,1,76500.0,Working,Higher education,Civil marriage,House / apartment,-12506,-495,1,1,0,0,Accountants,3.0,-25,C
9812,5009401,F,N,N,1,76500.0,Working,Higher education,Civil marriage,House / apartment,-12506,-495,1,1,0,0,Accountants,3.0,-26,C
9813,5009401,F,N,N,1,76500.0,Working,Higher education,Civil marriage,House / apartment,-12506,-495,1,1,0,0,Accountants,3.0,-27,C
9814,5009401,F,N,N,1,76500.0,Working,Higher education,Civil marriage,House / apartment,-12506,-495,1,1,0,0,Accountants,3.0,-28,C
9815,5009401,F,N,N,1,76500.0,Working,Higher education,Civil marriage,House / apartment,-12506,-495,1,1,0,0,Accountants,3.0,-29,C
9816,5009401,F,N,N,1,76500.0,Working,Higher education,Civil marriage,House / apartment,-12506,-495,1,1,0,0,Accountants,3.0,-30,C
9817,5009401,F,N,N,1,76500.0,Working,Higher education,Civil marriage,House / apartment,-12506,-495,1,1,0,0,Accountants,3.0,-31,C
9818,5009401,F,N,N,1,76500.0,Working,Higher education,Civil marriage,House / apartment,-12506,-495,1,1,0,0,Accountants,3.0,-32,C
9819,5009401,F,N,N,1,76500.0,Working,Higher education,Civil marriage,House / apartment,-12506,-495,1,1,0,0,Accountants,3.0,-33,C
9820,5009401,F,N,N,1,76500.0,Working,Higher education,Civil marriage,House / apartment,-12506,-495,1,1,0,0,Accountants,3.0,-34,C
9821,5009401,F,N,N,1,76500.0,Working,Higher education,Civil marriage,House / apartment,-12506,-495,1,1,0,0,Accountants,3.0,-35,C
9822,5009401,F,N,N,1,76500.0,Working,Higher education,Civil marriage,House / apartment,-12506,-495,1,1,0,0,Accountants,3.0,-36,C
9823,5009401,F,N,N,1,76500.0,Working,Higher education,Civil marriage,House / apartment,-12506,-495,1,1,0,0,Accountants,3.0,-37,C
9824,5009401,F,N,N,1,76500.0,Working,Higher education,Civil marriage,House / apartment,-12506,-495,1,1,0,0,Accountants,3.0,-38,C
9825,5009401,F,N,N,1,76500.0,Working,Higher education,Civil marriage,House / apartment,-12506,-495,1,1,0,0,Accountants,3.0,-39,C
9826,5009401,F,N,N,1,76500.0,Working,Higher education,Civil marriage,House / apartment,-12506,-495,1,1,0,0,Accountants,3.0,-40,C
9827,5009401,F,N,N,1,76500.0,Working,Higher education,Civil marriage,House / apartment,-12506,-495,1,1,0,0,Accountants,3.0,-41,C
9828,5009401,F,N,N,1,76500.0,Working,Higher education,Civil marriage,House / apartment,-12506,-495,1,1,0,0,Accountants,3.0,-42,C
9829,5009401,F,N,N,1,76500.0,Working,Higher education,Civil marriage,House / apartment,-12506,-495,1,1,0,0,Accountants,3.0,-43,C
9830,5009401,F,N,N,1,76500.0,Working,Higher education,Civil marriage,House / apartment,-12506,-495,1,1,0,0,Accountants,3.0,-44,C
9831,5009401,F,N,N,1,76500.0,Working,Higher education,Civil marriage,House / apartment,-12506,-495,1,1,0,0,Accountants,3.0,-45,C
9832,5009401,F,N,N,1,76500.0,Working,Higher education,Civil marriage,House / apartment,-12506,-495,1,1,0,0,Accountants,3.0,-46,C
9833,5009401,F,N,N,1,76500.0,Working,Higher education,Civil marriage,House / apartment,-12506,-495,1,1,0,0,Accountants,3.0,-47,C
9834,5009401,F,N,N,1,76500.0,Working,Higher education,Civil marriage,House / apartment,-12506,-495,1,1,0,0,Accountants,3.0,-48,C
9835,5009401,F,N,N,1,76500.0,Working,Higher education,Civil marriage,House / apartment,-12506,-495,1,1,0,0,Accountants,3.0,-49,C
9836,5009401,F,N,N,1,76500.0,Working,Higher education,Civil marriage,House / apartment,-12506,-495,1,1,0,0,Accountants,3.0,-50,C
9837,5009401,F,N,N,1,76500.0,Working,Higher education,Civil marriage,House / apartment,-12506,-495,1,1,0,0,Accountants,3.0,-51,C
9838,5009401,F,N,N,1,76500.0,Working,Higher education,Civil marriage,House / apartment,-12506,-495,1,1,0,0,Accountants,3.0,-52,C
9839,5009401,F,N,N,1,76500.0,Working,Higher education,Civil marriage,House / apartment,-12506,-495,1,1,0,0,Accountants,3.0,-53,0
9840,5009401,F,N,N,1,76500.0,Working,Higher education,Civil marriage,House / apartment,-12506,-495,1,1,0,0,Accountants,3.0,-54,0
9841,5009401,F,N,N,1,76500.0,Working,Higher education,Civil marriage,House / apartment,-12506,-495,1,1,0,0,Accountants,3.0,-55,0
9842,5009401,F,N,N,1,76500.0,Working,Higher education,Civil marriage,House / apartment,-12506,-495,1,1,0,0,Accountants,3.0,-56,0
9843,5009402,M,N,N,0,202500.0,Commercial associate,Secondary / secondary special,Married,House / apartment,-20604,-252,1,1,1,0,Security staff,2.0,0,X
9844,5009402,M,N,N,0,202500.0,Commercial associate,Secondary / secondary special,Married,House / apartment,-20604,-252,1,1,1,0,Security staff,2.0,-1,0
9845,5009402,M,N,N,0,202500.0,Commercial associate,Secondary / secondary special,Married,House / apartment,-20604,-252,1,1,1,0,Security staff,2.0,-2,X
9846,5009402,M,N,N,0,202500.0,Commercial associate,Secondary / secondary special,Married,House / apartment,-20604,-252,1,1,1,0,Security staff,2.0,-3,0
9847,5009402,M,N,N,0,202500.0,Commercial associate,Secondary / secondary special,Married,House / apartment,-20604,-252,1,1,1,0,Security staff,2.0,-4,0
9848,5009402,M,N,N,0,202500.0,Commercial associate,Secondary / secondary special,Married,House / apartment,-20604,-252,1,1,1,0,Security staff,2.0,-5,0
9849,5009402,M,N,N,0,202500.0,Commercial associate,Secondary / secondary special,Married,House / apartment,-20604,-252,1,1,1,0,Security staff,2.0,-6,0
9850,5009402,M,N,N,0,202500.0,Commercial associate,Secondary / secondary special,Married,House / apartment,-20604,-252,1,1,1,0,Security staff,2.0,-7,0
9851,5009403,M,N,N,0,202500.0,Commercial associate,Secondary / secondary special,Married,House / apartment,-20604,-252,1,1,1,0,Security staff,2.0,0,C
9852,5009403,M,N,N,0,202500.0,Commercial associate,Secondary / secondary special,Married,House / apartment,-20604,-252,1,1,1,0,Security staff,2.0,-1,C
9853,5009403,M,N,N,0,202500.0,Commercial associate,Secondary / secondary special,Married,House / apartment,-20604,-252,1,1,1,0,Security staff,2.0,-2,C
9854,5009403,M,N,N,0,202500.0,Commercial associate,Secondary / secondary special,Married,House / apartment,-20604,-252,1,1,1,0,Security staff,2.0,-3,C
9855,5009403,M,N,N,0,202500.0,Commercial associate,Secondary / secondary special,Married,House / apartment,-20604,-252,1,1,1,0,Security staff,2.0,-4,C
9856,5009403,M,N,N,0,202500.0,Commercial associate,Secondary / secondary special,Married,House / apartment,-20604,-252,1,1,1,0,Security staff,2.0,-5,C
9857,5009403,M,N,N,0,202500.0,Commercial associate,Secondary / secondary special,Married,House / apartment,-20604,-252,1,1,1,0,Security staff,2.0,-6,C
9858,5009403,M,N,N,0,202500.0,Commercial associate,Secondary / secondary special,Married,House / apartment,-20604,-252,1,1,1,0,Security staff,2.0,-7,C
9859,5009403,M,N,N,0,202500.0,Commercial associate,Secondary / secondary special,Married,House / apartment,-20604,-252,1,1,1,0,Security staff,2.0,-8,C
9860,5009403,M,N,N,0,202500.0,Commercial associate,Secondary / secondary special,Married,House / apartment,-20604,-252,1,1,1,0,Security staff,2.0,-9,C
9861,5009403,M,N,N,0,202500.0,Commercial associate,Secondary / secondary special,Married,House / apartment,-20604,-252,1,1,1,0,Security staff,2.0,-10,C
9862,5009403,M,N,N,0,202500.0,Commercial associate,Secondary / secondary special,Married,House / apartment,-20604,-252,1,1,1,0,Security staff,2.0,-11,C
9863,5009403,M,N,N,0,202500.0,Commercial associate,Secondary / secondary special,Married,House / apartment,-20604,-252,1,1,1,0,Security staff,2.0,-12,C
9864,5009403,M,N,N,0,202500.0,Commercial associate,Secondary / secondary special,Married,House / apartment,-20604,-252,1,1,1,0,Security staff,2.0,-13,C
9865,5009403,M,N,N,0,202500.0,Commercial associate,Secondary / secondary special,Married,House / apartment,-20604,-252,1,1,1,0,Security staff,2.0,-14,C
9866,5009403,M,N,N,0,202500.0,Commercial associate,Secondary / secondary special,Married,House / apartment,-20604,-252,1,1,1,0,Security staff,2.0,-15,C
9867,5009403,M,N,N,0,202500.0,Commercial associate,Secondary / secondary special,Married,House / apartment,-20604,-252,1,1,1,0,Security staff,2.0,-16,C
9868,5009403,M,N,N,0,202500.0,Commercial associate,Secondary / secondary special,Married,House / apartment,-20604,-252,1,1,1,0,Security staff,2.0,-17,C
9869,5009403,M,N,N,0,202500.0,Commercial associate,Secondary / secondary special,Married,House / apartment,-20604,-252,1,1,1,0,Security staff,2.0,-18,C
9870,5009403,M,N,N,0,202500.0,Commercial associate,Secondary / secondary special,Married,House / apartment,-20604,-252,1,1,1,0,Security staff,2.0,-19,C
9871,5009403,M,N,N,0,202500.0,Commercial associate,Secondary / secondary special,Married,House / apartment,-20604,-252,1,1,1,0,Security staff,2.0,-20,C
9872,5009403,M,N,N,0,202500.0,Commercial associate,Secondary / secondary special,Married,House / apartment,-20604,-252,1,1,1,0,Security staff,2.0,-21,C
9873,5009403,M,N,N,0,202500.0,Commercial associate,Secondary / secondary special,Married,House / apartment,-20604,-252,1,1,1,0,Security staff,2.0,-22,C
9874,5009403,M,N,N,0,202500.0,Commercial associate,Secondary / secondary special,Married,House / apartment,-20604,-252,1,1,1,0,Security staff,2.0,-23,C
9875,5009403,M,N,N,0,202500.0,Commercial associate,Secondary / secondary special,Married,House / apartment,-20604,-252,1,1,1,0,Security staff,2.0,-24,C
9876,5009403,M,N,N,0,202500.0,Commercial associate,Secondary / secondary special,Married,House / apartment,-20604,-252,1,1,1,0,Security staff,2.0,-25,C
9877,5009403,M,N,N,0,202500.0,Commercial associate,Secondary / secondary special,Married,House / apartment,-20604,-252,1,1,1,0,Security staff,2.0,-26,C
9878,5009403,M,N,N,0,202500.0,Commercial associate,Secondary / secondary special,Married,House / apartment,-20604,-252,1,1,1,0,Security staff,2.0,-27,C
9879,5009403,M,N,N,0,202500.0,Commercial associate,Secondary / secondary special,Married,House / apartment,-20604,-252,1,1,1,0,Security staff,2.0,-28,C
9880,5009403,M,N,N,0,202500.0,Commercial associate,Secondary / secondary special,Married,House / apartment,-20604,-252,1,1,1,0,Security staff,2.0,-29,C
9881,5009403,M,N,N,0,202500.0,Commercial associate,Secondary / secondary special,Married,House / apartment,-20604,-252,1,1,1,0,Security staff,2.0,-30,C
9882,5009403,M,N,N,0,202500.0,Commercial associate,Secondary / secondary special,Married,House / apartment,-20604,-252,1,1,1,0,Security staff,2.0,-31,X
9883,5009403,M,N,N,0,202500.0,Commercial associate,Secondary / secondary special,Married,House / apartment,-20604,-252,1,1,1,0,Security staff,2.0,-32,0
9884,5009403,M,N,N,0,202500.0,Commercial associate,Secondary / secondary special,Married,House / apartment,-20604,-252,1,1,1,0,Security staff,2.0,-33,0
9885,5009403,M,N,N,0,202500.0,Commercial associate,Secondary / secondary special,Married,House / apartment,-20604,-252,1,1,1,0,Security staff,2.0,-34,0
9886,5009403,M,N,N,0,202500.0,Commercial associate,Secondary / secondary special,Married,House / apartment,-20604,-252,1,1,1,0,Security staff,2.0,-35,0
9887,5009403,M,N,N,0,202500.0,Commercial associate,Secondary / secondary special,Married,House / apartment,-20604,-252,1,1,1,0,Security staff,2.0,-36,0
9888,5009403,M,N,N,0,202500.0,Commercial associate,Secondary / secondary special,Married,House / apartment,-20604,-252,1,1,1,0,Security staff,2.0,-37,0
9889,5009403,M,N,N,0,202500.0,Commercial associate,Secondary / secondary special,Married,House / apartment,-20604,-252,1,1,1,0,Security staff,2.0,-38,0
9890,5009403,M,N,N,0,202500.0,Commercial associate,Secondary / secondary special,Married,House / apartment,-20604,-252,1,1,1,0,Security staff,2.0,-39,0
9891,5009403,M,N,N,0,202500.0,Commercial associate,Secondary / secondary special,Married,House / apartment,-20604,-252,1,1,1,0,Security staff,2.0,-40,0
9892,5009403,M,N,N,0,202500.0,Commercial associate,Secondary / secondary special,Married,House / apartment,-20604,-252,1,1,1,0,Security staff,2.0,-41,0
9893,5009403,M,N,N,0,202500.0,Commercial associate,Secondary / secondary special,Married,House / apartment,-20604,-252,1,1,1,0,Security staff,2.0,-42,0
9894,5009403,M,N,N,0,202500.0,Commercial associate,Secondary / secondary special,Married,House / apartment,-20604,-252,1,1,1,0,Security staff,2.0,-43,0
9895,5009403,M,N,N,0,202500.0,Commercial associate,Secondary / secondary special,Married,House / apartment,-20604,-252,1,1,1,0,Security staff,2.0,-44,X
9896,5009404,F,N,N,2,67500.0,Commercial associate,Higher education,Married,House / apartment,-10331,-433,1,0,1,0,Core staff,4.0,0,0
9897,5009404,F,N,N,2,67500.0,Commercial associate,Higher education,Married,House / apartment,-10331,-433,1,0,1,0,Core staff,4.0,-1,0
9898,5009404,F,N,N,2,67500.0,Commercial associate,Higher education,Married,House / apartment,-10331,-433,1,0,1,0,Core staff,4.0,-2,0
9899,5009404,F,N,N,2,67500.0,Commercial associate,Higher education,Married,House / apartment,-10331,-433,1,0,1,0,Core staff,4.0,-3,0
9900,5009404,F,N,N,2,67500.0,Commercial associate,Higher education,Married,House / apartment,-10331,-433,1,0,1,0,Core staff,4.0,-4,0
9901,5009404,F,N,N,2,67500.0,Commercial associate,Higher education,Married,House / apartment,-10331,-433,1,0,1,0,Core staff,4.0,-5,0
9902,5009404,F,N,N,2,67500.0,Commercial associate,Higher education,Married,House / apartment,-10331,-433,1,0,1,0,Core staff,4.0,-6,0
9903,5009404,F,N,N,2,67500.0,Commercial associate,Higher education,Married,House / apartment,-10331,-433,1,0,1,0,Core staff,4.0,-7,0
9904,5009405,M,N,N,0,234000.0,Working,Incomplete higher,Married,House / apartment,-13923,-2290,1,1,1,0,Drivers,2.0,0,X
9905,5009405,M,N,N,0,234000.0,Working,Incomplete higher,Married,House / apartment,-13923,-2290,1,1,1,0,Drivers,2.0,-1,X
9906,5009405,M,N,N,0,234000.0,Working,Incomplete higher,Married,House / apartment,-13923,-2290,1,1,1,0,Drivers,2.0,-2,X
9907,5009405,M,N,N,0,234000.0,Working,Incomplete higher,Married,House / apartment,-13923,-2290,1,1,1,0,Drivers,2.0,-3,X
9908,5009405,M,N,N,0,234000.0,Working,Incomplete higher,Married,House / apartment,-13923,-2290,1,1,1,0,Drivers,2.0,-4,X
9909,5009405,M,N,N,0,234000.0,Working,Incomplete higher,Married,House / apartment,-13923,-2290,1,1,1,0,Drivers,2.0,-5,X
9910,5009405,M,N,N,0,234000.0,Working,Incomplete higher,Married,House / apartment,-13923,-2290,1,1,1,0,Drivers,2.0,-6,X
9911,5009405,M,N,N,0,234000.0,Working,Incomplete higher,Married,House / apartment,-13923,-2290,1,1,1,0,Drivers,2.0,-7,X
9912,5009405,M,N,N,0,234000.0,Working,Incomplete higher,Married,House / apartment,-13923,-2290,1,1,1,0,Drivers,2.0,-8,X
9913,5009405,M,N,N,0,234000.0,Working,Incomplete higher,Married,House / apartment,-13923,-2290,1,1,1,0,Drivers,2.0,-9,X
9914,5009405,M,N,N,0,234000.0,Working,Incomplete higher,Married,House / apartment,-13923,-2290,1,1,1,0,Drivers,2.0,-10,X
9915,5009405,M,N,N,0,234000.0,Working,Incomplete higher,Married,House / apartment,-13923,-2290,1,1,1,0,Drivers,2.0,-11,X
9916,5009405,M,N,N,0,234000.0,Working,Incomplete higher,Married,House / apartment,-13923,-2290,1,1,1,0,Drivers,2.0,-12,X
9917,5009405,M,N,N,0,234000.0,Working,Incomplete higher,Married,House / apartment,-13923,-2290,1,1,1,0,Drivers,2.0,-13,X
9918,5009405,M,N,N,0,234000.0,Working,Incomplete higher,Married,House / apartment,-13923,-2290,1,1,1,0,Drivers,2.0,-14,X
9919,5009405,M,N,N,0,234000.0,Working,Incomplete higher,Married,House / apartment,-13923,-2290,1,1,1,0,Drivers,2.0,-15,X
9920,5009405,M,N,N,0,234000.0,Working,Incomplete higher,Married,House / apartment,-13923,-2290,1,1,1,0,Drivers,2.0,-16,X
9921,5009405,M,N,N,0,234000.0,Working,Incomplete higher,Married,House / apartment,-13923,-2290,1,1,1,0,Drivers,2.0,-17,X
9922,5009405,M,N,N,0,234000.0,Working,Incomplete higher,Married,House / apartment,-13923,-2290,1,1,1,0,Drivers,2.0,-18,X
9923,5009405,M,N,N,0,234000.0,Working,Incomplete higher,Married,House / apartment,-13923,-2290,1,1,1,0,Drivers,2.0,-19,X
9924,5009405,M,N,N,0,234000.0,Working,Incomplete higher,Married,House / apartment,-13923,-2290,1,1,1,0,Drivers,2.0,-20,X
9925,5009406,M,N,N,0,234000.0,Working,Incomplete higher,Married,House / apartment,-13923,-2290,1,1,1,0,Drivers,2.0,0,X
9926,5009406,M,N,N,0,234000.0,Working,Incomplete higher,Married,House / apartment,-13923,-2290,1,1,1,0,Drivers,2.0,-1,X
9927,5009406,M,N,N,0,234000.0,Working,Incomplete higher,Married,House / apartment,-13923,-2290,1,1,1,0,Drivers,2.0,-2,X
9928,5009406,M,N,N,0,234000.0,Working,Incomplete higher,Married,House / apartment,-13923,-2290,1,1,1,0,Drivers,2.0,-3,X
9929,5009406,M,N,N,0,234000.0,Working,Incomplete higher,Married,House / apartment,-13923,-2290,1,1,1,0,Drivers,2.0,-4,X
9930,5009406,M,N,N,0,234000.0,Working,Incomplete higher,Married,House / apartment,-13923,-2290,1,1,1,0,Drivers,2.0,-5,X
9931,5009406,M,N,N,0,234000.0,Working,Incomplete higher,Married,House / apartment,-13923,-2290,1,1,1,0,Drivers,2.0,-6,X
9932,5009406,M,N,N,0,234000.0,Working,Incomplete higher,Married,House / apartment,-13923,-2290,1,1,1,0,Drivers,2.0,-7,X
9933,5009406,M,N,N,0,234000.0,Working,Incomplete higher,Married,House / apartment,-13923,-2290,1,1,1,0,Drivers,2.0,-8,X
9934,5009406,M,N,N,0,234000.0,Working,Incomplete higher,Married,House / apartment,-13923,-2290,1,1,1,0,Drivers,2.0,-9,X
9935,5009406,M,N,N,0,234000.0,Working,Incomplete higher,Married,House / apartment,-13923,-2290,1,1,1,0,Drivers,2.0,-10,X
9936,5009406,M,N,N,0,234000.0,Working,Incomplete higher,Married,House / apartment,-13923,-2290,1,1,1,0,Drivers,2.0,-11,X
9937,5009406,M,N,N,0,234000.0,Working,Incomplete higher,Married,House / apartment,-13923,-2290,1,1,1,0,Drivers,2.0,-12,X
9938,5009406,M,N,N,0,234000.0,Working,Incomplete higher,Married,House / apartment,-13923,-2290,1,1,1,0,Drivers,2.0,-13,X
9939,5009406,M,N,N,0,234000.0,Working,Incomplete higher,Married,House / apartment,-13923,-2290,1,1,1,0,Drivers,2.0,-14,X
9940,5009406,M,N,N,0,234000.0,Working,Incomplete higher,Married,House / apartment,-13923,-2290,1,1,1,0,Drivers,2.0,-15,X
9941,5009406,M,N,N,0,234000.0,Working,Incomplete higher,Married,House / apartment,-13923,-2290,1,1,1,0,Drivers,2.0,-16,X
9942,5009406,M,N,N,0,234000.0,Working,Incomplete higher,Married,House / apartment,-13923,-2290,1,1,1,0,Drivers,2.0,-17,X
9943,5009406,M,N,N,0,234000.0,Working,Incomplete higher,Married,House / apartment,-13923,-2290,1,1,1,0,Drivers,2.0,-18,X
9944,5009406,M,N,N,0,234000.0,Working,Incomplete higher,Married,House / apartment,-13923,-2290,1,1,1,0,Drivers,2.0,-19,X
9945,5009406,M,N,N,0,234000.0,Working,Incomplete higher,Married,House / apartment,-13923,-2290,1,1,1,0,Drivers,2.0,-20,X
9946,5009408,M,N,N,0,234000.0,Working,Incomplete higher,Married,House / apartment,-13923,-2290,1,1,1,0,Drivers,2.0,0,X
9947,5009408,M,N,N,0,234000.0,Working,Incomplete higher,Married,House / apartment,-13923,-2290,1,1,1,0,Drivers,2.0,-1,X
9948,5009408,M,N,N,0,234000.0,Working,Incomplete higher,Married,House / apartment,-13923,-2290,1,1,1,0,Drivers,2.0,-2,0
9949,5009408,M,N,N,0,234000.0,Working,Incomplete higher,Married,House / apartment,-13923,-2290,1,1,1,0,Drivers,2.0,-3,0
9950,5009408,M,N,N,0,234000.0,Working,Incomplete higher,Married,House / apartment,-13923,-2290,1,1,1,0,Drivers,2.0,-4,0
9951,5009408,M,N,N,0,234000.0,Working,Incomplete higher,Married,House / apartment,-13923,-2290,1,1,1,0,Drivers,2.0,-5,X
9952,5009408,M,N,N,0,234000.0,Working,Incomplete higher,Married,House / apartment,-13923,-2290,1,1,1,0,Drivers,2.0,-6,X
9953,5009408,M,N,N,0,234000.0,Working,Incomplete higher,Married,House / apartment,-13923,-2290,1,1,1,0,Drivers,2.0,-7,0
9954,5009408,M,N,N,0,234000.0,Working,Incomplete higher,Married,House / apartment,-13923,-2290,1,1,1,0,Drivers,2.0,-8,0
9955,5009408,M,N,N,0,234000.0,Working,Incomplete higher,Married,House / apartment,-13923,-2290,1,1,1,0,Drivers,2.0,-9,X
9956,5009408,M,N,N,0,234000.0,Working,Incomplete higher,Married,House / apartment,-13923,-2290,1,1,1,0,Drivers,2.0,-10,0
9957,5009408,M,N,N,0,234000.0,Working,Incomplete higher,Married,House / apartment,-13923,-2290,1,1,1,0,Drivers,2.0,-11,X
9958,5009408,M,N,N,0,234000.0,Working,Incomplete higher,Married,House / apartment,-13923,-2290,1,1,1,0,Drivers,2.0,-12,X
9959,5009408,M,N,N,0,234000.0,Working,Incomplete higher,Married,House / apartment,-13923,-2290,1,1,1,0,Drivers,2.0,-13,X
9960,5009408,M,N,N,0,234000.0,Working,Incomplete higher,Married,House / apartment,-13923,-2290,1,1,1,0,Drivers,2.0,-14,0
9961,5009408,M,N,N,0,234000.0,Working,Incomplete higher,Married,House / apartment,-13923,-2290,1,1,1,0,Drivers,2.0,-15,X
9962,5009408,M,N,N,0,234000.0,Working,Incomplete higher,Married,House / apartment,-13923,-2290,1,1,1,0,Drivers,2.0,-16,X
9963,5009408,M,N,N,0,234000.0,Working,Incomplete higher,Married,House / apartment,-13923,-2290,1,1,1,0,Drivers,2.0,-17,X
9964,5009408,M,N,N,0,234000.0,Working,Incomplete higher,Married,House / apartment,-13923,-2290,1,1,1,0,Drivers,2.0,-18,X
9965,5009408,M,N,N,0,234000.0,Working,Incomplete higher,Married,House / apartment,-13923,-2290,1,1,1,0,Drivers,2.0,-19,0
9966,5009408,M,N,N,0,234000.0,Working,Incomplete higher,Married,House / apartment,-13923,-2290,1,1,1,0,Drivers,2.0,-20,0
9967,5009408,M,N,N,0,234000.0,Working,Incomplete higher,Married,House / apartment,-13923,-2290,1,1,1,0,Drivers,2.0,-21,X
9968,5009408,M,N,N,0,234000.0,Working,Incomplete higher,Married,House / apartment,-13923,-2290,1,1,1,0,Drivers,2.0,-22,0
9969,5009408,M,N,N,0,234000.0,Working,Incomplete higher,Married,House / apartment,-13923,-2290,1,1,1,0,Drivers,2.0,-23,0
9970,5009408,M,N,N,0,234000.0,Working,Incomplete higher,Married,House / apartment,-13923,-2290,1,1,1,0,Drivers,2.0,-24,0
9971,5009408,M,N,N,0,234000.0,Working,Incomplete higher,Married,House / apartment,-13923,-2290,1,1,1,0,Drivers,2.0,-25,X
9972,5009408,M,N,N,0,234000.0,Working,Incomplete higher,Married,House / apartment,-13923,-2290,1,1,1,0,Drivers,2.0,-26,X
9973,5009408,M,N,N,0,234000.0,Working,Incomplete higher,Married,House / apartment,-13923,-2290,1,1,1,0,Drivers,2.0,-27,X
9974,5009408,M,N,N,0,234000.0,Working,Incomplete higher,Married,House / apartment,-13923,-2290,1,1,1,0,Drivers,2.0,-28,X
9975,5009408,M,N,N,0,234000.0,Working,Incomplete higher,Married,House / apartment,-13923,-2290,1,1,1,0,Drivers,2.0,-29,X
9976,5009408,M,N,N,0,234000.0,Working,Incomplete higher,Married,House / apartment,-13923,-2290,1,1,1,0,Drivers,2.0,-30,X
9977,5009408,M,N,N,0,234000.0,Working,Incomplete higher,Married,House / apartment,-13923,-2290,1,1,1,0,Drivers,2.0,-31,X
9978,5009408,M,N,N,0,234000.0,Working,Incomplete higher,Married,House / apartment,-13923,-2290,1,1,1,0,Drivers,2.0,-32,X
9979,5009408,M,N,N,0,234000.0,Working,Incomplete higher,Married,House / apartment,-13923,-2290,1,1,1,0,Drivers,2.0,-33,X
9980,5009408,M,N,N,0,234000.0,Working,Incomplete higher,Married,House / apartment,-13923,-2290,1,1,1,0,Drivers,2.0,-34,X
9981,5009408,M,N,N,0,234000.0,Working,Incomplete higher,Married,House / apartment,-13923,-2290,1,1,1,0,Drivers,2.0,-35,X
9982,5009408,M,N,N,0,234000.0,Working,Incomplete higher,Married,House / apartment,-13923,-2290,1,1,1,0,Drivers,2.0,-36,X
9983,5009408,M,N,N,0,234000.0,Working,Incomplete higher,Married,House / apartment,-13923,-2290,1,1,1,0,Drivers,2.0,-37,X
9984,5009410,M,N,N,0,234000.0,Working,Incomplete higher,Married,House / apartment,-13923,-2290,1,1,1,0,Drivers,2.0,0,X
9985,5009410,M,N,N,0,234000.0,Working,Incomplete higher,Married,House / apartment,-13923,-2290,1,1,1,0,Drivers,2.0,-1,X
9986,5009410,M,N,N,0,234000.0,Working,Incomplete higher,Married,House / apartment,-13923,-2290,1,1,1,0,Drivers,2.0,-2,X
9987,5009410,M,N,N,0,234000.0,Working,Incomplete higher,Married,House / apartment,-13923,-2290,1,1,1,0,Drivers,2.0,-3,X
9988,5009410,M,N,N,0,234000.0,Working,Incomplete higher,Married,House / apartment,-13923,-2290,1,1,1,0,Drivers,2.0,-4,X
9989,5009410,M,N,N,0,234000.0,Working,Incomplete higher,Married,House / apartment,-13923,-2290,1,1,1,0,Drivers,2.0,-5,X
9990,5009410,M,N,N,0,234000.0,Working,Incomplete higher,Married,House / apartment,-13923,-2290,1,1,1,0,Drivers,2.0,-6,X
9991,5009410,M,N,N,0,234000.0,Working,Incomplete higher,Married,House / apartment,-13923,-2290,1,1,1,0,Drivers,2.0,-7,X
9992,5009410,M,N,N,0,234000.0,Working,Incomplete higher,Married,House / apartment,-13923,-2290,1,1,1,0,Drivers,2.0,-8,X
9993,5009410,M,N,N,0,234000.0,Working,Incomplete higher,Married,House / apartment,-13923,-2290,1,1,1,0,Drivers,2.0,-9,X
9994,5009410,M,N,N,0,234000.0,Working,Incomplete higher,Married,House / apartment,-13923,-2290,1,1,1,0,Drivers,2.0,-10,X
9995,5009410,M,N,N,0,234000.0,Working,Incomplete higher,Married,House / apartment,-13923,-2290,1,1,1,0,Drivers,2.0,-11,X
9996,5009410,M,N,N,0,234000.0,Working,Incomplete higher,Married,House / apartment,-13923,-2290,1,1,1,0,Drivers,2.0,-12,X
9997,5009410,M,N,N,0,234000.0,Working,Incomplete higher,Married,House / apartment,-13923,-2290,1,1,1,0,Drivers,2.0,-13,X
9998,5009410,M,N,N,0,234000.0,Working,Incomplete higher,Married,House / apartment,-13923,-2290,1,1,1,0,Drivers,2.0,-14,X
9999,5009410,M,N,N,0,234000.0,Working,Incomplete higher,Married,House / apartment,-13923,-2290,1,1,1,0,Drivers,2.0,-15,X
